,FreeNet_pre_score,FreeNet_post_score,FreeNet_pre_rank,FreeNet_post_rank,FreeNet_delta_ranks,Reversed_pre_score,Reversed_post_score,Reversed_pre_rank,Reversed_post_rank,Reversed_delta_ranks,Independent_pre_score,Independent_post_score,Independent_pre_rank,Independent_post_rank,Independent_delta_ranks,Random_pre_score,Random_post_score,Random_pre_rank,Random_post_rank,Random_delta_ranks,dist_victim_relayer,dist_victim_vilain_pre,dist_victim_vilain_post,out_deg_victim,in_deg_villain,victim,villain,relayer
0,152,152,84,84,0,78,78,68,68,0,78,78,71,71,0,0.012525953912658701,0.012525953912658701,74,74,0,-1,2,2,4,14,83,32,84
1,90,90,61,61,0,154,154,67,67,0,90,90,61,61,0,0.006467204465774873,0.006467204465774873,57,57,0,-1,2,2,10,6,18,28,79
2,50,50,60,60,0,54,54,55,55,0,54,54,60,60,0,0.005480104836788182,0.005480104836788182,56,56,0,-1,3,3,4,5,84,47,79
3,0,0,1,1,0,0,0,1,1,0,0,0,1,1,0,0.0,0.0,1,1,0,-1,-1,-1,14,0,17,59,76
4,206,308,89,96,7,128,128,67,67,0,128,128,79,79,0,0.01783586915824228,0.018210286258892407,81,81,0,4,3,3,8,16,15,12,49
5,22,22,42,42,0,46,46,39,39,0,22,22,42,42,0,0.002110350930937064,0.002110350930937064,44,44,0,-1,3,3,6,2,41,83,66
6,0,0,1,1,0,0,0,1,1,0,0,0,1,1,0,0.0,0.0,1,1,0,-1,-1,-1,4,1,53,45,92
7,76,76,62,62,0,90,90,65,65,0,76,76,61,61,0,0.009088124170325743,0.009088124170325743,66,66,0,-1,2,2,6,6,74,34,81
8,46,252,53,93,40,64,64,57,57,0,46,64,52,64,12,0.004935498144933456,0.009258313761530345,52,68,16,3,2,2,5,2,88,52,47
9,116,732,80,100,20,94,104,70,84,14,94,104,72,85,13,0.012832295176826986,0.01834643793185609,74,83,9,2,2,2,5,8,37,17,83
10,0,206,1,95,94,0,14,1,31,30,0,14,1,38,37,0.0,0.004050512270669526,1,51,50,3,-1,4,3,0,94,80,13
11,0,1640,1,100,99,0,118,1,60,59,0,92,1,63,62,0.0,0.016610504101569147,1,78,77,1,-1,2,13,0,13,97,33
12,115,321,79,97,18,146,146,79,79,0,115,146,79,86,7,0.008951972497362062,0.009973110044589673,68,69,1,3,2,2,8,8,30,57,43
13,52,668,56,100,44,44,44,49,49,0,44,44,55,55,0,0.008577555396711936,0.015317063208414174,66,79,13,2,3,3,4,6,79,34,48
14,6,6,29,29,0,48,48,34,34,0,6,6,29,29,0,0.00037441710065012424,0.00037441710065012424,32,32,0,-1,4,4,12,1,3,88,99
15,24,230,50,96,46,22,22,49,49,0,22,22,53,53,0,0.0018720855032506212,0.005582218591510943,44,59,15,3,3,3,2,4,90,64,26
16,94,300,67,96,29,176,176,85,85,0,94,176,67,88,21,0.011981347220803976,0.014636304843595765,74,77,3,3,2,2,8,5,30,25,73
17,0,206,1,90,89,0,22,1,32,31,0,22,1,40,39,0.0,0.005173763572619898,1,53,52,3,-1,4,5,0,50,36,48
18,0,206,1,93,92,0,10,1,31,30,0,9,1,37,36,0.0,0.002314578440382586,1,44,43,3,-1,4,3,0,58,97,70
19,0,1640,1,100,99,0,52,1,34,33,0,42,1,51,50,0.0,0.012491915994417782,1,71,70,1,-1,2,9,1,29,50,51
20,42,42,50,50,0,84,84,64,64,0,42,42,51,51,0,0.003199564314646516,0.003199564314646516,48,48,0,-1,2,2,5,2,50,61,84
21,118,324,86,98,12,72,72,79,79,0,72,72,80,80,0,0.02038871302631131,0.02392865652336703,85,88,3,3,2,2,3,9,75,39,57
22,96,197,67,89,22,128,128,76,76,0,96,97,67,68,1,0.008611593314952858,0.008611593314952858,66,66,0,5,3,3,8,7,57,21,68
23,100,100,82,82,0,100,100,98,98,0,100,100,98,98,0,0.10316893018822969,0.10313489226998877,100,100,0,4,1,1,2,29,98,11,64
24,6,6,27,27,0,20,20,27,27,0,6,6,27,27,0,6.807583648184077e-05,6.807583648184077e-05,27,27,0,-1,4,4,14,1,25,68,92
25,368,968,100,100,0,112,112,94,94,0,112,112,94,94,0,0.050954763606657814,0.06239150413560707,98,98,0,2,2,2,4,36,78,2,23
26,12,12,42,42,0,18,18,40,40,0,12,12,42,42,0,0.0017359338302869397,0.0017359338302869397,43,43,0,-1,4,4,3,2,92,52,59
27,111,317,74,95,21,94,94,62,62,0,94,94,69,69,0,0.008373327887266415,0.010007147962830594,62,69,7,3,2,2,5,8,52,57,83
28,100,100,60,60,0,100,100,52,52,0,100,100,60,60,0,0.026004969536063176,0.031212771026923995,89,91,2,2,1,1,9,13,29,24,28
29,100,100,64,64,0,100,100,59,59,0,100,100,64,64,0,0.04581503795227884,0.0460873412982062,98,98,0,4,1,1,6,17,40,6,63
30,8,214,41,97,56,12,12,39,39,0,8,12,41,43,2,0.001599782157323258,0.005548180673270023,43,58,15,3,4,4,2,2,97,61,26
31,0,1640,1,100,99,0,90,1,64,63,0,90,1,71,70,0.0,0.03716940671908506,1,93,92,1,-1,2,6,0,59,98,1
32,0,0,1,1,0,0,0,1,1,0,0,0,1,1,0,0.0,0.0,1,1,0,-1,-1,-1,2,1,89,45,81
33,88,190,73,95,22,38,38,51,51,0,38,38,54,54,0,0.013104598522754349,0.014670342761836687,75,76,1,4,3,3,3,8,94,8,70
34,100,100,65,65,0,100,100,75,75,0,100,100,77,77,0,0.04979747438646653,0.04983151230470744,98,98,0,4,1,1,5,18,61,30,60
35,63,1703,60,100,40,110,134,80,89,9,63,134,60,89,29,0.0061949011198475104,0.0440791041219919,57,95,38,1,2,2,6,4,48,22,0
36,12,12,41,41,0,8,8,32,32,0,12,12,41,41,0,0.002212464685659825,0.002212464685659825,45,45,0,-1,4,4,2,2,95,83,66
37,36,652,50,100,50,84,94,46,47,1,36,94,50,59,9,0.004969536063174376,0.012151536812008578,56,75,19,2,3,3,9,6,28,73,17
38,24,24,43,43,0,68,68,41,41,0,24,24,43,43,0,0.001599782157323258,0.001599782157323258,42,42,0,-1,3,3,8,4,10,64,91
39,28,644,46,100,54,40,70,40,53,13,28,70,46,61,15,0.001599782157323258,0.028523775485891283,42,90,48,2,3,3,5,3,50,43,10
40,0,0,1,1,0,0,0,1,1,0,0,0,1,1,0,0.0,0.0,1,1,0,-1,-1,-1,7,0,46,96,99
41,80,286,65,95,30,84,84,74,74,0,84,84,74,74,0,0.011640968038394772,0.014602266925354846,69,78,9,3,2,2,5,6,49,34,22
42,0,101,1,77,76,0,11,1,25,24,0,1,1,25,24,0.0,0.0,1,1,0,5,-1,6,11,1,33,69,68
43,1,103,25,83,58,3,6,25,28,3,1,4,25,30,5,0.0,0.0012594029749140542,1,39,38,4,6,5,3,2,85,58,83
44,22,228,45,95,50,28,28,43,43,0,22,28,46,49,3,0.002110350930937064,0.0025188059498281084,44,46,2,3,3,3,3,2,96,52,49
45,24,640,45,100,55,64,64,39,39,0,24,40,45,50,5,0.0017018959120460194,0.005718370264474625,44,57,13,2,3,3,9,3,23,43,90
46,163,163,87,87,0,112,112,92,92,0,112,112,92,92,0,0.019367575479083698,0.019367575479083698,84,84,0,-1,2,2,4,15,53,19,76
47,0,0,1,1,0,0,0,1,1,0,0,0,1,1,0,0.0,0.0,1,1,0,-1,-1,-1,14,0,17,85,66
48,58,58,54,54,0,136,136,63,63,0,58,58,54,54,0,0.0026889955410327104,0.0026889955410327104,48,48,0,-1,2,2,16,4,9,64,67
49,0,616,1,99,98,0,74,1,39,38,0,46,1,52,51,0.0,0.004833384390210695,1,56,55,2,-1,3,11,0,19,84,47
50,97,303,80,98,18,32,32,63,63,0,32,32,64,64,0,0.01861874127778345,0.0339017665679567,83,94,11,3,3,3,2,12,86,37,9
51,0,0,1,1,0,0,0,1,1,0,0,0,1,1,0,0.0,0.0,1,1,0,-1,-1,-1,3,0,82,85,69
52,16,632,40,100,60,38,38,51,51,0,16,38,40,53,13,0.0038462847612240037,0.017121072875182955,51,78,27,2,3,3,3,1,94,90,30
53,0,616,1,100,99,0,58,1,35,34,0,39,1,50,49,0.0,0.006535280302256714,1,59,58,2,-1,3,10,0,36,80,31
54,0,0,1,1,0,0,0,1,1,0,0,0,1,1,0,0.0,0.0,1,1,0,-1,-1,-1,8,0,30,81,69
55,2,104,27,83,56,3,3,27,27,0,2,3,27,30,3,0.0002723033459273631,0.001940161339732462,30,42,12,4,5,5,2,1,99,88,75
56,1,1,26,26,0,4,4,26,26,0,1,1,26,26,0,3.4037918240920386e-05,3.4037918240920386e-05,29,29,0,-1,6,6,4,1,78,68,93
57,80,286,69,96,27,60,60,52,52,0,60,60,62,62,0,0.008101024541339052,0.013819394805813677,65,76,11,3,3,3,5,9,45,31,21
58,192,808,86,100,14,320,320,95,95,0,192,235,86,89,3,0.012049423057285817,0.016508390346846386,70,76,6,2,2,2,14,7,25,21,57
59,0,206,1,94,93,0,8,1,30,29,0,8,1,35,34,0.0,0.0012934408931549745,1,39,38,3,-1,4,2,0,91,92,52
60,80,181,78,96,18,32,32,67,67,0,32,32,68,68,0,0.012662105585622384,0.012730181422104225,75,75,0,6,3,3,2,14,97,14,95
61,0,206,1,90,89,0,13,1,27,26,0,11,1,33,32,0.0,0.0026889955410327104,1,47,46,3,-1,4,5,0,50,79,73
62,0,616,1,100,99,0,40,1,42,41,0,40,1,52,51,0.0,0.01575955614554614,1,79,78,2,-1,3,5,0,49,98,6
63,314,520,96,100,4,150,150,90,90,0,150,150,91,91,0,0.03699921712788046,0.0405731985431771,94,96,2,3,2,2,7,29,62,0,47
64,56,262,62,94,32,54,54,55,55,0,54,54,60,60,0,0.005616256509751864,0.009939072126348753,57,67,10,3,3,3,4,6,84,28,72
65,12,628,37,100,63,18,28,40,47,7,12,28,37,53,16,0.0006126825283365669,0.003710133088260322,35,51,16,2,4,3,3,2,55,63,53
66,84,290,66,95,29,64,64,61,61,0,64,64,64,64,0,0.009564655025698629,0.012866333095067906,66,74,8,3,2,2,5,9,49,31,90
67,48,664,51,100,49,134,144,62,64,2,48,120,52,77,25,0.002110350930937064,0.01055175465468532,44,67,23,2,3,3,14,3,8,43,20
68,242,342,98,100,2,56,56,84,84,0,56,56,84,84,0,0.03682902753667586,0.03682902753667586,96,96,0,5,2,2,2,29,86,1,4
69,0,0,1,1,0,0,0,1,1,0,0,0,1,1,0,0.0,0.0,1,1,0,-1,-1,-1,5,0,37,66,98
70,0,206,1,93,92,0,12,1,35,34,0,12,1,36,35,0.0,0.013444977705163553,1,76,75,3,-1,4,2,0,68,86,15
71,42,248,59,97,38,32,32,69,69,0,32,32,69,69,0,0.010109261717553355,0.0156914803090643,71,80,9,3,3,3,2,5,90,25,24
72,268,1908,92,100,8,254,278,93,95,2,254,278,94,96,2,0.022805405221416657,0.043568535348378096,82,97,15,1,2,2,12,17,2,6,15
73,389,589,100,100,0,128,128,96,96,0,128,128,96,96,0,0.051499370298512544,0.05200993907212635,98,98,0,3,2,2,5,36,49,2,94
74,16,16,41,41,0,28,28,42,42,0,16,16,41,41,0,0.0009530617107457708,0.0009530617107457708,39,39,0,-1,3,3,3,2,64,42,69
75,63,165,61,88,27,60,60,53,53,0,60,60,60,60,0,0.007182000748834201,0.007590455767725246,62,62,0,4,3,3,5,8,49,57,42
76,47,253,56,93,37,56,56,46,46,0,47,56,56,57,1,0.004799346471969774,0.007284114503556962,56,62,6,3,3,3,6,6,74,35,22
77,0,616,1,100,99,0,68,1,37,36,0,50,1,55,54,0.0,0.008509479560230097,1,65,64,2,-1,3,11,0,38,86,8
78,32,32,40,40,0,94,94,38,38,0,32,32,40,40,0,0.0014295925661186562,0.0014295925661186562,41,41,0,-1,3,3,15,2,7,74,87
79,307,513,97,100,3,144,144,98,98,0,144,144,98,98,0,0.04098165356206814,0.045134279587460434,96,97,1,3,2,2,6,29,69,0,72
80,0,616,1,100,99,0,68,1,42,41,0,68,1,55,54,0.0,0.019912182170938427,1,79,78,2,-1,3,8,0,27,82,10
81,108,210,78,92,14,62,62,46,46,0,62,62,59,59,0,0.011130399264780965,0.011402702610708328,70,70,0,4,3,3,7,8,62,8,60
82,161,161,93,93,0,80,80,96,96,0,80,80,96,96,0,0.03271043942952449,0.03271043942952449,93,93,0,-1,2,2,2,15,98,16,66
83,0,616,1,100,99,0,28,1,43,42,0,28,1,50,49,0.0,0.024881718234112803,1,88,87,2,-1,3,3,0,92,99,7
84,182,388,89,98,9,110,110,78,78,0,110,110,82,82,0,0.012117498893767658,0.012559991830899623,72,73,1,3,2,2,6,14,51,32,49
85,0,1640,1,100,99,0,92,1,46,45,0,92,1,61,60,0.0,0.022294836447802852,1,84,83,1,-1,2,8,0,42,92,33
86,0,206,1,89,88,0,40,1,31,30,0,8,1,32,31,0.0,0.0014295925661186562,1,40,39,3,-1,4,12,0,14,59,52
87,419,625,100,100,0,136,136,98,98,0,136,136,98,98,0,0.052248204499812795,0.05286088702814936,97,97,0,3,2,2,4,36,47,2,61
88,232,333,91,96,5,320,320,92,92,0,232,232,91,91,0,0.019571802988529223,0.01960584090677014,80,80,0,5,2,2,14,12,16,37,78
89,54,670,51,100,49,96,126,53,76,23,53,126,51,83,32,0.004493005207801491,0.0348888661969434,53,91,38,2,2,2,7,6,46,41,2
90,168,374,89,99,10,94,94,75,75,0,94,94,75,75,0,0.01960584090677014,0.023009632730862182,82,83,1,3,2,2,5,18,49,5,47
91,2,618,29,100,71,14,56,29,40,11,2,56,29,55,26,0.00013615167296368154,0.010109261717553355,30,67,37,2,5,3,9,1,26,60,19
92,16,16,37,37,0,56,56,48,48,0,16,16,37,37,0,0.0035739814152966403,0.0035739814152966403,50,50,0,-1,3,3,6,1,65,90,80
93,0,0,1,1,0,0,0,1,1,0,0,0,1,1,0,0.0,0.0,1,1,0,-1,-1,-1,10,0,18,92,89
94,20,636,44,100,56,38,48,46,66,20,20,48,45,69,24,0.0018380475850097008,0.014602266925354846,42,77,35,2,3,3,3,3,96,43,19
95,50,50,54,54,0,82,82,50,50,0,50,50,54,54,0,0.005684332346233704,0.005684332346233704,56,56,0,-1,3,3,7,6,43,26,36
96,16,632,32,99,67,63,112,33,57,24,16,73,32,54,22,0.0002382654276864427,0.005888559855679227,32,54,22,2,3,3,17,1,20,88,57
97,142,142,89,89,0,72,72,87,87,0,72,72,87,87,0,0.01960584090677014,0.01960584090677014,86,86,0,-1,2,2,3,16,55,12,89
98,182,382,86,96,10,120,120,77,77,0,120,120,84,84,0,0.01943565131556554,0.023213860240307704,82,84,2,3,2,2,6,18,40,30,26
99,12,628,40,100,60,18,38,38,54,16,12,38,40,57,17,0.0018040096667687805,0.019265461724360937,44,85,41,2,4,3,3,2,76,52,18
100,125,125,76,76,0,204,204,79,79,0,125,125,76,76,0,0.00891793457912114,0.00891793457912114,61,61,0,-1,2,2,11,8,5,57,97
101,0,0,1,1,0,0,0,1,1,0,0,0,1,1,0,0.0,0.0,1,1,0,-1,-1,-1,10,0,12,85,45
102,0,616,1,100,99,0,78,1,43,42,0,78,1,57,56,0.0,0.01497668402600497,1,78,77,2,-1,3,8,0,10,93,12
103,0,616,1,100,99,0,36,1,35,34,0,23,1,46,45,0.0,0.0015317063208414173,1,39,38,2,-1,3,7,0,43,36,64
104,22,638,51,100,49,28,38,46,48,2,22,38,51,53,2,0.0021784267674189047,0.015555328636100617,47,80,33,2,3,3,3,2,87,52,8
105,100,100,59,59,0,100,100,46,46,0,100,100,59,59,0,0.031655263964055956,0.036624800027230335,91,94,3,2,1,1,11,15,5,19,38
106,63,269,57,93,36,138,138,75,75,0,63,69,57,58,1,0.005582218591510943,0.005956635692161067,58,59,1,3,2,2,9,4,31,22,65
107,0,1640,1,100,99,0,90,1,58,57,0,90,1,65,64,0.0,0.03553558664352088,1,92,91,1,-1,2,6,0,44,79,7
108,0,616,1,100,99,0,34,1,35,34,0,16,1,38,37,0.0,0.002552843868069029,1,47,46,2,-1,3,6,0,44,91,53
109,0,0,1,1,0,0,0,1,1,0,0,0,1,1,0,0.0,0.0,1,1,0,-1,-1,-1,14,0,25,66,76
110,0,616,1,100,99,0,94,1,41,40,0,94,1,60,59,0.0,0.0123557643214541,1,70,69,2,-1,3,12,1,2,50,5
111,109,709,86,100,14,32,32,71,71,0,32,32,71,71,0,0.020592940535756832,0.056434868443446,85,97,12,2,3,3,2,16,99,18,2
112,0,0,1,1,0,0,0,1,1,0,0,0,1,1,0,0.0,0.0,1,1,0,-1,-1,-1,3,0,60,67,98
113,2,618,26,100,74,11,90,26,42,16,2,90,26,63,37,0.00010211375472276115,0.011709043874876613,29,74,45,2,5,3,10,1,1,78,14
114,0,101,1,74,73,0,12,1,23,22,0,1,1,23,22,0.0,3.4037918240920386e-05,1,25,24,5,-1,6,12,0,3,67,68
115,12,12,41,41,0,20,20,37,37,0,12,12,41,41,0,0.002382654276864427,0.002382654276864427,48,48,0,-1,4,4,4,2,72,75,85
116,146,762,85,100,15,128,128,93,93,0,128,128,93,93,0,0.01664454201981007,0.04523639334218319,77,98,21,2,2,2,5,8,70,17,11
117,8,624,38,100,62,24,44,40,47,7,8,44,38,57,19,0.00037441710065012424,0.025256135334762925,35,88,53,2,4,3,4,2,47,56,11
118,8,8,37,37,0,30,30,37,37,0,8,8,37,37,0,0.0016338200755641784,0.0016338200755641784,41,41,0,-1,4,4,5,2,80,83,84
119,2,2,28,28,0,6,6,30,30,0,2,2,28,28,0,0.00013615167296368154,0.00013615167296368154,30,30,0,-1,5,5,3,1,76,55,93
120,1,207,25,93,68,3,18,25,35,10,1,18,25,44,19,6.807583648184077e-05,0.005956635692161067,27,59,32,3,6,4,3,1,82,78,21
121,106,1746,73,100,27,148,192,76,93,17,106,192,73,93,20,0.00878178290615746,0.04009666768780421,66,95,29,1,2,2,9,8,29,57,7
122,73,279,70,98,28,22,22,48,48,0,22,22,51,51,0,0.011675005956635693,0.013887470642295518,72,75,3,3,3,3,2,13,95,33,46
123,100,100,59,59,0,100,100,40,40,0,100,100,59,59,0,0.028693965077095884,0.028693965077095884,90,90,0,-1,1,1,15,16,7,12,84
124,58,674,59,100,41,72,72,59,59,0,58,72,61,64,3,0.006126825283365669,0.012253650566731339,55,72,17,2,2,2,6,3,69,54,44
125,0,616,1,100,99,0,50,1,35,34,0,31,1,43,42,0.0,0.00789679703189353,1,62,61,2,-1,3,8,0,27,98,25
126,1,207,25,94,69,3,14,25,36,11,1,14,25,42,17,3.4037918240920386e-05,0.007692569522448007,27,67,40,3,6,4,3,2,81,58,8
127,184,390,86,96,10,190,190,92,92,0,184,190,93,93,0,0.016542428265087308,0.017597603730555838,80,81,1,3,2,2,8,8,42,20,83
128,46,662,49,100,51,98,108,42,57,15,46,68,49,56,7,0.002552843868069029,0.005105687736138058,46,55,9,2,2,2,12,3,2,51,83
129,0,1640,1,100,99,0,44,1,65,64,0,44,1,67,66,0.0,0.03832669593927635,1,94,93,1,-1,2,3,0,81,91,57
130,208,824,92,100,8,222,222,92,92,0,208,222,92,94,2,0.02032063718982947,0.02668572790088158,85,88,3,2,2,2,10,12,0,37,48
131,0,0,1,1,0,0,0,1,1,0,0,0,1,1,0,0.0,0.0,1,1,0,-1,-1,-1,3,0,87,96,67
132,71,173,56,84,28,180,180,70,70,0,71,73,56,56,0,0.005650294427992784,0.005684332346233704,55,57,2,4,3,3,15,6,7,35,55
133,122,328,87,98,11,96,96,92,92,0,96,96,92,92,0,0.020354675108070392,0.020729092208720514,86,88,2,3,2,2,3,13,96,33,49
134,0,101,1,86,85,0,2,1,24,23,0,1,1,24,23,0.0,0.0,1,1,0,6,-1,7,2,0,97,76,78
135,0,0,1,1,0,0,0,1,1,0,0,0,1,1,0,0.0,0.0,1,1,0,-1,-1,-1,10,0,36,91,99
136,0,616,1,100,99,0,60,1,50,49,0,60,1,56,55,0.0,0.026651689982640663,1,89,88,2,-1,3,5,0,37,84,0
137,0,101,1,74,73,0,11,1,25,24,0,1,1,25,24,0.0,0.00010211375472276115,1,29,28,5,-1,6,11,1,19,50,60
138,6,212,29,93,64,10,14,29,31,2,6,12,29,34,5,0.0002382654276864427,0.0017359338302869397,32,41,9,3,4,4,3,1,82,60,53
139,100,100,62,62,0,100,100,45,45,0,100,100,62,62,0,0.022124646856598252,0.03526328329759352,82,92,10,2,1,1,12,8,3,44,12
140,0,616,1,100,99,0,24,1,42,41,0,22,1,46,45,0.0,0.004765308553728854,1,52,51,2,-1,3,3,0,58,79,52
141,270,372,94,95,1,120,120,78,78,0,120,120,78,78,0,0.028762040913577726,0.028830116750059566,89,89,0,4,2,2,6,22,41,9,60
142,100,100,71,71,0,100,100,80,80,0,100,100,81,81,0,0.050818611933694136,0.05088668777017598,97,97,0,6,1,1,5,12,49,37,78
143,358,558,95,100,5,176,176,87,87,0,176,176,89,89,0,0.0348888661969434,0.03720344463732598,89,91,2,3,2,2,8,30,57,7,28
144,0,0,1,1,0,0,0,1,1,0,0,0,1,1,0,0.0,0.0,1,1,0,-1,-1,-1,3,0,58,99,92
145,0,616,1,99,98,0,124,1,58,57,0,66,1,53,52,0.0,0.007828721195411689,1,57,56,2,-1,3,17,0,20,67,77
146,2,618,27,99,72,22,74,29,39,10,2,48,27,54,27,0.00017018959120460194,0.004833384390210695,31,57,26,2,5,3,11,1,19,65,47
147,0,616,1,100,99,0,80,1,40,39,0,80,1,56,55,0.0,0.010415602981721638,1,70,69,2,-1,3,10,1,18,50,14
148,16,632,38,100,62,40,50,45,49,4,16,50,38,53,15,0.002212464685659825,0.010858095918853602,47,70,23,2,3,3,5,2,37,94,25
149,494,1094,99,100,1,240,240,98,98,0,240,240,98,98,0,0.04785731304673406,0.06225535246264338,97,100,3,2,2,2,9,36,29,2,9
150,42,658,59,100,41,46,46,81,81,0,42,46,81,81,0,0.012968446849790666,0.030497974743864665,77,93,16,2,2,2,2,2,90,75,12
151,56,262,63,95,32,48,48,66,66,0,48,48,67,67,0,0.010245413390517035,0.01589570781850982,71,79,8,3,3,3,3,6,76,77,21
152,108,108,79,79,0,60,60,55,55,0,60,60,60,60,0,0.012832295176826986,0.012832295176826986,73,73,0,-1,3,3,5,8,70,8,59
153,39,39,53,53,0,44,44,48,48,0,39,39,53,53,0,0.004629156880765172,0.004629156880765172,55,55,0,-1,3,3,4,4,83,22,84
154,176,776,91,100,9,136,136,97,97,0,136,136,97,97,0,0.02668572790088158,0.043534497430137174,88,94,6,2,2,2,4,9,72,39,16
155,0,616,1,99,98,0,110,1,55,54,0,50,1,50,49,0.0,0.00616086320160659,1,56,55,2,-1,3,17,0,20,67,26
156,78,694,64,100,36,110,110,77,77,0,78,110,64,80,16,0.009496579189216788,0.017189148711664794,67,79,12,2,2,2,6,4,74,72,25
157,40,142,58,89,31,44,44,67,67,0,40,44,67,68,1,0.00616086320160659,0.007284114503556962,62,65,3,4,2,2,3,2,81,42,52
158,22,228,39,90,51,164,164,70,70,0,22,40,39,45,6,0.001940161339732462,0.004595118962524252,41,54,13,3,3,3,14,2,17,61,70
159,2,2,29,29,0,8,8,30,30,0,2,2,29,29,0,0.0002382654276864427,0.0002382654276864427,33,33,0,-1,5,5,4,1,73,60,36
160,66,272,55,93,38,76,76,55,55,0,66,76,55,59,4,0.006126825283365669,0.011198475101262807,53,69,16,3,3,3,6,6,71,28,25
161,0,616,1,100,99,0,86,1,42,41,0,67,1,56,55,0.0,0.008305252050784574,1,64,63,2,-1,3,10,0,36,79,17
162,80,696,61,100,39,126,126,80,80,0,80,126,63,82,19,0.010109261717553355,0.022465026039007456,68,85,17,2,2,2,7,5,62,25,39
163,12,1652,35,100,65,50,94,36,47,11,12,94,35,63,28,0.0009530617107457708,0.018959120460192654,37,80,43,1,4,2,9,2,54,74,8
164,96,302,65,95,30,124,124,75,75,0,96,124,65,83,18,0.006297014874570271,0.009122162088566664,60,67,7,3,3,3,9,6,23,13,41
165,100,100,63,63,0,100,100,45,45,0,100,100,63,63,0,0.02314578440382586,0.02314578440382586,87,87,0,-1,1,1,11,4,19,38,45
166,0,0,1,1,0,0,0,1,1,0,0,0,1,1,0,0.0,0.0,1,1,0,-1,-1,-1,3,1,55,50,81
167,115,115,85,85,0,48,48,59,59,0,48,48,63,63,0,0.0141938119064638,0.0141938119064638,80,80,0,-1,3,3,3,15,75,19,96
168,100,100,63,63,0,100,100,45,45,0,100,100,63,63,0,0.05000170189591205,0.05003573981415296,97,97,0,5,1,1,11,29,19,1,78
169,2,1642,28,100,72,7,50,28,54,26,2,50,28,59,31,0.00017018959120460194,0.034854828278702475,31,93,62,1,5,2,4,1,84,95,6
170,100,100,78,78,0,100,100,97,97,0,100,100,97,97,0,0.09397869226318119,0.09404676809966303,100,100,0,5,1,1,3,30,96,7,95
171,156,1756,89,100,11,56,56,76,76,0,56,56,77,77,0,0.020899281799925118,0.08383539262738691,87,98,11,1,2,2,2,16,68,12,7
172,0,0,1,1,0,0,0,1,1,0,0,0,1,1,0,0.0,0.0,1,1,0,-1,-1,-1,4,0,79,67,69
173,0,102,1,74,73,0,17,1,25,24,0,2,1,25,24,0.0,0.00017018959120460194,1,29,28,4,-1,5,16,0,9,87,55
174,16,16,37,37,0,116,116,62,62,0,16,16,37,37,0,0.0037441710065012424,0.0037441710065012424,51,51,0,-1,3,3,11,1,19,90,92
175,66,682,53,100,47,190,200,69,71,2,64,115,53,79,26,0.004016474352428605,0.011879233466081215,51,71,20,2,2,2,16,6,4,41,25
176,86,1726,67,100,33,60,84,53,73,20,60,84,60,73,13,0.008577555396711936,0.04632560672589264,65,97,32,1,3,2,5,13,49,24,1
177,48,254,63,99,36,12,12,37,37,0,12,12,41,41,0,0.00707988699411144,0.012389802239695021,63,73,10,3,4,4,2,13,89,24,34
178,16,632,37,100,63,38,48,38,44,6,16,32,37,47,10,0.0008509479560230097,0.0042547397801150485,38,50,12,2,3,3,6,2,48,42,46
179,16,16,32,32,0,68,68,34,34,0,16,16,32,32,0,0.00030634126416828345,0.00030634126416828345,34,34,0,-1,3,3,17,1,20,4,59
180,42,42,48,48,0,130,130,61,61,0,42,42,48,48,0,0.0013955546478777359,0.0013955546478777359,41,41,0,-1,2,2,14,2,8,56,84
181,222,838,91,100,9,256,256,94,94,0,222,256,92,95,3,0.022601177711971135,0.03601211749889377,84,95,11,2,2,2,10,12,11,37,39
182,78,78,65,65,0,110,110,81,81,0,78,78,67,67,0,0.008203138296061813,0.008203138296061813,65,65,0,-1,2,2,6,4,32,72,84
183,84,700,71,100,29,54,54,54,54,0,54,54,58,58,0,0.010892133837094524,0.0283876238129276,72,89,17,2,3,3,4,9,47,27,16
184,40,246,51,93,42,92,92,51,51,0,40,46,51,51,0,0.0053099152455835805,0.006841621566424997,56,61,5,3,2,2,8,1,30,90,53
185,54,260,59,96,37,38,38,53,53,0,38,38,55,55,0,0.006875659484665918,0.007794683277170768,62,65,3,3,3,3,3,7,64,62,61
186,94,710,62,100,38,160,160,73,73,0,94,136,62,83,21,0.006501242384015794,0.014227849824704722,62,77,15,2,2,2,11,6,38,26,77
187,100,100,63,63,0,100,100,45,45,0,100,100,63,63,0,0.05177167364443991,0.058953674393274105,98,100,2,2,1,1,11,30,19,7,72
188,46,252,49,93,44,112,112,62,62,0,46,58,49,52,3,0.0025188059498281084,0.004152626025392287,46,53,7,3,2,2,8,2,42,61,75
189,22,228,53,97,44,32,32,63,63,0,22,32,54,63,9,0.004833384390210695,0.016168011164437182,57,79,22,3,3,3,2,3,86,29,37
190,0,0,1,1,0,0,0,1,1,0,0,0,1,1,0,0.0,0.0,1,1,0,-1,-1,-1,9,1,26,45,89
191,97,1737,74,100,26,72,96,80,86,6,72,96,80,86,6,0.010007147962830594,0.04949113312229824,69,97,28,1,2,2,3,8,87,57,24
192,0,102,1,75,74,0,7,1,27,26,0,2,1,27,26,0.0,0.0,1,1,0,4,-1,5,6,1,44,45,95
193,294,395,96,99,3,144,144,91,91,0,144,144,91,91,0,0.03451444909629327,0.03454848701453419,92,92,0,5,2,2,6,29,74,0,68
194,16,16,32,32,0,124,124,60,60,0,16,16,32,32,0,0.004016474352428605,0.004016474352428605,53,53,0,-1,3,3,14,1,17,90,40
195,192,392,94,100,6,56,56,85,85,0,56,56,85,85,0,0.032914666938970015,0.036624800027230335,93,93,0,3,2,2,2,22,90,9,13
196,0,206,1,92,91,0,48,1,31,30,0,30,1,45,44,0.0,0.003437829742332959,1,50,49,3,-1,4,10,0,36,89,26
197,249,351,96,98,2,48,48,62,62,0,48,48,64,64,0,0.032063718982947,0.033050818611933694,91,93,2,4,3,3,3,30,64,7,53
198,84,700,70,100,30,38,48,53,61,8,38,48,55,63,8,0.011300588855985567,0.02552843868069029,72,89,17,2,3,3,3,8,64,8,19
199,2,104,27,83,56,3,4,27,28,1,2,4,27,30,3,0.0002723033459273631,0.0024166921951053475,30,45,15,4,5,5,2,1,99,88,83
200,6,108,29,77,48,17,18,28,28,0,6,8,29,32,3,0.00010211375472276115,0.00013615167296368154,28,29,1,4,4,4,11,2,33,58,65
201,6,108,29,75,46,27,27,30,30,0,6,6,29,29,0,0.00010211375472276115,0.0002723033459273631,27,31,4,4,4,4,12,1,14,60,65
202,0,1640,1,100,99,0,126,1,61,60,0,126,1,79,78,0.0,0.01872085503250621,1,80,79,1,-1,2,14,1,16,50,12
203,0,0,1,1,0,0,0,1,1,0,0,0,1,1,0,0.0,0.0,1,1,0,-1,-1,-1,2,0,93,40,79
204,6,6,32,32,0,34,34,33,33,0,6,6,32,32,0,0.0007828721195411688,0.0007828721195411688,37,37,0,-1,4,4,7,1,46,71,79
205,0,102,1,77,76,0,6,1,24,23,0,2,1,24,23,0.0,0.00010211375472276115,1,29,28,4,-1,5,5,0,50,87,65
206,100,100,67,67,0,100,100,54,54,0,100,100,67,67,0,0.01940161339732462,0.02917049593246877,79,90,11,2,1,1,8,2,27,83,33
207,0,102,1,71,70,0,14,1,31,30,0,4,1,31,30,0.0,0.0013615167296368155,1,39,38,4,-1,5,7,0,46,36,75
208,0,0,1,1,0,0,0,1,1,0,0,0,1,1,0,0.0,0.0,1,1,0,-1,-1,-1,16,1,9,45,66
209,100,100,64,64,0,100,100,45,45,0,100,100,64,64,0,0.06429762755709861,0.0672929643622996,100,100,0,2,1,1,10,36,18,2,22
210,16,16,37,37,0,66,66,49,49,0,16,16,37,37,0,0.003914360597705844,0.003914360597705844,52,52,0,-1,3,3,6,1,41,90,86
211,149,749,84,100,16,84,84,69,69,0,84,84,71,71,0,0.010483678818203479,0.013444977705163553,70,75,5,2,2,2,5,13,37,24,22
212,276,378,98,100,2,96,96,92,92,0,96,96,92,92,0,0.041798563599850236,0.042751625310596,95,95,0,4,2,2,3,29,81,1,74
213,6,212,29,90,61,28,36,33,35,2,6,16,29,36,7,0.00037441710065012424,0.0018040096667687805,35,42,7,3,4,4,8,1,10,88,54
214,6,212,33,93,60,12,12,34,34,0,6,15,33,42,9,0.0006126825283365669,0.0023486163586235067,37,46,9,3,4,4,4,2,72,42,70
215,88,688,61,100,39,122,122,69,69,0,88,106,61,75,14,0.007726607440688927,0.012219612648490419,62,71,9,2,2,2,8,4,27,72,62
216,45,147,62,90,28,48,48,68,68,0,48,48,69,69,0,0.009258313761530345,0.010245413390517035,69,72,3,4,3,3,3,5,81,25,64
217,0,0,1,1,0,0,0,1,1,0,0,0,1,1,0,0.0,0.0,1,1,0,-1,-1,-1,9,0,29,76,82
218,0,616,1,100,99,0,66,1,50,49,0,66,1,61,60,0.0,0.018108172504169646,1,83,82,2,-1,3,6,0,34,96,23
219,39,39,53,53,0,38,38,47,47,0,38,38,53,53,0,0.004833384390210695,0.004833384390210695,55,55,0,-1,3,3,3,4,75,22,82
220,38,654,49,100,51,110,110,60,60,0,38,110,49,73,24,0.002314578440382586,0.016168011164437182,47,78,31,2,3,3,10,6,11,70,5
221,100,100,77,77,0,100,100,96,96,0,100,100,96,96,0,0.07022022533101875,0.07022022533101875,99,99,0,-1,1,1,3,19,76,15,85
222,6,212,30,91,61,30,30,37,37,0,6,13,30,38,8,0.0013955546478777359,0.0020082371762143027,39,44,5,3,4,4,5,1,80,71,56
223,6,622,27,100,73,29,58,29,34,5,6,22,27,38,11,0.0002042275094455223,0.0034718676605738795,30,51,21,2,4,3,14,1,8,55,90
224,157,258,91,99,8,56,56,85,85,0,56,56,85,85,0,0.026855917492086184,0.026855917492086184,88,88,0,6,2,2,2,15,90,16,68
225,120,736,85,100,15,64,64,64,64,0,64,64,67,67,0,0.016168011164437182,0.01960584090677014,81,84,3,2,3,3,4,18,77,30,52
226,100,716,67,100,33,94,104,71,79,8,94,104,72,80,8,0.007998910786616291,0.02396269444160795,65,88,23,2,2,2,5,6,63,13,39
227,146,352,82,96,14,116,116,76,76,0,116,116,80,80,0,0.015283025290173252,0.016440314510364547,77,78,1,3,2,2,7,13,62,33,52
228,0,206,1,89,88,0,28,1,29,28,0,6,1,28,27,0.0,0.0006807583648184077,1,35,34,3,-1,4,10,0,18,67,71
229,265,367,98,100,2,72,72,85,85,0,72,72,85,85,0,0.03948398515946765,0.03972225058715409,95,95,0,4,2,2,3,30,94,7,60
230,79,695,66,100,34,78,78,73,73,0,78,78,73,73,0,0.007794683277170768,0.014227849824704722,64,75,11,2,2,2,4,6,79,28,62
231,100,100,62,62,0,100,100,48,48,0,100,100,62,62,0,0.04237720820994588,0.042649511555873244,97,97,0,3,1,1,10,15,11,16,49
232,0,206,1,92,91,0,16,1,33,32,0,16,1,43,42,0.0,0.003914360597705844,1,51,50,3,-1,4,4,0,77,93,13
233,0,616,1,100,99,0,132,1,61,60,0,110,1,74,73,0.0,0.016270124919159943,1,78,77,2,-1,3,16,0,9,87,23
234,173,789,90,100,10,112,112,95,95,0,112,112,95,95,0,0.02644746247319514,0.03829265802103543,89,94,5,2,2,2,4,16,73,18,6
235,0,0,1,1,0,0,0,1,1,0,0,0,1,1,0,0.0,0.0,1,1,0,-1,-1,-1,9,1,26,69,92
236,42,248,53,95,42,90,90,58,58,0,42,49,53,55,2,0.002995336805200994,0.003369753905851118,46,48,2,3,2,2,6,2,48,61,56
237,70,276,62,95,33,80,80,66,66,0,70,80,64,67,3,0.005241839409101739,0.014874570271282209,58,78,20,3,3,3,5,6,63,28,19
238,47,47,55,55,0,86,86,63,63,0,47,47,55,55,0,0.004731270635487933,0.004731270635487933,55,55,0,-1,3,3,6,6,34,35,89
239,0,0,1,1,0,0,0,1,1,0,0,0,1,1,0,0.0,0.0,1,1,0,-1,-1,-1,6,0,59,98,87
240,0,0,1,1,0,0,0,1,1,0,0,0,1,1,0,0.0,0.0,1,1,0,-1,-1,-1,3,0,82,40,85
241,0,102,1,83,82,0,4,1,28,27,0,4,1,32,31,0.0,0.0022465026039007454,1,47,46,4,-1,5,2,0,86,36,70
242,6,6,29,29,0,23,23,30,30,0,6,6,29,29,0,0.00013615167296368154,0.00013615167296368154,31,31,0,-1,4,4,8,1,10,65,76
243,180,1820,89,100,11,158,182,83,86,3,158,182,87,90,3,0.017972020831205963,0.0477551992920113,81,98,17,1,2,2,9,17,31,6,1
244,0,616,1,100,99,0,36,1,39,38,0,36,1,50,49,0.0,0.008475441641989176,1,67,66,2,-1,3,5,0,37,84,27
245,56,672,59,100,41,48,48,54,54,0,48,48,56,56,0,0.00980292045338507,0.01592974573675074,68,80,12,2,3,3,3,5,87,25,70
246,190,1830,89,100,11,222,256,83,89,6,222,256,90,93,3,0.020048333843902106,0.04731270635487934,82,98,16,1,2,2,13,16,13,18,9
247,70,70,60,60,0,86,86,63,63,0,70,70,63,63,0,0.005990673610401988,0.005990673610401988,56,56,0,-1,3,3,6,6,56,26,85
248,0,616,1,100,99,0,18,1,46,45,0,18,1,48,47,0.0,0.008951972497362062,1,67,66,2,-1,3,2,0,99,36,17
249,190,190,90,90,0,148,148,96,96,0,148,148,96,96,0,0.01940161339732462,0.01940161339732462,80,80,0,-1,2,2,6,8,51,8,84
250,16,118,43,83,40,54,54,59,59,0,16,19,44,50,6,0.004731270635487933,0.005582218591510943,56,57,1,4,3,3,4,1,77,90,74
251,144,350,82,95,13,112,112,92,92,0,112,112,92,92,0,0.012049423057285817,0.016712617856291908,72,80,8,3,2,2,4,6,83,13,62
252,0,0,1,1,0,0,0,1,1,0,0,0,1,1,0,0.0,0.0,1,1,0,-1,-1,-1,12,0,2,40,66
253,16,222,41,93,52,40,40,44,44,0,16,40,41,52,11,0.0012253650566731338,0.009156200006807584,41,68,27,3,3,3,5,1,70,71,77
254,6,212,31,97,66,7,12,31,36,5,6,12,31,41,10,0.0006807583648184077,0.006739507811702236,36,62,26,3,4,4,2,2,99,42,25
255,0,206,1,96,95,0,8,1,32,31,0,8,1,37,36,0.0,0.012525953912658701,1,73,72,3,-1,4,2,1,99,45,6
256,0,102,1,73,72,0,8,1,28,27,0,2,1,25,24,0.0,0.0002042275094455223,1,32,31,4,-1,5,5,0,61,96,88
257,16,632,34,100,66,156,176,67,68,1,16,111,34,74,40,0.0030293747234419145,0.010790020082371761,49,61,12,2,3,3,16,3,9,46,24
258,0,616,1,100,99,0,58,1,37,36,0,52,1,52,51,0.0,0.007828721195411689,1,64,63,2,-1,3,8,0,15,84,20
259,0,616,1,100,99,0,90,1,45,44,0,90,1,60,59,0.0,0.012934408931549747,1,75,74,2,-1,3,10,1,11,50,5
260,6,212,33,94,61,8,12,33,39,6,6,12,33,41,8,0.00037441710065012424,0.007488342013002485,35,68,33,3,4,4,2,1,90,49,27
261,136,1776,81,100,19,228,262,79,86,7,136,208,81,86,5,0.011981347220803976,0.024064808196330712,69,88,19,1,2,2,14,8,25,17,48
262,264,470,96,100,4,112,112,93,93,0,112,112,93,93,0,0.03264236359304265,0.03543347288879812,92,93,1,3,2,2,4,22,47,9,35
263,126,332,82,96,14,94,94,68,68,0,94,94,71,71,0,0.017223186629905716,0.018108172504169646,80,81,1,3,2,2,5,12,50,37,71
264,0,0,1,1,0,0,0,1,1,0,0,0,1,1,0,0.0,0.0,1,1,0,-1,-1,-1,6,1,74,50,67
265,0,616,1,100,99,0,76,1,38,37,0,76,1,57,56,0.0,0.009598692943939549,1,69,68,2,-1,3,10,0,36,92,19
266,0,0,1,1,0,0,0,1,1,0,0,0,1,1,0,0.0,0.0,1,1,0,-1,-1,-1,4,0,83,98,69
267,100,100,74,74,0,100,100,80,80,0,100,100,80,80,0,0.038394771775758195,0.04598522754348344,94,96,2,3,1,1,5,8,45,44,32
268,0,0,1,1,0,0,0,1,1,0,0,0,1,1,0,0.0,0.0,1,1,0,-1,-1,-1,4,0,84,85,80
269,96,198,78,95,17,56,56,82,82,0,56,56,82,82,0,0.015521290717859695,0.0158616699002689,79,79,0,4,2,2,2,7,89,48,63
270,0,0,1,1,0,0,0,1,1,0,0,0,1,1,0,0.0,0.0,1,1,0,-1,-1,-1,2,0,91,98,84
271,0,0,1,1,0,0,0,1,1,0,0,0,1,1,0,0.0,0.0,1,1,0,-1,-1,-1,11,0,38,87,89
272,168,374,83,96,13,158,158,79,79,0,158,158,84,84,0,0.01851662752306069,0.01855066544130161,81,81,0,3,2,2,9,18,54,30,95
273,102,102,74,74,0,192,192,72,72,0,102,102,74,74,0,0.008271214132543654,0.008271214132543654,65,65,0,-1,3,3,12,7,6,48,84
274,0,206,1,92,91,0,33,1,33,32,0,33,1,48,47,0.0,0.004595118962524252,1,53,52,3,-1,4,9,0,35,92,31
275,1,1,26,26,0,6,6,26,26,0,1,1,26,26,0,3.4037918240920386e-05,3.4037918240920386e-05,28,28,0,-1,6,6,6,1,41,78,66
276,60,266,55,93,38,76,76,54,54,0,60,76,55,59,4,0.008441403723748256,0.015351101126655093,65,77,12,3,3,3,6,5,41,25,48
277,84,84,66,66,0,88,88,71,71,0,88,88,71,71,0,0.011300588855985567,0.011300588855985567,73,73,0,-1,2,2,4,5,53,25,96
278,44,146,55,89,34,38,38,51,51,0,38,38,54,54,0,0.006603356138738555,0.006909697402906838,59,60,1,4,3,3,3,4,94,72,63
279,74,280,60,94,34,106,106,71,71,0,74,80,60,63,3,0.006467204465774873,0.007590455767725246,58,62,4,3,2,2,7,5,43,47,42
280,16,632,39,100,61,42,52,41,47,6,16,48,39,56,17,0.0040845501889104465,0.009020048333843901,51,66,15,2,3,3,6,1,69,90,47
281,0,206,1,91,90,0,54,1,37,36,0,54,1,55,54,0.0,0.007590455767725246,1,63,62,3,-1,4,9,1,31,45,33
282,2,618,28,100,72,12,26,30,33,3,2,20,28,44,16,0.00013615167296368154,0.0020763130126961434,30,45,15,2,5,3,6,1,44,65,63
283,56,1696,52,100,48,80,124,61,88,27,56,124,52,89,37,0.005650294427992784,0.048129616392661424,54,97,43,1,2,2,6,3,56,29,3
284,0,0,1,1,0,0,0,1,1,0,0,0,1,1,0,0.0,0.0,1,1,0,-1,-1,-1,3,0,60,87,98
285,192,294,95,99,4,32,32,63,63,0,32,32,65,65,0,0.028489737567650362,0.02913645801422785,91,91,0,4,3,3,2,22,98,9,64
286,0,616,1,100,99,0,36,1,37,36,0,34,1,51,50,0.0,0.006024711528642908,1,58,57,2,-1,3,5,0,61,89,72
287,100,100,69,69,0,100,100,66,66,0,100,100,72,72,0,0.04680213758126553,0.04680213758126553,96,96,0,-1,1,1,6,17,44,6,91
288,97,1737,74,100,26,48,72,54,79,25,48,72,56,79,23,0.014227849824704722,0.06375302086524388,78,99,21,1,3,2,3,13,87,33,9
289,432,432,100,100,0,176,176,99,99,0,176,176,99,99,0,0.05211205282684911,0.05211205282684911,97,97,0,-1,2,2,5,36,63,2,45
290,284,284,96,96,0,256,256,96,96,0,256,256,96,96,0,0.021818305592429966,0.021818305592429966,86,86,0,-1,2,2,10,18,0,30,79
291,0,616,1,100,99,0,57,1,31,30,0,24,1,42,41,0.0,0.0016338200755641784,1,40,39,2,-1,3,16,0,4,91,54
292,0,0,1,1,0,0,0,1,1,0,0,0,1,1,0,0.0,0.0,1,1,0,-1,-1,-1,9,0,26,82,50
293,12,218,36,92,56,66,66,37,37,0,12,20,36,41,5,0.002110350930937064,0.005377991082065421,43,57,14,3,4,4,11,2,19,83,29
294,6,6,29,29,0,24,24,30,30,0,6,6,29,29,0,0.00013615167296368154,0.00013615167296368154,30,30,0,-1,4,4,8,1,15,60,45
295,0,206,1,88,87,0,15,1,27,26,0,6,1,29,28,0.0,3.4037918240920386e-05,1,27,26,3,-1,4,9,0,54,89,95
296,0,102,1,75,74,0,10,1,26,25,0,2,1,25,24,0.0,0.00010211375472276115,1,29,28,4,-1,5,8,0,15,97,60
297,136,752,83,100,17,120,120,85,85,0,120,120,85,85,0,0.014704380680077607,0.02648150039143606,80,89,9,2,2,2,6,13,48,33,37
298,432,1048,99,100,1,200,200,93,93,0,200,200,93,93,0,0.037373634228530586,0.03876918887640832,97,97,0,2,2,2,8,30,27,7,60
299,0,616,1,100,99,0,40,1,43,42,0,40,1,50,49,0.0,0.029306647605432452,1,88,87,2,-1,3,5,1,88,45,3
300,108,314,78,97,19,86,86,62,62,0,86,86,65,65,0,0.012594029749140543,0.02205657102011641,73,84,11,3,3,3,6,8,74,8,33
301,100,100,66,66,0,100,100,43,43,0,100,100,66,66,0,0.020729092208720514,0.027026107083290785,85,88,3,2,1,1,11,6,33,13,24
302,53,259,62,97,35,32,32,70,70,0,32,32,70,70,0,0.008203138296061813,0.019469689233806462,64,82,18,3,3,3,2,8,95,57,37
303,49,255,65,98,33,22,22,49,49,0,22,22,53,53,0,0.005786446100956465,0.026719765819122502,60,88,28,3,3,3,2,4,90,22,1
304,22,228,45,93,48,52,52,42,42,0,22,34,45,50,5,0.0017359338302869397,0.004731270635487933,44,52,8,3,3,3,7,2,62,52,29
305,120,1760,81,100,19,240,264,77,80,3,120,264,81,95,14,0.006467204465774873,0.02900030634126417,57,89,32,1,2,2,16,6,4,13,15
306,0,616,1,100,99,0,28,1,42,41,0,28,1,48,47,0.0,0.022226760611321013,1,88,87,2,-1,3,3,0,66,93,11
307,100,100,67,67,0,100,100,54,54,0,100,100,67,67,0,0.034105994077402224,0.03526328329759352,94,94,0,3,1,1,8,8,27,8,54
308,73,689,56,100,44,154,154,67,67,0,73,129,56,80,24,0.005888559855679227,0.010619830491167161,56,68,12,2,2,2,10,4,18,22,13
309,28,28,45,45,0,70,70,39,39,0,28,28,45,45,0,0.0013615167296368155,0.0013615167296368155,40,40,0,-1,3,3,10,3,22,43,91
310,46,252,48,90,42,116,116,58,58,0,46,60,48,52,4,0.002927260968719153,0.003642057251778481,49,51,2,3,2,2,14,2,25,83,64
311,0,616,1,100,99,0,30,1,44,43,0,30,1,54,53,0.0,0.008169100377820893,1,64,63,2,-1,3,4,0,77,81,57
312,0,206,1,92,91,0,20,1,31,30,0,12,1,36,35,0.0,0.0010211375472276116,1,39,38,3,-1,4,6,0,69,93,61
313,16,117,43,84,41,40,40,49,49,0,16,17,43,46,3,0.0026209197045508697,0.0026889955410327104,48,48,0,6,3,3,4,2,73,94,78
314,64,64,57,57,0,128,128,69,69,0,64,64,57,57,0,0.007692569522448007,0.007692569522448007,62,62,0,-1,3,3,8,4,30,38,91
315,296,296,94,94,0,320,320,95,95,0,296,296,93,93,0,0.024098846114571634,0.024098846114571634,86,86,0,-1,2,2,14,20,17,23,99
316,100,100,67,67,0,100,100,54,54,0,100,100,67,67,0,0.031314884781646755,0.031314884781646755,91,91,0,-1,1,1,9,6,35,77,45
317,118,734,79,100,21,104,104,80,80,0,104,104,81,81,0,0.013581129378127233,0.034990979951666154,76,92,16,2,2,2,5,9,63,27,1
318,6,6,32,32,0,34,34,33,33,0,6,6,32,32,0,0.0007828721195411688,0.0007828721195411688,37,37,0,-1,4,4,7,1,46,71,97
319,250,456,95,99,4,216,216,93,93,0,216,216,94,94,0,0.02379250485040335,0.02917049593246877,85,89,4,3,2,2,9,18,28,30,24
320,132,232,86,94,8,44,44,50,50,0,44,44,57,57,0,0.01606589740971442,0.016133973246196264,77,78,1,4,3,3,4,16,73,12,4
321,80,181,58,90,32,130,130,65,65,0,80,81,58,58,0,0.006092787365124749,0.00616086320160659,57,57,0,5,3,3,10,6,36,26,95
322,0,616,1,100,99,0,108,1,57,56,0,108,1,79,78,0.0,0.01678069369277375,1,77,76,2,-1,3,13,0,13,86,23
323,0,206,1,96,95,0,8,1,33,32,0,6,1,33,32,0.0,0.0018040096667687805,1,42,41,3,-1,4,2,0,93,36,53
324,0,616,1,100,99,0,40,1,38,37,0,40,1,52,51,0.0,0.021341774737057083,1,86,85,2,-1,3,5,0,63,84,11
325,166,266,95,100,5,32,32,67,67,0,32,32,68,68,0,0.03185949147350148,0.032370060247115286,94,94,0,4,3,3,2,29,97,0,63
326,82,682,71,100,29,38,38,57,57,0,38,38,59,59,0,0.012219612648490419,0.031178733108683073,75,91,16,2,3,3,3,8,55,20,0
327,56,56,63,63,0,48,48,66,66,0,48,48,67,67,0,0.005173763572619898,0.005173763572619898,60,60,0,-1,3,3,3,6,76,28,99
328,0,206,1,87,86,0,38,1,30,29,0,8,1,33,32,0.0,0.0008509479560230097,1,35,34,3,-1,4,14,0,16,89,74
329,16,16,33,33,0,66,66,36,36,0,16,16,33,33,0,0.0006126825283365669,0.0006126825283365669,36,36,0,-1,3,3,10,1,0,49,67
330,16,118,41,82,41,24,24,41,41,0,16,18,41,46,5,0.0006807583648184077,0.0020422750944552232,37,46,9,4,3,3,3,1,64,49,53
331,46,46,62,62,0,22,22,47,47,0,22,22,52,52,0,0.005071649817897137,0.005071649817897137,58,58,0,-1,3,3,2,6,89,26,36
332,42,42,57,57,0,46,46,81,81,0,42,42,81,81,0,0.010007147962830594,0.010007147962830594,70,70,0,-1,2,2,2,2,89,74,69
333,16,632,37,100,63,56,76,44,58,14,16,76,37,65,28,0.0018040096667687805,0.013751318969331836,45,74,29,2,3,3,6,1,34,53,32
334,6,108,28,77,49,27,28,28,30,2,6,8,28,32,4,0.00030634126416828345,0.0005446066918547262,31,34,3,4,4,4,10,1,36,60,49
335,363,963,98,100,2,200,200,96,96,0,200,200,97,97,0,0.03594404166241193,0.04377276285782362,93,96,3,2,2,2,8,29,39,11,8
336,64,166,55,85,30,128,128,69,69,0,64,66,55,56,1,0.007216038667075122,0.007216038667075122,61,61,0,4,3,3,8,4,42,72,95
337,0,0,1,1,0,0,0,1,1,0,0,0,1,1,0,0.0,0.0,1,1,0,-1,-1,-1,4,1,72,45,98
338,0,101,1,80,79,0,3,1,24,23,0,1,1,24,23,0.0,0.00010211375472276115,1,29,28,5,-1,6,3,0,76,79,65
339,144,744,89,100,11,48,48,70,70,0,48,48,72,72,0,0.017052997038701112,0.022737329384934817,79,88,9,2,3,3,3,18,94,5,54
340,0,102,1,83,82,0,4,1,28,27,0,2,1,26,25,0.0,0.0033357159876101976,1,49,48,4,-1,5,2,0,99,40,90
341,0,206,1,92,91,0,18,1,32,31,0,6,1,32,31,0.0,0.001599782157323258,1,44,43,3,-1,4,5,0,88,40,94
342,22,638,43,100,57,40,40,39,39,0,22,40,43,52,9,0.0020763130126961434,0.013989584397018279,45,77,32,2,3,3,5,2,63,75,6
343,130,746,83,100,17,88,88,76,76,0,88,88,79,79,0,0.011709043874876613,0.03655672419074849,74,93,19,2,2,2,4,13,47,24,0
344,88,704,67,100,33,110,110,80,80,0,88,104,67,82,15,0.010381565063480718,0.013683243132849994,70,77,7,2,2,2,6,4,48,72,46
345,12,1652,37,100,63,12,46,32,78,46,12,46,37,80,43,0.0018380475850097008,0.05568603424214575,44,98,54,1,4,2,2,2,91,83,29
346,0,0,1,1,0,0,0,1,1,0,0,0,1,1,0,0.0,0.0,1,1,0,-1,-1,-1,8,0,21,85,79
347,0,0,1,1,0,0,0,1,1,0,0,0,1,1,0,0.0,0.0,1,1,0,-1,-1,-1,2,0,89,85,87
348,100,100,76,76,0,100,100,90,90,0,100,100,90,90,0,0.04595118962524252,0.0490826781034072,95,96,1,3,1,1,4,6,72,34,28
349,73,1713,59,100,41,116,150,77,85,8,73,150,59,85,26,0.005854521937438306,0.027638789611627353,57,88,31,1,2,2,7,4,43,22,32
350,30,30,46,46,0,100,100,47,47,0,30,30,46,46,0,0.00442492937131965,0.00442492937131965,52,52,0,-1,3,3,10,6,22,73,59
351,276,476,98,100,2,72,72,87,87,0,72,72,87,87,0,0.04084550188910446,0.046734061744783686,94,96,2,3,2,2,3,29,55,1,20
352,39,39,55,55,0,54,54,59,59,0,39,39,57,57,0,0.004629156880765172,0.004629156880765172,55,55,0,-1,3,3,4,4,77,22,81
353,168,374,87,98,11,128,128,69,69,0,128,128,82,82,0,0.012491915994417782,0.014329963579427483,75,76,1,3,3,3,8,14,30,32,46
354,0,616,1,100,99,0,44,1,35,34,0,44,1,52,51,0.0,0.008543517478471017,1,67,66,2,-1,3,9,0,23,98,14
355,0,102,1,75,74,0,9,1,27,26,0,3,1,28,27,0.0,0.0004084550188910446,1,32,31,4,-1,5,6,1,59,50,63
356,6,1646,29,100,71,19,92,29,46,17,6,92,29,61,32,0.00010211375472276115,0.02573266619013581,30,87,57,1,4,2,8,1,42,60,5
357,24,24,48,48,0,42,42,41,41,0,24,24,48,48,0,0.0012253650566731338,0.0012253650566731338,41,41,0,-1,3,3,6,4,32,64,45
358,16,16,37,37,0,46,46,39,39,0,16,16,37,37,0,0.0012594029749140542,0.0012594029749140542,41,41,0,-1,3,3,6,1,41,71,40
359,290,906,95,100,5,222,222,92,92,0,222,222,94,94,0,0.02375846693216243,0.03008951972497362,83,91,8,2,2,2,10,19,12,15,31
360,2,208,28,92,64,6,14,30,34,4,2,10,28,39,11,0.0,0.0030974505599237552,1,51,50,3,5,4,3,1,76,95,29
361,0,206,1,91,90,0,12,1,28,27,0,8,1,34,33,0.0,0.000442492937131965,1,34,33,3,-1,4,5,0,52,36,63
362,0,102,1,75,74,0,7,1,26,25,0,2,1,26,25,0.0,0.00010211375472276115,1,28,27,4,-1,5,6,1,65,45,60
363,152,152,85,85,0,100,100,71,71,0,100,100,72,72,0,0.01664454201981007,0.01664454201981007,77,77,0,-1,2,2,6,13,56,33,97
364,0,616,1,100,99,0,74,1,48,47,0,74,1,61,60,0.0,0.012900371013308825,1,74,73,2,-1,3,8,0,21,40,37
365,0,102,1,78,77,0,22,1,27,26,0,2,1,26,25,0.0,0.000442492937131965,1,32,31,4,-1,5,13,0,13,91,49
366,0,102,1,77,76,0,7,1,27,26,0,2,1,27,26,0.0,0.0005446066918547262,1,37,36,4,-1,5,4,0,84,97,42
367,142,244,90,94,4,96,96,87,87,0,96,96,87,87,0,0.021511964328261683,0.023179822322066782,87,88,1,4,2,2,3,8,87,8,94
368,0,0,1,1,0,0,0,1,1,0,0,0,1,1,0,0.0,0.0,1,1,0,-1,-1,-1,2,0,93,86,85
369,0,0,1,1,0,0,0,1,1,0,0,0,1,1,0,0.0,0.0,1,1,0,-1,-1,-1,14,0,8,76,80
370,0,206,1,94,93,0,12,1,39,38,0,12,1,41,40,0.0,0.005616256509751864,1,60,59,3,-1,4,2,1,90,45,21
371,96,1736,68,100,32,132,156,73,84,11,96,156,68,87,19,0.009190237925048503,0.042853739065318766,69,95,26,1,2,2,8,6,30,34,10
372,0,616,1,99,98,0,70,1,36,35,0,35,1,43,42,0.0,0.0051397256543789785,1,54,53,2,-1,3,11,0,33,89,22
373,2,618,28,100,72,4,22,29,51,22,2,22,28,53,25,0.00017018959120460194,0.010007147962830594,32,67,35,2,5,3,2,1,86,4,44
374,70,686,60,100,40,78,88,69,70,1,78,88,70,70,0,0.011164437183021887,0.030736240171551108,71,94,23,2,2,2,4,6,53,34,11
375,22,228,47,94,47,28,28,45,45,0,22,28,47,49,2,0.0025188059498281084,0.022396950202525613,46,86,40,3,3,3,3,3,58,51,7
376,92,92,65,65,0,118,118,68,68,0,92,92,65,65,0,0.010790020082371761,0.010790020082371761,69,69,0,-1,3,3,8,8,21,20,45
377,0,102,1,84,83,0,5,1,29,28,0,2,1,26,25,0.0,0.0006467204465774873,1,35,34,4,-1,5,3,0,92,93,42
378,16,222,45,93,48,28,28,46,46,0,16,28,44,50,6,0.003165526396405596,0.011879233466081215,49,73,24,3,3,3,3,3,85,46,33
379,100,100,67,67,0,100,100,54,54,0,100,100,67,67,0,0.028591851322373123,0.029647026787841656,89,89,0,3,1,1,8,7,27,21,61
380,16,1656,33,100,67,166,230,61,74,13,16,230,33,92,59,0.003812246842983083,0.031655263964055956,50,91,41,1,3,2,16,1,4,90,1
381,0,616,1,99,98,0,96,1,42,41,0,96,1,58,57,0.0,0.01596378365499166,1,75,74,2,-1,3,11,0,5,40,23
382,22,638,40,100,60,126,136,63,66,3,22,59,40,57,17,0.002212464685659825,0.00793083495013445,45,64,19,2,3,3,11,2,38,61,34
383,122,1762,76,100,24,104,128,73,90,17,104,128,79,90,11,0.012151536812008578,0.041219918989754585,75,94,19,1,2,2,5,9,52,27,14
384,0,206,1,94,93,0,14,1,36,35,0,14,1,42,41,0.0,0.007590455767725246,1,67,66,3,-1,4,3,0,81,82,8
385,100,100,61,61,0,100,100,40,40,0,100,100,61,61,0,0.02205657102011641,0.02205657102011641,83,83,0,5,1,1,14,9,8,27,78
386,192,1832,87,100,13,120,144,77,88,11,120,144,84,89,5,0.01327478811395895,0.05517546546853194,76,98,22,1,2,2,6,14,40,32,2
387,122,223,87,95,8,96,96,92,92,0,96,96,92,92,0,0.020354675108070392,0.020354675108070392,86,86,0,6,2,2,3,13,96,33,68
388,0,616,1,100,99,0,66,1,47,46,0,66,1,58,57,0.0,0.017087034956942034,1,81,80,2,-1,3,6,0,59,84,30
389,0,0,1,1,0,0,0,1,1,0,0,0,1,1,0,0.0,0.0,1,1,0,-1,-1,-1,14,0,17,97,89
390,0,1640,1,100,99,0,86,1,56,55,0,86,1,65,64,0.0,0.03094046768099663,1,94,93,1,-1,2,6,0,65,96,18
391,370,576,97,100,3,176,176,98,98,0,176,176,98,98,0,0.03859899928520372,0.04135607066271827,92,93,1,3,2,2,5,27,61,10,41
392,16,117,35,81,46,34,34,39,39,0,16,17,35,40,5,0.0026209197045508697,0.0026209197045508697,43,43,0,5,3,3,4,3,67,46,95
393,1,102,26,81,55,4,4,26,26,0,1,2,26,27,1,0.0,0.00010211375472276115,1,29,28,5,6,6,4,1,72,68,88
394,100,100,62,62,0,100,100,43,43,0,100,100,62,62,0,0.04949113312229824,0.049559208958780084,98,98,0,4,1,1,12,29,14,11,4
395,22,22,38,38,0,80,80,42,42,0,22,22,38,38,0,0.0012594029749140542,0.0012594029749140542,39,39,0,-1,3,3,10,2,0,74,45
396,134,340,87,98,11,96,96,87,87,0,96,96,87,87,0,0.01405766023350012,0.020865243881684196,77,86,9,3,2,2,3,7,87,21,31
397,6,212,32,91,59,24,24,38,38,0,6,24,32,49,17,0.002723033459273631,0.006092787365124749,48,58,10,3,4,4,4,3,79,46,47
398,1,1,26,26,0,4,4,26,26,0,1,1,26,26,0,3.4037918240920386e-05,3.4037918240920386e-05,26,26,0,-1,6,6,4,1,47,68,45
399,22,228,40,91,51,88,92,42,43,1,22,37,40,47,7,0.0026549576227917903,0.005446066918547262,47,60,13,3,3,3,11,2,38,83,41
400,0,0,1,1,0,0,0,1,1,0,0,0,1,1,0,0.0,0.0,1,1,0,-1,-1,-1,10,0,12,81,87
401,24,640,50,100,50,22,32,47,63,16,22,32,52,63,11,0.005037611899656217,0.02375846693216243,57,87,30,2,3,3,2,6,89,73,5
402,0,206,1,95,94,0,8,1,31,30,0,8,1,37,36,0.0,0.017189148711664794,1,80,79,3,-1,4,2,0,95,76,7
403,22,622,41,100,59,48,48,36,36,0,22,22,41,41,0,0.0009190237925048504,0.0018720855032506212,37,43,6,2,3,3,9,2,35,63,49
404,0,0,1,1,0,0,0,1,1,0,0,0,1,1,0,0.0,0.0,1,1,0,-1,-1,-1,3,0,58,40,85
405,188,804,87,100,13,166,166,83,83,0,166,166,88,88,0,0.011164437183021887,0.015180911535450491,73,78,5,2,2,2,8,13,42,24,47
406,0,616,1,100,99,0,42,1,35,34,0,42,1,51,50,0.0,0.011675005956635693,1,71,70,2,-1,3,6,0,51,91,30
407,0,0,1,1,0,0,0,1,1,0,0,0,1,1,0,0.0,0.0,1,1,0,-1,-1,-1,8,0,42,86,87
408,0,0,1,1,0,0,0,1,1,0,0,0,1,1,0,0.0,0.0,1,1,0,-1,-1,-1,7,0,43,40,96
409,198,198,94,94,0,88,88,71,71,0,88,88,71,71,0,0.01929949964260186,0.01929949964260186,83,83,0,-1,2,2,4,18,53,5,67
410,364,980,99,100,1,176,176,87,87,0,176,176,91,91,0,0.03475271452397971,0.042275094455223115,92,96,4,2,2,2,8,30,39,7,31
411,100,100,76,76,0,100,100,90,90,0,100,100,90,90,0,0.05582218591510943,0.055958337588073115,97,97,0,4,1,1,4,12,72,37,4
412,0,0,1,1,0,0,0,1,1,0,0,0,1,1,0,0.0,0.0,1,1,0,-1,-1,-1,9,0,23,91,79
413,16,16,38,38,0,114,114,61,61,0,16,16,38,38,0,0.0020422750944552232,0.0020422750944552232,43,43,0,-1,3,3,9,1,54,53,59
414,13,115,41,82,41,18,18,35,35,0,13,18,41,45,4,0.0012253650566731338,0.002144388849177984,39,43,4,4,4,4,3,4,58,64,71
415,0,1640,1,100,99,0,62,1,74,73,0,62,1,75,74,0.0,0.053609721229449604,1,97,96,1,-1,2,3,0,82,67,0
416,36,36,51,51,0,50,50,45,45,0,35,35,51,51,0,0.0035739814152966403,0.0035739814152966403,51,51,0,-1,3,3,5,6,45,41,93
417,160,360,91,99,8,48,48,64,64,0,48,48,66,66,0,0.019027196296674494,0.03448041117805235,83,93,10,3,3,3,3,19,85,15,9
418,238,238,90,90,0,192,192,87,87,0,192,192,88,88,0,0.020252561353347628,0.020252561353347628,82,82,0,-1,2,2,9,16,54,12,81
419,18,634,41,100,59,46,56,43,47,4,18,56,41,56,15,0.0014295925661186562,0.011232513019503728,42,69,27,2,3,3,6,2,65,61,77
420,0,206,1,88,87,0,38,1,31,30,0,6,1,28,27,0.0,0.0019741992579733825,1,42,41,3,-1,4,11,0,33,92,94
421,66,272,61,94,33,80,80,68,68,0,66,80,66,71,5,0.010041185881071514,0.01504475986248681,69,77,8,3,3,3,5,5,88,25,44
422,169,169,90,90,0,104,104,86,86,0,104,104,86,86,0,0.0230436706491031,0.0230436706491031,86,86,0,-1,2,2,5,16,45,18,97
423,100,100,79,79,0,100,100,95,95,0,100,100,95,95,0,0.08386943054562783,0.08809013240750195,98,99,1,2,1,1,3,29,75,0,26
424,0,206,1,91,90,0,12,1,27,26,0,6,1,26,25,0.0,0.0012253650566731338,1,36,35,3,-1,4,4,0,67,92,53
425,100,100,79,79,0,100,100,95,95,0,100,100,95,95,0,0.08386943054562783,0.08608189523128766,98,99,1,3,1,1,3,29,75,0,22
426,142,142,84,84,0,80,80,59,59,0,80,80,63,63,0,0.013479015623404473,0.013479015623404473,77,77,0,-1,3,3,5,13,61,33,99
427,8,214,36,94,58,12,12,32,32,0,8,12,36,36,0,0.0004084550188910446,0.00176997174852786,34,41,7,3,4,4,2,2,91,56,61
428,16,16,34,34,0,70,70,37,37,0,16,16,34,34,0,0.0006807583648184077,0.0006807583648184077,36,36,0,-1,3,3,11,1,33,49,96
429,74,690,60,100,40,100,100,66,66,0,68,100,58,74,16,0.006024711528642908,0.024234997787535316,55,85,30,2,2,2,6,6,51,41,9
430,120,221,80,92,12,152,152,80,80,0,120,121,81,81,0,0.010449640899962559,0.010449640899962559,70,70,0,5,2,2,8,7,30,21,68
431,22,22,40,40,0,90,90,36,36,0,22,22,40,40,0,0.00088498587426393,0.00088498587426393,37,37,0,-1,3,3,16,3,4,51,86
432,42,248,56,96,40,22,22,48,48,0,22,22,51,51,0,0.007216038667075122,0.014500153170632085,61,76,15,3,3,3,2,6,95,34,27
433,0,0,1,1,0,0,0,1,1,0,0,0,1,1,0,0.0,0.0,1,1,0,-1,-1,-1,6,0,51,81,36
434,40,40,50,50,0,144,144,72,72,0,40,40,50,50,0,0.004663194799006093,0.004663194799006093,54,54,0,-1,2,2,10,3,22,46,80
435,0,0,1,1,0,0,0,1,1,0,0,0,1,1,0,0.0,0.0,1,1,0,-1,-1,-1,6,0,56,93,89
436,50,256,61,97,36,22,22,48,48,0,22,22,51,51,0,0.005071649817897137,0.008645631233193778,56,65,9,3,3,3,2,5,95,47,13
437,140,140,81,81,0,224,224,87,87,0,140,140,81,81,0,0.013138636440995268,0.013138636440995268,75,75,0,-1,2,2,11,8,19,17,36
438,0,206,1,89,88,0,24,1,31,30,0,6,1,28,27,0.0,0.001599782157323258,1,41,40,3,-1,4,8,0,42,86,94
439,100,100,63,63,0,100,100,45,45,0,100,100,63,63,0,0.034990979951666154,0.034990979951666154,93,93,0,-1,1,1,11,18,19,30,76
440,183,389,85,96,11,192,192,87,87,0,192,192,88,88,0,0.01776779332176044,0.019571802988529223,77,81,4,3,2,2,9,15,54,19,94
441,0,101,1,74,73,0,14,1,25,24,0,1,1,25,24,0.0,3.4037918240920386e-05,1,26,25,5,-1,6,14,1,16,45,58
442,153,153,87,87,0,104,104,88,88,0,104,104,88,88,0,0.018312400013615168,0.018312400013615168,81,81,0,-1,2,2,5,15,88,19,86
443,62,678,57,100,43,154,154,71,71,0,62,154,57,88,31,0.0038462847612240037,0.011606930120153852,53,74,21,2,2,2,10,6,1,70,32
444,6,6,28,28,0,32,32,29,29,0,6,6,28,28,0,0.0002042275094455223,0.0002042275094455223,32,32,0,-1,4,4,16,1,9,55,98
445,0,1640,1,100,99,0,86,1,56,55,0,86,1,64,63,0.0,0.030532012662105586,1,93,92,1,-1,2,6,0,65,97,18
446,174,275,87,96,9,192,192,86,86,0,192,192,89,89,0,0.020150447598624867,0.020150447598624867,83,83,0,5,2,2,9,12,28,37,68
447,0,0,1,1,0,0,0,1,1,0,0,0,1,1,0,0.0,0.0,1,1,0,-1,-1,-1,6,0,56,67,84
448,0,616,1,100,99,0,40,1,39,38,0,30,1,47,46,0.0,0.005888559855679227,1,54,53,2,-1,3,5,1,52,69,38
449,242,448,93,98,5,184,184,94,94,0,184,184,94,94,0,0.02467749072466728,0.027808979202831954,87,88,1,3,2,2,7,17,43,6,26
450,0,102,1,83,82,0,4,1,29,28,0,2,1,27,26,0.0,0.0007147962830593281,1,37,36,4,-1,5,2,0,89,91,71
451,48,48,61,61,0,28,28,44,44,0,28,28,51,51,0,0.007113924912352361,0.007113924912352361,64,64,0,-1,3,3,3,7,92,48,79
452,47,47,57,57,0,34,34,45,45,0,34,34,53,53,0,0.007522379931243405,0.007522379931243405,63,63,0,-1,3,3,4,8,84,44,45
453,76,692,63,100,37,68,68,72,72,0,68,68,74,74,0,0.009054086252084823,0.026855917492086184,63,88,25,2,2,2,4,6,67,41,16
454,0,206,1,87,86,0,28,1,28,27,0,6,1,28,27,0.0,0.0002723033459273631,1,33,32,3,-1,4,14,0,16,92,88
455,46,246,58,96,38,22,22,48,48,0,22,22,51,51,0,0.007726607440688927,0.023315973995030465,63,86,23,3,3,3,2,7,95,21,7
456,240,446,93,99,6,190,190,92,92,0,190,190,93,93,0,0.02100139555464788,0.024166921951053473,83,85,2,3,2,2,8,18,57,5,47
457,132,1772,82,100,18,100,134,66,85,19,100,134,72,86,14,0.013751318969331836,0.050274005241839406,77,98,21,1,2,2,6,8,44,8,7
458,2,2,28,28,0,4,4,31,31,0,2,2,28,28,0,0.0002723033459273631,0.0002723033459273631,32,32,0,-1,5,5,2,1,95,55,89
459,464,1080,98,100,2,288,288,98,98,0,288,288,98,98,0,0.03727152047380782,0.05561795840566391,96,99,3,2,2,2,9,30,54,7,1
460,0,101,1,70,69,0,11,1,25,24,0,1,1,25,24,0.0,0.0,1,1,0,5,-1,6,11,0,5,87,58
461,0,616,1,100,99,0,38,1,34,33,0,38,1,48,47,0.0,0.005854521937438306,1,54,53,2,-1,3,6,1,40,69,44
462,86,702,63,100,37,92,92,62,62,0,86,92,66,67,1,0.00789679703189353,0.022396950202525613,63,85,22,2,3,3,7,7,62,21,18
463,16,118,36,78,42,40,40,42,42,0,16,22,36,47,11,0.002110350930937064,0.003165526396405596,46,50,4,4,3,3,5,2,61,94,43
464,6,6,29,29,0,29,29,31,31,0,6,6,29,29,0,0.0002042275094455223,0.0002042275094455223,31,31,0,-1,4,4,12,1,3,65,98
465,126,332,80,96,16,136,136,81,81,0,126,136,84,87,3,0.013138636440995268,0.020558902617515914,77,85,8,3,2,2,7,8,46,17,8
466,6,6,30,30,0,18,18,32,32,0,6,6,30,30,0,0.00034037918240920387,0.00034037918240920387,31,31,0,-1,4,4,6,1,65,55,84
467,70,172,59,87,28,118,118,66,66,0,70,72,59,60,1,0.0063650907110521125,0.006705469893461316,60,60,0,4,3,3,8,6,30,26,63
468,134,134,88,88,0,72,72,85,85,0,72,72,85,85,0,0.02474556656114912,0.02474556656114912,86,86,0,-1,2,2,3,20,60,23,84
469,22,638,43,100,57,88,98,48,51,3,22,64,43,57,14,0.0021784267674189047,0.007794683277170768,45,62,17,2,3,3,8,2,15,52,28
470,1,207,26,93,67,5,18,26,33,7,1,17,26,44,18,6.807583648184077e-05,0.0037441710065012424,28,51,23,3,6,4,5,2,49,58,38
471,100,100,57,57,0,100,100,38,38,0,100,100,57,57,0,0.031110657272201234,0.0348888661969434,90,94,4,2,1,1,16,17,4,6,35
472,0,206,1,93,92,0,20,1,36,35,0,8,1,37,36,0.0,0.003437829742332959,1,51,50,3,-1,4,4,0,72,40,29
473,100,100,63,63,0,100,100,56,56,0,100,100,63,63,0,0.0424112461281868,0.043364307838932574,96,96,0,3,1,1,7,16,24,12,51
474,0,206,1,92,91,0,22,1,33,32,0,22,1,43,42,0.0,0.004629156880765172,1,52,51,3,-1,4,5,0,37,87,57
475,1,1,25,25,0,6,6,25,25,0,1,1,25,25,0,3.4037918240920386e-05,3.4037918240920386e-05,28,28,0,-1,6,6,6,1,69,78,89
476,124,1764,82,100,18,182,206,87,94,7,124,206,84,95,11,0.013070560604513427,0.03682902753667586,71,94,23,1,2,2,9,6,23,77,30
477,6,622,30,100,70,32,48,31,33,2,6,22,30,39,9,0.00017018959120460194,0.0015317063208414173,30,40,10,2,4,3,11,1,38,65,42
478,1,207,26,91,65,7,14,26,30,4,1,7,26,34,8,0.0,0.00017018959120460194,1,30,29,3,6,4,7,2,62,58,4
479,184,784,84,100,16,166,166,84,84,0,166,166,85,85,0,0.011947309302563056,0.015385139044896015,69,73,4,2,2,2,8,13,27,24,29
480,0,616,1,100,99,0,25,1,35,34,0,16,1,38,37,0.0,0.0014636304843595766,1,42,41,2,-1,3,6,0,69,79,49
481,174,1814,83,100,17,298,332,85,91,6,174,264,83,93,10,0.012287688484972258,0.023384049831512304,68,87,19,1,2,2,16,7,9,48,21
482,100,100,69,69,0,100,100,55,55,0,100,100,69,69,0,0.021443888491779844,0.021443888491779844,81,81,0,-1,1,1,9,6,26,73,93
483,100,100,63,63,0,100,100,39,39,0,100,100,63,63,0,0.018176248340651485,0.019265461724360937,78,80,2,3,1,1,14,8,17,44,54
484,100,100,62,62,0,100,100,45,45,0,100,100,62,62,0,0.03274447734776541,0.03284659110248817,90,90,0,5,1,1,12,12,3,37,78
485,184,184,87,87,0,144,144,88,88,0,144,144,88,88,0,0.013410939786922631,0.013410939786922631,76,76,0,-1,2,2,6,13,44,24,98
486,430,430,97,97,0,320,320,92,92,0,320,320,95,95,0,0.032029681064706085,0.032029681064706085,92,92,0,-1,2,2,14,27,16,10,36
487,9,9,44,44,0,12,12,39,39,0,12,12,44,44,0,0.0011913271384322134,0.0011913271384322134,41,41,0,-1,4,4,2,3,97,43,89
488,391,391,100,100,0,168,168,97,97,0,168,168,97,97,0,0.03403791824092039,0.03403791824092039,94,94,0,-1,2,2,6,30,59,7,45
489,0,102,1,76,75,0,10,1,30,29,0,4,1,30,29,0.0,0.0014636304843595766,1,41,40,4,-1,5,5,0,70,81,61
490,16,16,31,31,0,82,82,37,37,0,16,16,31,31,0,0.0005786446100956465,0.0005786446100956465,37,37,0,-1,3,3,14,2,25,42,80
491,112,1752,84,100,16,32,56,58,79,21,32,56,60,80,20,0.018857006705469893,0.06793968480887709,84,98,14,1,3,2,2,17,91,6,29
492,0,102,1,77,76,0,10,1,26,25,0,2,1,26,25,0.0,6.807583648184077e-05,1,28,27,4,-1,5,9,0,35,92,4
493,0,616,1,100,99,0,38,1,46,45,0,38,1,52,51,0.0,0.01923142380612002,1,85,84,2,-1,3,3,0,75,76,23
494,138,240,86,92,6,102,102,92,92,0,102,102,92,92,0,0.014398039415909322,0.016304162837400864,76,80,4,4,2,2,4,13,79,24,46
495,32,648,51,100,49,54,64,52,59,7,32,64,51,62,11,0.004356853534837809,0.014908608189523128,54,77,23,2,3,3,4,3,83,29,8
496,22,638,41,100,59,78,98,37,41,4,22,70,41,56,15,0.0019061234214915416,0.009905034208107831,43,66,23,2,3,3,12,2,14,83,34
497,0,206,1,87,86,0,36,1,33,32,0,12,1,34,33,0.0,0.0014295925661186562,1,40,39,3,-1,4,10,0,22,67,52
498,84,700,60,100,40,144,164,69,73,4,84,122,60,79,19,0.005820484019197386,0.01317267435923619,57,75,18,2,2,2,10,6,1,28,25
499,50,256,60,93,33,54,54,55,55,0,54,54,60,60,0,0.005480104836788182,0.01147077844719017,56,69,13,3,3,3,4,5,84,47,44
500,260,876,94,100,6,224,224,98,98,0,224,224,98,98,0,0.021648116001225366,0.027843017121072875,84,88,4,2,2,2,8,18,10,5,21
501,0,206,1,90,89,0,26,1,34,33,0,26,1,47,46,0.0,0.006297014874570271,1,59,58,3,-1,4,5,0,80,76,77
502,0,102,1,78,77,0,7,1,28,27,0,3,1,32,31,0.0,0.000442492937131965,1,35,34,4,-1,5,4,0,47,82,51
503,124,1764,78,100,22,284,308,81,86,5,124,308,78,96,18,0.011879233466081215,0.04309200449300521,66,95,29,1,2,2,16,6,9,77,11
504,12,628,37,100,63,22,32,34,40,6,12,29,37,47,10,0.0006807583648184077,0.004016474352428605,36,50,14,2,4,3,5,2,88,56,54
505,100,100,75,75,0,100,100,89,89,0,100,100,89,89,0,0.0719561591613057,0.07638108853262535,99,100,1,3,1,1,4,29,73,0,31
506,150,1750,86,100,14,240,240,89,89,0,150,240,86,93,7,0.01412573606998196,0.03311889444841554,73,90,17,1,2,2,12,8,6,17,12
507,16,222,35,91,56,70,70,38,38,0,16,22,35,40,5,0.0022465026039007454,0.0045270431260424114,44,54,10,3,3,3,10,2,18,94,46
508,126,332,78,96,18,168,168,85,85,0,126,132,79,81,2,0.015283025290173252,0.01606589740971442,76,77,1,3,2,2,9,8,29,20,78
509,223,429,97,100,3,56,56,88,88,0,56,56,88,88,0,0.038428809693999116,0.04111780523503183,96,96,0,3,2,2,2,29,93,1,29
510,22,123,44,81,37,46,46,43,43,0,22,23,44,46,2,0.003437829742332959,0.003437829742332959,49,49,0,5,3,3,6,3,69,29,95
511,0,1640,1,100,99,0,156,1,69,68,0,156,1,83,82,0.0,0.03798631675686715,1,98,97,1,-1,2,12,0,2,81,10
512,100,100,64,64,0,100,100,49,49,0,100,100,64,64,0,0.049763436468225605,0.07450900302937473,98,100,2,1,1,1,8,22,42,9,16
513,0,616,1,100,99,0,34,1,46,45,0,34,1,54,53,0.0,0.010755982164130842,1,71,70,2,-1,3,4,0,77,93,19
514,0,616,1,100,99,0,42,1,35,34,0,42,1,51,50,0.0,0.009632730862180468,1,67,66,2,-1,3,6,0,40,36,39
515,46,662,54,100,46,68,78,66,68,2,46,78,57,69,12,0.004629156880765172,0.020831205963443275,54,86,32,2,2,2,4,2,53,52,23
516,136,752,79,100,21,238,238,87,87,0,136,172,79,83,4,0.009734844616903231,0.014806494434800367,64,74,10,2,2,2,11,4,5,72,26
517,22,228,45,91,46,32,40,40,40,0,22,40,45,53,8,0.0020082371762143027,0.005548180673270023,45,59,14,3,3,3,5,3,80,51,26
518,80,696,65,100,35,100,100,70,70,0,80,100,65,71,6,0.010007147962830594,0.015725518227305217,68,79,11,2,2,2,6,5,65,25,34
519,0,206,1,96,95,0,18,1,35,34,0,18,1,44,43,0.0,0.003914360597705844,1,51,50,3,-1,4,3,0,75,98,62
520,122,122,81,81,0,110,110,86,86,0,110,110,86,86,0,0.01606589740971442,0.01606589740971442,78,78,0,-1,2,2,6,9,69,39,36
521,0,102,1,74,73,0,26,1,27,26,0,4,1,27,26,0.0,0.0002042275094455223,1,31,30,4,-1,5,16,0,4,91,63
522,14,630,34,100,66,56,66,35,38,3,14,52,34,54,20,0.0013615167296368155,0.007352190340038803,41,60,19,2,4,3,10,3,36,43,34
523,100,100,64,64,0,100,100,49,49,0,100,100,64,64,0,0.03887130263113108,0.03887130263113108,93,93,0,-1,1,1,8,17,42,6,96
524,66,168,64,88,24,70,70,59,59,0,70,70,66,66,0,0.009564655025698629,0.00966676878042139,69,70,1,4,3,3,5,6,80,77,63
525,100,100,59,59,0,100,100,45,45,0,100,100,59,59,0,0.05075053609721229,0.051669559889717144,97,97,0,3,1,1,10,29,0,1,83
526,68,268,63,98,35,72,72,77,77,0,72,72,79,79,0,0.00976888253514415,0.013989584397018279,72,78,6,3,2,2,3,4,96,38,24
527,150,356,87,98,11,88,88,81,81,0,88,88,81,81,0,0.020014295925661188,0.021580040164743523,83,85,2,3,2,2,4,17,73,6,52
528,16,1656,32,100,68,114,218,56,73,17,16,218,32,90,58,0.0021784267674189047,0.026004969536063176,45,90,45,1,3,2,14,2,8,94,15
529,8,624,37,100,63,18,28,35,45,10,8,28,37,53,16,0.0015657442390823377,0.006467204465774873,43,57,14,2,4,3,3,2,87,83,47
530,422,422,99,99,0,144,144,91,91,0,144,144,92,92,0,0.047993464719697745,0.047993464719697745,99,99,0,-1,2,2,6,36,51,2,81
531,6,622,27,100,73,28,50,30,34,4,6,28,27,43,16,0.00030634126416828345,0.002825147213996392,31,48,17,2,4,3,12,1,2,88,83
532,0,206,1,92,91,0,20,1,34,33,0,20,1,45,44,0.0,0.0068075836481840775,1,60,59,3,-1,4,4,1,47,45,77
533,100,100,69,69,0,84,84,46,46,0,84,84,64,64,0,0.01065386840940808,0.01065386840940808,68,68,0,-1,3,3,9,14,26,32,93
534,28,130,49,82,33,46,46,42,42,0,28,33,49,50,1,0.0014295925661186562,0.0020763130126961434,41,46,5,4,3,3,6,4,74,64,43
535,6,622,30,100,70,22,40,33,38,5,6,40,30,52,22,0.0008509479560230097,0.016610504101569147,37,78,41,2,4,3,5,2,63,42,16
536,0,102,1,73,72,0,6,1,25,24,0,2,1,25,24,0.0,3.4037918240920386e-05,1,26,25,4,-1,5,5,0,61,76,95
537,16,632,39,100,61,68,78,43,46,3,16,36,39,52,13,0.002144388849177984,0.007454304094761564,46,61,15,2,3,3,8,2,57,94,73
538,100,100,67,67,0,100,100,74,74,0,100,100,75,75,0,0.03819054426631267,0.038258620102794516,95,95,0,5,1,1,5,5,63,25,68
539,16,632,39,100,61,54,88,39,50,11,16,88,39,64,25,0.0011232513019503727,0.014466115252391163,39,78,39,2,3,3,8,1,57,71,5
540,32,32,51,51,0,54,54,55,55,0,32,32,51,51,0,0.004901460226692535,0.004901460226692535,56,56,0,-1,3,3,4,3,73,29,97
541,0,616,1,99,98,0,48,1,34,33,0,16,1,36,35,0.0,0.002757071377514551,1,48,47,2,-1,3,11,1,19,50,94
542,0,0,1,1,0,0,0,1,1,0,0,0,1,1,0,0.0,0.0,1,1,0,-1,-1,-1,6,0,59,66,96
543,34,34,50,50,0,60,60,49,49,0,34,34,50,50,0,0.0030634126416828346,0.0030634126416828346,48,48,0,-1,3,3,5,6,88,70,85
544,24,230,50,98,48,32,32,64,64,0,32,32,64,64,0,0.002723033459273631,0.02110350930937064,47,86,39,3,3,3,2,3,89,54,0
545,0,206,1,96,95,0,12,1,38,37,0,12,1,44,43,0.0,0.004663194799006093,1,55,54,3,-1,4,2,0,93,59,26
546,0,102,1,74,73,0,14,1,26,25,0,2,1,25,24,0.0,0.0,1,1,0,4,-1,5,12,1,3,45,95
547,125,331,79,96,17,102,102,65,65,0,102,102,74,74,0,0.016202049082678104,0.016338200755641786,79,80,1,3,3,3,7,12,46,37,4
548,86,86,58,58,0,170,170,69,69,0,86,86,58,58,0,0.004016474352428605,0.004016474352428605,54,54,0,-1,2,2,12,6,6,70,99
549,0,0,1,1,0,0,0,1,1,0,0,0,1,1,0,0.0,0.0,1,1,0,-1,-1,-1,14,0,25,84,81
550,8,624,39,100,61,12,22,35,51,16,8,22,39,53,14,0.00176997174852786,0.012832295176826986,45,75,30,2,4,3,2,2,86,61,25
551,82,288,59,94,35,174,174,73,73,0,82,90,59,61,2,0.0045270431260424114,0.007726607440688927,56,62,6,3,2,2,11,6,19,70,29
552,334,934,96,100,4,246,246,95,95,0,246,246,96,96,0,0.025290173253003846,0.03958609891419041,88,96,8,2,2,2,10,19,22,15,16
553,8,214,35,94,59,32,32,37,37,0,8,22,35,46,11,0.00034037918240920387,0.002552843868069029,34,48,14,3,4,4,6,2,32,56,70
554,6,212,29,89,60,28,32,30,32,2,6,12,29,34,5,0.00017018959120460194,0.000442492937131965,31,34,3,3,4,4,10,1,18,65,4
555,100,100,70,70,0,100,100,68,68,0,100,100,73,73,0,0.06171074577078866,0.07117328704176452,100,100,0,2,1,1,6,29,48,1,32
556,54,54,64,64,0,32,32,63,63,0,32,32,64,64,0,0.008407365805507334,0.008407365805507334,64,64,0,-1,3,3,2,4,86,38,66
557,100,100,64,64,0,100,100,49,49,0,100,100,64,64,0,0.038939378467612924,0.03972225058715409,94,95,1,3,1,1,8,18,42,5,51
558,130,232,85,97,12,72,72,85,85,0,72,72,85,85,0,0.020456788862793153,0.020558902617515914,82,82,0,4,2,2,3,18,94,30,65
559,40,142,61,93,32,22,22,55,55,0,22,22,57,57,0,0.005548180673270023,0.0061949011198475104,58,61,3,4,3,3,2,6,97,41,71
560,2,103,27,80,53,6,6,29,29,0,2,3,27,31,4,0.00013615167296368154,0.0002042275094455223,30,31,1,5,5,5,3,1,58,65,4
561,94,195,69,92,23,94,94,70,70,0,94,94,72,72,0,0.007011811157629599,0.007011811157629599,62,62,0,5,2,2,5,6,37,26,68
562,0,616,1,100,99,0,110,1,58,57,0,110,1,75,74,0.0,0.020763130126961436,1,84,83,2,-1,3,10,0,18,87,10
563,270,270,91,91,0,286,286,88,88,0,270,270,91,91,0,0.0212056230640934,0.0212056230640934,81,81,0,-1,2,2,14,18,25,30,86
564,40,40,47,47,0,128,128,70,70,0,40,40,47,47,0,0.0030634126416828346,0.0030634126416828346,49,49,0,-1,2,2,9,1,29,53,99
565,180,380,89,97,8,158,158,83,83,0,158,158,87,87,0,0.017972020831205963,0.023350011913271386,81,85,4,3,2,2,9,17,31,6,32
566,100,100,76,76,0,100,100,96,96,0,100,100,96,96,0,0.08356308928145954,0.08356308928145954,100,100,0,6,1,1,3,22,87,9,68
567,16,632,41,100,59,24,34,37,42,5,16,34,41,51,10,0.0034037918240920387,0.010960209673576363,51,70,19,2,4,3,4,6,83,73,24
568,128,230,81,90,9,200,200,84,84,0,128,130,81,81,0,0.01242384015793594,0.012559991830899623,71,71,0,4,2,2,11,9,33,27,88
569,100,100,72,72,0,100,100,77,77,0,100,100,77,77,0,0.036454610436025735,0.038905340549372,94,95,1,3,1,1,6,6,69,73,46
570,22,638,42,100,58,46,56,39,43,4,22,58,42,54,12,0.0018380475850097008,0.007862759113652609,43,63,20,2,3,3,6,2,41,61,26
571,100,100,70,70,0,100,100,53,53,0,100,100,70,70,0,0.03887130263113108,0.03921168181354028,93,93,0,3,1,1,9,18,31,30,65
572,32,648,49,100,51,60,70,51,58,7,32,70,49,65,16,0.00445896728956057,0.013785356887572755,55,75,20,2,3,3,5,3,80,29,32
573,0,206,1,89,88,0,30,1,33,32,0,12,1,37,36,0.0,0.0012594029749140542,1,40,39,3,-1,4,9,0,26,81,52
574,17,17,49,49,0,38,38,49,49,0,17,17,47,47,0,0.0008509479560230097,0.0008509479560230097,37,37,0,-1,3,3,3,2,87,56,40
575,78,678,57,100,43,128,128,72,72,0,78,128,57,82,25,0.0088498587426393,0.03097450559923755,67,92,25,2,2,2,9,4,35,38,7
576,174,174,90,90,0,72,72,77,77,0,72,72,77,77,0,0.020150447598624867,0.020150447598624867,85,85,0,-1,2,2,3,17,82,6,96
577,16,632,37,100,63,64,92,36,41,5,16,49,37,54,17,0.00037441710065012424,0.003199564314646516,35,50,15,2,3,3,11,1,19,49,70
578,22,228,46,93,47,28,28,44,44,0,22,28,47,50,3,0.004288777698355968,0.0088498587426393,50,69,19,3,3,3,3,3,92,29,62
579,94,710,67,100,33,110,110,78,78,0,94,110,72,81,9,0.007250076585316042,0.011743081793117532,58,71,13,2,2,2,6,5,51,47,41
580,46,252,53,94,41,146,146,64,64,0,46,52,53,53,0,0.0021784267674189047,0.0031314884781646754,45,50,5,3,2,2,12,2,6,61,71
581,0,616,1,100,99,0,44,1,38,37,0,39,1,51,50,0.0,0.007420266176520644,1,62,61,2,-1,3,7,1,62,50,57
582,107,313,79,96,17,48,48,62,62,0,48,48,64,64,0,0.013036522686272508,0.014295925661186561,75,75,0,3,3,3,3,13,64,33,61
583,56,1656,56,100,44,68,68,72,72,0,56,68,66,73,7,0.007454304094761564,0.03448041117805235,62,94,32,1,2,2,4,2,67,83,27
584,0,206,1,89,88,0,30,1,33,32,0,30,1,46,45,0.0,0.007454304094761564,1,60,59,3,-1,4,9,0,26,80,32
585,0,206,1,92,91,0,14,1,31,30,0,9,1,39,38,0.0,0.0016338200755641784,1,43,42,3,-1,4,3,0,87,93,64
586,22,123,41,82,41,34,34,39,39,0,22,23,41,42,1,0.0019061234214915416,0.0019061234214915416,39,39,0,6,3,3,4,2,67,52,58
587,6,212,29,93,64,10,18,29,35,6,6,18,29,44,15,0.00017018959120460194,0.005718370264474625,30,58,28,3,4,4,3,1,82,65,31
588,0,616,1,100,99,0,68,1,41,40,0,45,1,53,52,0.0,0.007488342013002485,1,65,64,2,-1,3,8,0,39,84,25
589,0,616,1,100,99,0,40,1,42,41,0,36,1,52,51,0.0,0.0088498587426393,1,65,64,2,-1,3,5,0,49,96,25
590,2,2,26,26,0,10,10,26,26,0,2,2,26,26,0,3.4037918240920386e-05,3.4037918240920386e-05,26,26,0,-1,5,5,9,2,31,58,99
591,373,373,99,99,0,120,120,99,99,0,120,120,99,99,0,0.05265665951870384,0.05265665951870384,97,97,0,-1,2,2,3,36,75,2,92
592,100,100,58,58,0,100,100,38,38,0,100,100,58,58,0,0.04782327512849314,0.05105687736138058,97,98,1,2,1,1,16,29,9,1,90
593,100,100,64,64,0,100,100,44,44,0,100,100,64,64,0,0.02542632492596753,0.032165832737669764,85,91,6,2,1,1,13,9,13,31,25
594,28,1668,44,100,56,88,142,47,77,30,28,142,44,82,38,0.0023486163586235067,0.043364307838932574,46,97,51,1,3,2,8,3,10,54,2
595,176,176,86,86,0,176,176,90,90,0,176,176,91,91,0,0.016338200755641786,0.016338200755641786,77,77,0,-1,2,2,8,13,21,33,45
596,104,720,78,100,22,198,208,86,89,3,104,208,78,91,13,0.010449640899962559,0.018891044623710815,71,82,11,2,2,2,10,6,1,77,27
597,0,206,1,89,88,0,24,1,30,29,0,15,1,35,34,0.0,0.002552843868069029,1,39,38,3,-1,4,6,0,71,86,22
598,196,812,89,100,11,172,172,88,88,0,172,172,90,90,0,0.019469689233806462,0.026719765819122502,80,88,8,2,2,2,9,18,35,30,17
599,0,0,1,1,0,0,0,1,1,0,0,0,1,1,0,0.0,0.0,1,1,0,-1,-1,-1,2,1,93,50,81
600,223,223,99,99,0,80,80,97,97,0,80,80,97,97,0,0.05058034650600769,0.05058034650600769,97,97,0,-1,2,2,2,27,97,10,99
601,0,206,1,88,87,0,24,1,31,30,0,9,1,35,34,0.0,0.0012594029749140542,1,39,38,3,-1,4,8,0,10,40,64
602,34,34,52,52,0,54,54,54,54,0,34,34,52,52,0,0.003710133088260322,0.003710133088260322,52,52,0,-1,3,3,4,6,47,70,67
603,92,92,76,76,0,48,48,59,59,0,48,48,63,63,0,0.012866333095067906,0.012866333095067906,78,78,0,-1,3,3,3,8,75,17,93
604,156,772,83,100,17,200,200,81,81,0,156,200,83,91,8,0.014670342761836687,0.022567139793730217,76,86,10,2,2,2,11,13,19,33,48
605,0,0,1,1,0,0,0,1,1,0,0,0,1,1,0,0.0,0.0,1,1,0,-1,-1,-1,9,0,23,80,36
606,280,280,96,96,0,160,160,94,94,0,160,160,95,95,0,0.024064808196330712,0.024064808196330712,88,88,0,-1,2,2,7,19,46,15,40
607,0,1640,1,100,99,0,70,1,66,65,0,70,1,70,69,0.0,0.03213179481942884,1,91,90,1,-1,2,5,0,70,40,30
608,29,235,51,94,43,28,28,43,43,0,28,28,50,50,0,0.004016474352428605,0.007318152421797883,53,65,12,3,3,3,3,6,66,73,29
609,0,206,1,92,91,0,20,1,31,30,0,16,1,38,37,0.0,0.004356853534837809,1,50,49,3,-1,4,6,0,69,92,62
610,100,100,66,66,0,100,100,45,45,0,100,100,66,66,0,0.06821198815480445,0.06821198815480445,100,100,0,-1,1,1,10,36,1,2,82
611,2,2,26,26,0,8,8,26,26,0,2,2,26,26,0,3.4037918240920386e-05,3.4037918240920386e-05,27,27,0,-1,5,5,7,1,43,78,93
612,0,616,1,100,99,0,66,1,37,36,0,40,1,50,49,0.0,0.004118588107151367,1,53,52,2,-1,3,10,0,18,91,47
613,0,616,1,100,99,0,62,1,42,41,0,41,1,53,52,0.0,0.006739507811702236,1,59,58,2,-1,3,7,0,24,67,25
614,100,100,59,59,0,100,100,45,45,0,100,100,59,59,0,0.03761189965621702,0.04496408999625583,95,95,0,2,1,1,10,20,0,23,34
615,0,206,1,88,87,0,42,1,34,33,0,6,1,29,28,0.0,0.0014636304843595766,1,40,39,3,-1,4,9,0,54,84,53
616,22,123,43,79,36,50,50,37,37,0,22,23,43,48,5,0.0005446066918547262,0.0005786446100956465,36,36,0,5,3,3,8,2,21,63,95
617,0,616,1,99,98,0,98,1,34,33,0,48,1,50,49,0.0,0.007011811157629599,1,57,56,2,-1,3,17,0,20,86,34
618,2,104,26,72,46,10,16,26,27,1,2,4,26,27,1,0.0,0.0002382654276864427,1,29,28,4,5,5,9,2,29,58,88
619,195,195,93,93,0,96,96,93,93,0,96,96,93,93,0,0.02644746247319514,0.02644746247319514,89,89,0,-1,2,2,3,16,58,12,85
620,80,286,70,94,24,50,50,47,47,0,50,50,54,54,0,0.007828721195411689,0.013785356887572755,62,77,15,3,3,3,5,13,88,24,72
621,270,886,91,100,9,286,286,88,88,0,270,286,91,93,2,0.0212056230640934,0.0353994349705572,81,94,13,2,2,2,14,18,25,30,15
622,0,0,1,1,0,0,0,1,1,0,0,0,1,1,0,0.0,0.0,1,1,0,-1,-1,-1,9,0,54,85,96
623,100,100,72,72,0,100,100,79,79,0,100,100,80,80,0,0.03543347288879812,0.04469178665032847,93,96,3,2,1,1,5,6,37,73,20
624,2,208,27,96,69,4,8,29,31,2,2,8,27,36,9,0.00010211375472276115,0.005854521937438306,30,60,30,3,5,4,2,1,98,4,31
625,18,18,46,46,0,18,18,35,35,0,18,18,46,46,0,0.002212464685659825,0.002212464685659825,44,44,0,-1,4,4,3,3,58,54,91
626,0,206,1,92,91,0,11,1,32,31,0,7,1,36,35,0.0,0.0006467204465774873,1,36,35,3,-1,4,4,1,78,50,63
627,18,634,40,100,60,60,84,38,45,7,18,50,40,55,15,0.0002382654276864427,0.004322815616596889,34,53,19,2,3,3,9,2,28,56,29
628,46,252,53,93,40,100,100,45,45,0,46,90,53,61,8,0.0026549576227917903,0.009836958371625992,47,66,19,3,2,2,11,2,19,74,27
629,46,252,48,91,43,96,96,42,42,0,46,54,48,51,3,0.0025188059498281084,0.002927260968719153,44,44,0,3,2,2,11,2,33,74,63
630,6,622,30,100,70,27,46,34,38,4,6,46,30,52,22,0.0004084550188910446,0.022396950202525613,33,86,53,2,4,3,6,1,41,88,11
631,100,100,66,66,0,100,100,67,67,0,100,100,73,73,0,0.04802750263793867,0.04802750263793867,97,97,0,-1,1,1,5,18,52,5,89
632,16,632,43,100,57,34,34,44,44,0,16,34,43,54,11,0.0019061234214915416,0.011777119711358454,45,75,30,2,3,3,4,1,72,53,17
633,290,890,95,100,5,222,222,92,92,0,222,222,94,94,0,0.02375846693216243,0.036624800027230335,83,92,9,2,2,2,10,19,12,15,16
634,42,642,58,100,42,48,48,64,64,0,48,48,66,66,0,0.00980292045338507,0.028455699649409444,66,90,24,2,3,3,3,5,85,25,12
635,22,228,38,92,54,56,56,37,37,0,22,30,38,42,4,0.0005105687736138058,0.0014295925661186562,33,38,5,3,3,3,9,2,29,56,74
636,56,672,55,100,45,128,148,72,77,5,56,148,55,84,29,0.0061949011198475104,0.02236291228428469,56,85,29,2,2,2,9,3,35,29,6
637,0,0,1,1,0,0,0,1,1,0,0,0,1,1,0,0.0,0.0,1,1,0,-1,-1,-1,5,0,37,67,76
638,244,450,94,99,5,206,206,95,95,0,206,206,95,95,0,0.021818305592429966,0.027979168794036557,82,91,9,3,2,2,9,18,26,5,31
639,338,954,96,100,4,256,256,95,95,0,256,256,95,95,0,0.02661765206439974,0.029034344259505088,88,88,0,2,2,2,10,19,18,15,52
640,46,46,62,62,0,22,22,47,47,0,22,22,52,52,0,0.005071649817897137,0.005071649817897137,58,58,0,-1,3,3,2,6,89,26,87
641,0,102,1,82,81,0,5,1,29,28,0,3,1,31,30,0.0,0.0005786446100956465,1,33,32,4,-1,5,3,0,60,66,63
642,37,139,48,81,33,52,52,39,39,0,37,39,48,49,1,0.0053099152455835805,0.0053439531638245,54,54,0,4,3,3,7,6,43,35,65
643,73,689,54,100,46,164,164,69,69,0,73,164,54,85,31,0.005786446100956465,0.01242384015793594,54,74,20,2,2,2,10,4,0,22,24
644,76,282,62,96,34,90,90,63,63,0,76,90,62,68,6,0.0088498587426393,0.00976888253514415,66,67,1,3,2,2,6,6,65,34,64
645,100,100,67,67,0,100,100,54,54,0,100,100,67,67,0,0.023179822322066782,0.0477551992920113,85,97,12,1,1,1,9,6,35,26,15
646,183,1823,90,100,10,144,168,95,98,3,144,168,95,98,3,0.017801831240001363,0.054494707103713534,79,97,18,1,2,2,6,15,56,19,10
647,0,0,1,1,0,0,0,1,1,0,0,0,1,1,0,0.0,0.0,1,1,0,-1,-1,-1,9,0,28,67,66
648,0,1640,1,100,99,0,55,1,38,37,0,40,1,48,47,0.0,0.011130399264780965,1,70,69,1,-1,2,9,1,54,50,4
649,100,100,63,63,0,100,100,47,47,0,100,100,63,63,0,0.029306647605432452,0.029647026787841656,91,91,0,3,1,1,10,14,22,14,71
650,234,234,91,91,0,180,180,71,71,0,180,180,86,86,0,0.01872085503250621,0.01872085503250621,78,78,0,-1,2,2,11,16,5,12,98
651,0,101,1,80,79,0,4,1,25,24,0,1,1,25,24,0.0,3.4037918240920386e-05,1,26,25,5,-1,6,4,0,73,84,95
652,0,616,1,100,99,0,38,1,34,33,0,25,1,43,42,0.0,0.0031314884781646754,1,49,48,2,-1,3,8,0,42,92,41
653,189,189,92,92,0,120,120,90,90,0,120,120,90,90,0,0.02392865652336703,0.02392865652336703,85,85,0,-1,2,2,6,16,69,18,40
654,6,622,29,100,71,35,122,31,58,27,6,110,29,75,46,0.00017018959120460194,0.00970080669866231,30,63,33,2,4,3,15,1,7,60,19
655,276,476,98,100,2,96,96,92,92,0,96,96,92,92,0,0.041798563599850236,0.04360257326661901,95,95,0,3,2,2,3,29,81,1,47
656,94,94,69,69,0,94,94,68,68,0,94,94,71,71,0,0.007454304094761564,0.007454304094761564,62,62,0,-1,2,2,5,5,50,47,45
657,2,208,26,89,63,10,42,26,32,6,2,42,26,51,25,0.0,0.007590455767725246,1,60,59,3,5,4,9,2,29,58,14
658,184,285,91,94,3,238,238,90,90,0,184,185,90,90,0,0.011640968038394772,0.011777119711358454,71,71,0,5,2,2,11,7,19,48,60
659,0,0,1,1,0,0,0,1,1,0,0,0,1,1,0,0.0,0.0,1,1,0,-1,-1,-1,8,1,21,69,92
660,0,0,1,1,0,0,0,1,1,0,0,0,1,1,0,0.0,0.0,1,1,0,-1,-1,-1,6,1,34,50,40
661,0,616,1,100,99,0,116,1,54,53,0,116,1,81,80,0.0,0.010994247591817285,1,68,67,2,-1,3,14,0,17,36,5
662,0,206,1,94,93,0,12,1,29,28,0,6,1,29,28,0.0,0.0009190237925048504,1,38,37,3,-1,4,4,0,53,82,71
663,84,290,72,99,27,88,88,82,82,0,88,88,82,82,0,0.010279451308757957,0.011096361346540046,70,73,3,3,2,2,4,6,72,26,49
664,0,206,1,93,92,0,10,1,30,29,0,10,1,40,39,0.0,0.003608019333537561,1,48,47,3,-1,4,3,0,92,97,26
665,136,342,83,96,13,158,158,78,78,0,136,148,86,87,1,0.012832295176826986,0.01409169815174104,72,74,2,3,2,2,9,8,29,17,61
666,89,705,64,100,36,148,148,78,78,0,89,148,64,82,18,0.006603356138738555,0.01245787807617686,58,71,13,2,2,2,9,6,54,28,48
667,0,206,1,90,89,0,14,1,27,26,0,8,1,31,30,0.0,0.001055175465468532,1,35,34,3,-1,4,6,0,51,82,74
668,6,212,33,96,63,14,18,33,35,2,6,18,33,44,11,0.0006467204465774873,0.018891044623710815,36,83,47,3,4,4,3,2,75,42,11
669,164,164,86,86,0,142,142,76,76,0,142,142,84,84,0,0.011368664692467409,0.011368664692467409,72,72,0,-1,2,2,8,13,30,24,45
670,0,101,1,83,82,0,2,1,24,23,0,1,1,24,23,0.0,6.807583648184077e-05,1,27,26,5,-1,6,2,1,89,45,65
671,130,130,85,85,0,48,48,54,54,0,48,48,56,56,0,0.018312400013615168,0.018312400013615168,83,83,0,-1,3,3,3,18,87,30,81
672,318,918,98,100,2,134,134,96,96,0,134,134,96,96,0,0.03580788998944825,0.04333026992069165,93,97,4,2,2,2,6,30,69,7,17
673,54,156,59,88,29,38,38,53,53,0,38,38,55,55,0,0.006875659484665918,0.007386228258279724,62,64,2,4,3,3,3,7,64,62,74
674,100,100,58,58,0,100,100,38,38,0,100,100,58,58,0,0.014874570271282209,0.017291262466387555,76,82,6,3,1,1,16,5,9,47,73
675,50,151,65,90,25,12,12,37,37,0,12,12,41,41,0,0.007216038667075122,0.007216038667075122,64,64,0,6,4,4,2,9,89,31,58
676,22,22,45,45,0,50,50,48,48,0,22,22,45,45,0,0.0016678579938050988,0.0016678579938050988,43,43,0,-1,3,3,5,2,49,52,76
677,32,238,44,88,44,84,84,48,48,0,32,38,44,46,2,0.002314578440382586,0.0026889955410327104,42,45,3,3,3,3,8,2,27,52,68
678,112,112,75,75,0,210,210,78,78,0,112,112,75,75,0,0.008135062459579971,0.008135062459579971,64,64,0,-1,2,2,12,4,6,72,59
679,120,736,75,100,25,200,200,78,78,0,120,200,75,87,12,0.01065386840940808,0.027026107083290785,69,89,20,2,2,2,11,6,5,77,23
680,2,618,27,100,73,4,32,29,62,33,2,32,27,64,37,3.4037918240920386e-05,0.03720344463732598,29,95,66,2,5,3,2,1,98,65,2
681,54,670,62,100,38,48,48,63,63,0,48,48,64,64,0,0.006875659484665918,0.024881718234112803,62,88,26,2,3,3,3,7,82,62,5
682,0,0,1,1,0,0,0,1,1,0,0,0,1,1,0,0.0,0.0,1,1,0,-1,-1,-1,4,0,47,66,93
683,159,365,86,96,10,234,234,91,91,0,159,165,86,87,1,0.009020048333843901,0.010075223799312433,68,71,3,3,2,2,12,8,3,57,71
684,0,0,1,1,0,0,0,1,1,0,0,0,1,1,0,0.0,0.0,1,1,0,-1,-1,-1,6,1,59,69,92
685,6,622,29,100,71,19,68,29,40,11,6,58,29,52,23,0.00017018959120460194,0.007284114503556962,31,61,30,2,4,3,8,1,42,65,21
686,62,678,61,100,39,38,48,46,66,20,38,48,51,69,18,0.00789679703189353,0.020252561353347628,62,86,24,2,3,3,3,6,96,34,19
687,6,622,30,100,70,15,66,30,48,18,6,66,30,56,26,0.0,0.02825147213996392,1,89,88,2,4,3,6,1,41,95,2
688,0,1640,1,100,99,0,146,1,62,61,0,68,1,53,52,0.0,0.012185574730249497,1,69,68,1,-1,2,17,0,20,99,72
689,128,334,81,96,15,150,150,85,85,0,128,150,86,88,2,0.00796487286837537,0.020695054290479593,61,85,24,3,2,2,7,5,46,47,18
690,115,216,85,96,11,48,48,59,59,0,48,48,63,63,0,0.0141938119064638,0.014295925661186561,80,80,0,5,3,3,3,15,75,19,55
691,0,101,1,75,74,0,10,1,25,24,0,1,1,25,24,0.0,6.807583648184077e-05,1,29,28,5,-1,6,10,1,12,69,55
692,22,638,45,100,55,46,76,40,53,13,22,76,45,60,15,0.002382654276864427,0.02729841042921815,47,88,41,2,3,3,6,2,44,75,10
693,0,206,1,92,91,0,34,1,33,32,0,15,1,35,34,0.0,0.002723033459273631,1,47,46,3,-1,4,9,0,35,99,22
694,100,100,69,69,0,100,100,71,71,0,100,100,72,72,0,0.06845025358249089,0.06845025358249089,99,99,0,-1,1,1,6,36,56,2,59
695,1,617,26,100,74,7,58,26,43,17,1,58,26,56,30,0.0,0.015385139044896015,1,77,76,2,6,3,7,1,62,78,37
696,92,92,62,62,0,80,80,53,53,0,80,80,60,60,0,0.00891793457912114,0.00891793457912114,64,64,0,-1,3,3,5,7,52,48,85
697,56,56,56,56,0,76,76,52,52,0,56,56,57,57,0,0.005990673610401988,0.005990673610401988,57,57,0,-1,3,3,6,6,65,35,79
698,0,0,1,1,0,0,0,1,1,0,0,0,1,1,0,0.0,0.0,1,1,0,-1,-1,-1,4,1,79,50,69
699,12,218,43,98,55,12,12,37,37,0,12,12,42,42,0,0.002757071377514551,0.005956635692161067,47,59,12,3,4,4,2,2,99,83,29
700,158,774,84,100,16,142,142,72,72,0,142,142,83,83,0,0.00980292045338507,0.019129310051397258,69,82,13,2,2,2,8,9,42,31,17
701,250,866,95,100,5,216,216,93,93,0,216,216,94,94,0,0.02379250485040335,0.02913645801422785,85,89,4,2,2,2,9,18,28,30,38
702,234,335,93,97,4,156,156,87,87,0,156,156,89,89,0,0.022499063957248374,0.022499063957248374,85,85,0,5,2,2,8,16,21,12,68
703,0,616,1,100,99,0,108,1,57,56,0,108,1,74,73,0.0,0.011913271384322134,1,71,70,2,-1,3,12,0,3,89,19
704,16,632,32,99,67,110,158,56,63,7,16,124,32,77,45,0.0008169100377820892,0.010960209673576363,39,67,28,2,3,3,17,1,20,71,33
705,32,32,46,46,0,76,76,49,49,0,32,32,46,46,0,0.0025188059498281084,0.0025188059498281084,45,45,0,-1,3,3,6,2,40,52,98
706,362,978,97,100,3,224,224,97,97,0,224,224,97,97,0,0.037509785901494265,0.04401102828551006,93,97,4,2,2,2,8,27,57,10,38
707,148,764,88,100,12,88,88,82,82,0,88,88,82,82,0,0.022465026039007456,0.03849688553048095,85,94,9,2,2,2,4,18,72,30,12
708,0,102,1,79,78,0,6,1,28,27,0,2,1,26,25,0.0,0.0009190237925048504,1,36,35,4,-1,5,3,0,58,76,71
709,12,114,40,82,42,18,18,38,38,0,12,14,40,42,2,0.0015657442390823377,0.001940161339732462,42,45,3,4,4,4,3,2,81,52,49
710,0,1640,1,100,99,0,156,1,67,66,0,156,1,86,85,0.0,0.03066816433506927,1,92,91,1,-1,2,12,0,14,67,1
711,8,8,40,40,0,12,12,39,39,0,8,8,40,40,0,0.0018380475850097008,0.0018380475850097008,44,44,0,-1,4,4,2,2,93,83,92
712,0,102,1,84,83,0,6,1,30,29,0,4,1,30,29,0.0,0.0007488342013002485,1,35,34,4,-1,5,3,0,92,40,43
713,159,1759,91,100,9,72,72,79,79,0,72,72,80,80,0,0.02484768031587188,0.06858640525545458,90,97,7,1,2,2,3,16,75,18,0
714,0,206,1,95,94,0,18,1,34,33,0,18,1,45,44,0.0,0.015385139044896015,1,77,76,3,-1,4,3,0,94,96,9
715,46,46,48,48,0,130,130,59,59,0,46,46,48,48,0,0.0016338200755641784,0.0016338200755641784,40,40,0,-1,2,2,17,3,20,51,80
716,138,754,86,100,14,64,64,63,63,0,64,64,64,64,0,0.011845195547840293,0.04060723646141802,74,93,19,2,3,3,4,14,79,32,1
717,0,102,1,78,77,0,6,1,28,27,0,2,1,28,27,0.0,0.0002723033459273631,1,33,32,4,-1,5,4,0,47,85,4
718,8,8,34,34,0,40,40,34,34,0,8,8,34,34,0,0.0005105687736138058,0.0005105687736138058,33,33,0,-1,4,4,8,2,27,63,96
719,24,230,50,98,48,22,22,47,47,0,22,22,52,52,0,0.0028932230504782326,0.00793083495013445,49,68,19,3,3,3,2,6,89,70,21
720,64,680,67,100,33,28,38,44,58,14,28,38,51,61,10,0.010415602981721638,0.024098846114571634,71,88,17,2,3,3,3,9,92,27,19
721,152,358,84,96,12,272,272,88,88,0,152,164,84,84,0,0.016508390346846386,0.01746145205759216,76,77,1,3,2,2,14,9,17,39,74
722,1,207,26,94,68,4,24,26,35,9,1,24,26,46,20,3.4037918240920386e-05,0.0045270431260424114,27,53,26,3,6,4,4,2,53,58,38
723,0,102,1,81,80,0,3,1,27,26,0,2,1,27,26,0.0,0.00030634126416828345,1,32,31,4,-1,5,2,0,95,76,88
724,90,706,64,100,36,122,122,69,69,0,90,122,64,78,14,0.010517716736444398,0.018040096667687803,67,79,12,2,2,2,8,6,27,77,44
725,120,326,78,96,18,228,228,75,75,0,120,126,78,79,1,0.007318152421797883,0.008509479560230097,58,61,3,3,2,2,14,6,16,13,53
726,0,206,1,93,92,0,14,1,33,32,0,14,1,39,38,0.0,0.0061949011198475104,1,59,58,3,-1,4,3,0,55,67,31
727,87,293,59,94,35,146,146,77,77,0,87,93,59,61,2,0.006535280302256714,0.007862759113652609,58,62,4,3,2,2,8,4,42,22,53
728,22,228,47,94,47,24,28,43,47,4,22,28,48,53,5,0.003982436434187685,0.009598692943939549,53,67,14,3,3,3,3,2,55,83,31
729,0,0,1,1,0,0,0,1,1,0,0,0,1,1,0,0.0,0.0,1,1,0,-1,-1,-1,6,0,34,93,99
730,16,118,35,78,43,100,100,45,45,0,16,18,35,40,5,0.0026549576227917903,0.0026209197045508697,47,47,0,4,3,3,10,2,1,94,95
731,100,716,79,100,21,56,56,76,76,0,56,56,77,77,0,0.013989584397018279,0.02032063718982947,77,85,8,2,2,2,2,13,68,24,26
732,128,744,79,100,21,146,166,80,86,6,128,166,80,90,10,0.008101024541339052,0.021920419347152727,63,86,23,2,2,2,8,5,10,47,12
733,0,616,1,100,99,0,86,1,35,34,0,47,1,48,47,0.0,0.005990673610401988,1,56,55,2,-1,3,16,0,4,67,44
734,443,649,100,100,0,200,200,100,100,0,200,200,100,100,0,0.045304469178665034,0.04731270635487934,96,97,1,3,2,2,5,29,61,1,75
735,0,206,1,96,95,0,12,1,34,33,0,12,1,42,41,0.0,0.007760645358929848,1,63,62,3,-1,4,2,0,86,84,14
736,40,656,46,100,54,174,184,71,71,0,40,121,46,82,36,0.0025188059498281084,0.009428503352734947,47,66,19,2,2,2,14,1,17,53,24
737,0,0,1,1,0,0,0,1,1,0,0,0,1,1,0,0.0,0.0,1,1,0,-1,-1,-1,5,0,61,81,87
738,132,732,78,100,22,190,190,74,74,0,132,190,78,86,8,0.010824058000612683,0.016202049082678104,71,75,4,2,2,2,11,9,5,27,25
739,46,252,61,99,38,46,46,83,83,0,46,46,83,83,0,0.02130773681881616,0.02917049593246877,86,94,8,3,2,2,2,3,99,51,32
740,98,714,71,100,29,54,64,56,66,10,54,64,57,67,10,0.012730181422104225,0.018278362095374246,71,82,11,2,3,3,4,13,67,33,41
741,40,246,53,97,44,72,72,77,77,0,40,48,67,69,2,0.005241839409101739,0.006841621566424997,53,57,4,3,2,2,3,1,96,53,61
742,144,144,81,81,0,198,198,82,82,0,144,144,81,81,0,0.012491915994417782,0.012491915994417782,71,71,0,-1,2,2,10,6,18,77,99
743,224,430,91,98,7,134,134,91,91,0,134,134,92,92,0,0.02127369890057524,0.0228734810578985,81,84,3,3,2,2,6,16,71,12,90
744,216,422,90,98,8,128,128,90,90,0,128,128,90,90,0,0.02028659927158855,0.021716191837707205,83,84,1,3,2,2,5,18,61,5,94
745,64,270,70,98,28,32,32,63,63,0,32,32,64,64,0,0.011130399264780965,0.016099935327955343,69,77,8,3,3,3,2,9,86,27,48
746,0,0,1,1,0,0,0,1,1,0,0,0,1,1,0,0.0,0.0,1,1,0,-1,-1,-1,6,0,44,99,96
747,0,616,1,100,99,0,72,1,39,38,0,72,1,61,60,0.0,0.01334286395044079,1,71,70,2,-1,3,10,0,12,87,30
748,126,228,84,97,13,48,48,70,70,0,48,48,72,72,0,0.021784267674189048,0.021954457265393648,85,85,0,4,3,3,3,15,94,16,60
749,98,304,71,99,28,78,78,78,78,0,78,78,78,78,0,0.015453214881377854,0.017869907076483203,78,81,3,3,2,2,4,9,67,39,70
750,362,1962,95,100,5,224,224,99,99,0,224,224,99,99,0,0.03104258143571939,0.0489124885122026,90,99,9,1,2,2,8,22,27,9,8
751,6,622,29,100,71,28,42,33,38,5,6,28,29,48,19,0.0006126825283365669,0.004561081044283332,37,53,16,2,4,3,6,2,59,42,29
752,140,756,84,100,16,182,182,87,87,0,140,182,85,91,6,0.01497668402600497,0.024983831988835564,76,86,10,2,2,2,9,8,23,20,17
753,42,658,59,100,41,38,48,55,65,10,38,48,58,66,8,0.007454304094761564,0.03543347288879812,64,92,28,2,3,3,3,6,76,34,11
754,0,102,1,77,76,0,12,1,26,25,0,2,1,26,25,0.0,6.807583648184077e-05,1,27,26,4,-1,5,11,0,33,84,58
755,16,222,34,86,52,82,82,40,40,0,16,22,34,41,7,0.0029612988869600733,0.0033016780693692774,49,51,2,3,3,3,12,3,2,46,55
756,174,380,89,96,7,174,174,92,92,0,174,174,93,93,0,0.014670342761836687,0.01858470335954253,77,82,5,3,2,2,7,7,43,48,35
757,183,389,90,100,10,144,144,95,95,0,144,144,95,95,0,0.017801831240001363,0.023179822322066782,79,87,8,3,2,2,6,15,56,19,22
758,0,206,1,89,88,0,34,1,33,32,0,12,1,34,33,0.0,0.0014295925661186562,1,40,39,3,-1,4,9,0,28,87,52
759,168,784,88,100,12,100,120,71,86,15,100,120,72,87,15,0.015317063208414174,0.036624800027230335,76,97,21,2,2,2,6,14,56,32,16
760,84,290,63,94,31,90,90,67,67,0,84,90,66,69,3,0.007011811157629599,0.01667857993805099,58,80,22,3,2,2,6,5,71,47,37
761,71,71,60,60,0,112,112,66,66,0,71,71,60,60,0,0.008101024541339052,0.008101024541339052,64,64,0,-1,2,2,8,6,21,35,59
762,62,163,53,87,34,146,146,67,67,0,62,63,53,55,2,0.0033357159876101976,0.003369753905851118,51,51,0,5,2,2,12,6,3,70,58
763,100,100,67,67,0,100,100,54,54,0,100,100,67,67,0,0.028591851322373123,0.028591851322373123,89,89,0,-1,1,1,8,7,27,21,89
764,60,162,56,87,31,50,50,49,49,0,60,60,56,56,0,0.005854521937438306,0.006092787365124749,57,57,0,4,3,3,5,6,61,26,49
765,16,16,38,38,0,60,60,39,39,0,16,16,38,38,0,0.0010892133837094523,0.0010892133837094523,39,39,0,-1,3,3,9,1,54,71,50
766,278,1918,95,100,5,344,368,93,95,2,278,368,95,98,3,0.02552843868069029,0.03461656285101603,87,92,5,1,2,2,17,15,20,16,62
767,0,0,1,1,0,0,0,1,1,0,0,0,1,1,0,0.0,0.0,1,1,0,-1,-1,-1,3,0,76,80,36
768,100,100,77,77,0,100,100,96,96,0,100,100,96,96,0,0.07610878518669797,0.11967732053507607,98,100,2,1,1,1,3,20,66,23,0
769,86,188,63,89,26,92,92,62,62,0,86,88,66,67,1,0.00789679703189353,0.008237176214302734,63,63,0,4,3,3,7,7,62,21,60
770,0,101,1,77,76,0,8,1,25,24,0,1,1,25,24,0.0,3.4037918240920386e-05,1,27,26,5,-1,6,8,0,57,84,55
771,0,0,1,1,0,0,0,1,1,0,0,0,1,1,0,0.0,0.0,1,1,0,-1,-1,-1,5,0,61,36,85
772,210,311,97,100,3,22,22,54,54,0,22,22,54,54,0,0.02828551005820484,0.028523775485891283,92,93,1,5,3,3,2,29,99,1,88
773,237,237,96,96,0,88,88,82,82,0,88,88,82,82,0,0.03114469519044215,0.03114469519044215,90,90,0,-1,2,2,4,30,72,7,59
774,58,160,57,87,30,78,78,68,68,0,58,60,60,60,0,0.005718370264474625,0.005820484019197386,56,56,0,4,2,2,4,3,83,54,95
775,22,638,42,100,58,56,66,41,43,2,22,66,42,55,13,0.0021784267674189047,0.009496579189216788,44,67,23,2,3,3,6,2,40,83,17
776,6,622,30,100,70,36,56,36,47,11,6,56,30,56,26,0.0006807583648184077,0.010347527145239796,36,68,32,2,4,3,6,1,65,49,77
777,124,330,81,96,15,204,204,86,86,0,124,139,81,84,3,0.011198475101262807,0.014023622315259198,70,76,6,3,2,2,11,6,38,77,73
778,168,374,89,99,10,88,88,81,81,0,88,88,81,81,0,0.024439225296980838,0.025154021580040164,86,87,1,3,2,2,4,18,73,30,42
779,0,206,1,90,89,0,19,1,28,27,0,12,1,31,30,0.0,0.0021784267674189047,1,40,39,3,-1,4,6,0,51,80,75
780,2,618,28,100,72,4,22,30,46,16,2,22,28,51,23,0.0002042275094455223,0.02484768031587188,31,89,58,2,5,3,2,1,89,88,10
781,100,100,69,69,0,100,100,55,55,0,100,100,69,69,0,0.02641342455495422,0.04629156880765172,90,96,6,2,1,1,9,6,26,77,10
782,166,267,88,94,6,112,112,93,93,0,112,112,93,93,0,0.018040096667687803,0.018108172504169646,83,83,0,6,2,2,4,14,79,14,68
783,16,632,34,100,66,78,114,34,55,21,16,60,34,53,19,0.00037441710065012424,0.006058749446883829,34,55,21,2,3,3,14,1,16,88,38
784,134,340,81,97,16,166,166,87,87,0,134,140,82,82,0,0.012628067667381462,0.014738418598318526,74,75,1,3,2,2,8,6,10,77,46
785,40,40,50,50,0,150,150,65,65,0,40,40,50,50,0,0.0026549576227917903,0.0026549576227917903,48,48,0,-1,2,2,11,1,5,53,69
786,39,139,54,85,31,38,38,51,51,0,38,38,54,54,0,0.004493005207801491,0.004493005207801491,55,55,0,5,3,3,3,4,82,22,58
787,74,674,66,100,34,60,60,52,52,0,60,60,62,62,0,0.009870996289866912,0.018312400013615168,70,83,13,2,3,3,5,9,45,27,17
788,6,622,31,100,69,21,62,33,45,12,6,62,31,58,27,0.0004765308553728854,0.00888389666088022,36,67,31,2,4,3,7,1,62,88,48
789,100,716,75,100,25,54,64,55,67,12,54,64,60,68,8,0.01055175465468532,0.02818339630348208,73,90,17,2,3,3,4,14,73,32,5
790,2,618,27,100,73,6,28,29,42,13,2,28,27,49,22,0.00034037918240920387,0.022703291466693896,34,88,54,2,5,3,3,1,66,60,11
791,122,722,76,100,24,136,136,81,81,0,136,136,82,82,0,0.01153885428367201,0.03866707512168556,71,94,23,2,2,2,7,9,43,27,2
792,100,100,61,61,0,100,100,44,44,0,100,100,61,61,0,0.04687021341774737,0.054528745021954456,96,99,3,2,1,1,12,27,6,10,20
793,1,617,23,100,77,4,44,23,43,20,1,44,23,49,26,3.4037918240920386e-05,0.01929949964260186,24,85,61,2,6,3,4,2,67,58,9
794,319,1959,96,100,4,144,168,92,95,3,144,168,92,95,3,0.03264236359304265,0.05221416658157187,90,96,6,1,2,2,6,29,48,11,62
795,22,638,43,100,57,70,90,38,42,4,22,74,43,59,16,0.0012934408931549745,0.006909697402906838,41,61,20,2,3,3,10,3,1,51,57
796,0,206,1,91,90,0,20,1,33,32,0,16,1,43,42,0.0,0.004118588107151367,1,52,51,3,-1,4,4,0,84,59,72
797,261,361,96,98,2,288,288,95,95,0,288,288,95,95,0,0.02542632492596753,0.02552843868069029,89,89,0,4,2,2,12,20,6,23,65
798,140,1780,81,100,19,178,212,80,89,9,140,192,81,87,6,0.015248987371932332,0.03185949147350148,77,88,11,1,2,2,10,8,11,20,72
799,0,102,1,81,80,0,6,1,29,28,0,3,1,30,29,0.0,0.0013274788113958951,1,38,37,4,-1,5,3,0,81,40,61
800,49,255,56,96,40,48,48,69,69,0,48,48,70,70,0,0.005718370264474625,0.009496579189216788,57,68,11,3,3,3,3,4,55,22,13
801,490,690,99,100,1,312,312,98,98,0,312,312,98,98,0,0.036794989618434935,0.03716940671908506,96,96,0,3,2,2,12,30,2,7,55
802,88,88,60,60,0,152,152,78,78,0,88,88,60,60,0,0.009054086252084823,0.009054086252084823,67,67,0,-1,2,2,8,4,42,38,82
803,0,616,1,100,99,0,30,1,39,38,0,30,1,47,46,0.0,0.006331052792811192,1,56,55,2,-1,3,6,0,69,98,44
804,0,0,1,1,0,0,0,1,1,0,0,0,1,1,0,0.0,0.0,1,1,0,-1,-1,-1,2,0,93,76,36
805,40,656,55,100,45,38,48,51,62,11,38,48,54,63,9,0.005616256509751864,0.023554239422716908,59,87,28,2,3,3,3,6,82,26,18
806,48,254,69,100,31,46,46,87,87,0,46,46,88,88,0,0.0176997174852786,0.02648150039143606,82,89,7,3,2,2,2,6,97,73,14
807,76,76,69,69,0,38,38,57,57,0,38,38,59,59,0,0.008101024541339052,0.008101024541339052,62,62,0,-1,3,3,3,13,55,24,67
808,166,166,84,84,0,136,136,77,77,0,136,136,83,83,0,0.01592974573675074,0.01592974573675074,77,77,0,-1,2,2,7,13,24,33,50
809,212,812,88,100,12,232,232,77,77,0,212,232,88,90,2,0.012525953912658701,0.018380475850097007,71,79,8,2,2,2,14,14,16,32,25
810,16,16,36,36,0,88,88,49,49,0,16,16,36,36,0,0.002757071377514551,0.002757071377514551,49,49,0,-1,3,3,8,3,30,46,87
811,0,206,1,94,93,0,24,1,35,34,0,20,1,41,40,0.0,0.00445896728956057,1,52,51,3,-1,4,4,0,53,89,38
812,140,140,86,86,0,176,176,87,87,0,140,140,86,86,0,0.016882807447496512,0.016882807447496512,80,80,0,-1,2,2,8,8,39,20,40
813,260,466,97,100,3,88,88,82,82,0,88,88,82,82,0,0.033425235712583816,0.0368971033731577,92,94,2,3,2,2,4,22,78,9,73
814,116,116,80,80,0,250,250,79,79,0,116,116,80,80,0,0.009462541270975866,0.009462541270975866,66,66,0,-1,2,2,16,7,4,48,87
815,0,206,1,94,93,0,15,1,30,29,0,6,1,30,29,0.0,0.0005786446100956465,1,35,34,3,-1,4,6,0,32,79,88
816,66,66,57,57,0,94,94,45,45,0,66,66,57,57,0,0.007556417849484326,0.007556417849484326,60,60,0,-1,3,3,9,6,29,34,98
817,0,206,1,90,89,0,18,1,29,28,0,8,1,32,31,0.0,0.0009870996289866913,1,38,37,3,-1,4,8,1,39,50,74
818,104,206,75,89,14,152,152,78,78,0,104,106,75,75,0,0.006773545729943157,0.006875659484665918,59,60,1,4,2,2,8,5,42,47,65
819,0,102,1,81,80,0,6,1,28,27,0,4,1,28,27,0.0,0.001055175465468532,1,37,36,4,-1,5,3,0,82,40,74
820,190,1790,92,100,8,104,104,80,80,0,104,104,81,81,0,0.021920419347152727,0.041185881071513664,85,96,11,1,2,2,5,16,63,12,34
821,0,102,1,75,74,0,21,1,27,26,0,2,1,25,24,0.0,0.0002723033459273631,1,30,29,4,-1,5,14,0,8,89,88
822,100,100,67,67,0,100,100,54,54,0,100,100,67,67,0,0.028591851322373123,0.03730555839204874,89,97,8,2,1,1,8,7,27,21,34
823,16,1656,34,100,66,40,118,32,61,29,16,84,34,57,23,0.00034037918240920387,0.014466115252391163,32,72,40,1,3,2,12,1,2,60,62
824,94,300,75,98,23,54,54,60,60,0,54,54,62,62,0,0.010381565063480718,0.012185574730249497,71,75,4,3,3,3,4,9,78,27,75
825,24,640,52,100,48,12,22,39,54,15,12,22,44,56,12,0.0057524081827155455,0.01674665577453283,60,80,20,2,4,3,2,4,97,38,73
826,100,100,66,66,0,100,100,49,49,0,100,100,66,66,0,0.061268252833656695,0.07971680452023554,100,100,0,1,1,1,9,40,54,3,18
827,100,100,63,63,0,100,100,45,45,0,100,100,63,63,0,0.039994553933081455,0.05248646992749923,94,98,4,1,1,1,11,20,19,23,62
828,6,6,32,32,0,10,10,32,32,0,6,6,32,32,0,0.00037441710065012424,0.00037441710065012424,33,33,0,-1,4,4,3,1,58,88,87
829,110,110,83,83,0,48,48,67,67,0,48,48,70,70,0,0.018108172504169646,0.018108172504169646,81,81,0,-1,3,3,3,18,96,30,45
830,84,284,62,92,30,168,168,82,82,0,84,90,62,64,2,0.007386228258279724,0.009905034208107831,63,69,6,3,2,2,9,6,54,26,29
831,16,222,38,90,52,56,56,46,46,0,16,26,38,47,9,0.002280540522141666,0.005241839409101739,47,56,9,3,3,3,6,2,74,94,73
832,6,6,29,29,0,28,28,33,33,0,6,6,29,29,0,0.00017018959120460194,0.00017018959120460194,31,31,0,-1,4,4,8,1,15,4,80
833,0,101,1,80,79,0,3,1,24,23,0,1,1,24,23,0.0,0.00017018959120460194,1,30,29,5,-1,6,3,0,76,86,60
834,2,618,26,100,74,10,60,26,38,12,2,54,26,53,27,0.0,0.007624493685966166,1,60,59,2,5,3,9,2,29,58,17
835,0,1640,1,100,99,0,182,1,69,68,0,182,1,88,87,0.0,0.028523775485891283,1,91,90,1,-1,2,13,0,13,81,9
836,50,666,58,100,42,28,28,45,45,0,28,28,49,49,0,0.005480104836788182,0.035195207461111676,54,92,38,2,3,3,3,6,60,28,2
837,16,632,39,100,61,38,66,40,48,8,16,66,39,62,23,0.0011232513019503727,0.015521290717859695,39,79,40,2,3,3,6,2,32,42,18
838,13,13,43,43,0,24,24,40,40,0,13,13,43,43,0,0.0015317063208414173,0.0015317063208414173,42,42,0,-1,4,4,4,4,78,64,59
839,6,622,31,100,69,13,46,31,49,18,6,46,31,52,21,0.00017018959120460194,0.013751318969331836,30,77,47,2,4,3,5,1,37,65,12
840,0,101,1,76,75,0,6,1,25,24,0,1,1,25,24,0.0,3.4037918240920386e-05,1,25,24,6,-1,7,6,0,71,87,58
841,40,656,55,100,45,52,62,78,81,3,40,62,64,81,17,0.007556417849484326,0.029715102624323496,62,90,28,2,2,2,3,2,85,94,0
842,100,100,67,67,0,100,100,66,66,0,100,100,72,72,0,0.07553014057660233,0.07553014057660233,100,100,0,-1,1,1,6,36,59,2,97
843,0,616,1,100,99,0,50,1,47,46,0,50,1,56,55,0.0,0.023384049831512304,1,86,85,2,-1,3,5,0,49,93,0
844,128,1768,80,100,20,252,286,83,90,7,128,286,80,96,16,0.0068075836481840775,0.02236291228428469,60,85,25,1,2,2,14,5,8,47,32
845,50,666,52,100,48,94,104,45,61,16,50,90,52,57,5,0.005956635692161067,0.011266550937744648,56,69,13,2,2,2,9,6,29,73,38
846,132,338,91,100,9,32,32,71,71,0,32,32,71,71,0,0.01844855168657885,0.02467749072466728,81,89,8,3,3,3,2,16,99,12,14
847,100,100,59,59,0,100,100,39,39,0,100,100,59,59,0,0.05721774056298717,0.07120732496000545,99,100,1,2,1,1,14,40,16,3,5
848,32,632,44,100,56,110,110,58,58,0,32,57,44,51,7,0.0017359338302869397,0.005650294427992784,43,53,10,2,3,3,10,2,0,52,35
849,16,16,45,45,0,28,28,46,46,0,16,16,44,44,0,0.003165526396405596,0.003165526396405596,49,49,0,-1,3,3,3,3,85,46,81
850,16,1656,39,100,61,38,72,51,76,25,16,72,39,76,37,0.0024507301133462676,0.045474658769869634,48,95,47,1,3,2,3,1,82,53,17
851,53,259,62,97,35,32,32,70,70,0,32,32,70,70,0,0.008203138296061813,0.01405766023350012,64,76,12,3,3,3,2,8,95,57,31
852,54,260,56,93,37,70,70,67,67,0,54,60,55,59,4,0.007386228258279724,0.007624493685966166,63,64,1,3,3,3,5,7,70,62,4
853,84,185,61,88,27,104,104,82,82,0,84,104,69,82,13,0.010824058000612683,0.010824058000612683,72,72,0,5,2,2,5,5,50,25,68
854,102,308,72,96,24,112,112,70,70,0,102,112,74,76,2,0.009734844616903231,0.010177337554035196,69,69,0,3,3,3,7,7,46,48,42
855,0,616,1,100,99,0,90,1,45,44,0,90,1,60,59,0.0,0.021546002246502605,1,81,80,2,-1,3,10,0,11,80,10
856,104,104,75,75,0,174,174,76,76,0,104,104,75,75,0,0.006467204465774873,0.006467204465774873,57,57,0,-1,2,2,10,5,18,47,87
857,78,78,71,71,0,48,48,64,64,0,48,48,66,66,0,0.013070560604513427,0.013070560604513427,75,75,0,-1,3,3,3,13,85,33,98
858,2,104,26,74,48,19,19,27,27,0,2,4,26,27,1,6.807583648184077e-05,0.0002382654276864427,26,31,5,4,5,5,16,1,4,68,55
859,42,248,57,97,40,46,46,79,79,0,42,46,80,80,0,0.006739507811702236,0.01763164164879676,60,84,24,3,2,2,2,3,91,51,37
860,0,102,1,75,74,0,10,1,27,26,0,2,1,25,24,0.0,0.0010211375472276116,1,38,37,4,-1,5,5,0,80,82,71
861,16,118,34,81,47,40,40,40,40,0,16,18,34,38,4,0.0013274788113958951,0.0018380475850097008,40,43,3,4,3,3,5,1,50,71,49
862,111,727,78,100,22,152,152,80,80,0,111,152,78,87,9,0.00891793457912114,0.016202049082678104,67,78,11,2,2,2,8,8,30,44,24
863,22,638,47,100,53,56,56,47,47,0,22,52,47,57,10,0.0019061234214915416,0.007828721195411689,44,64,20,2,3,3,6,2,32,52,72
864,172,172,87,87,0,100,100,77,77,0,100,100,77,77,0,0.019810068416215663,0.019810068416215663,81,81,0,-1,2,2,6,18,69,5,82
865,0,0,1,1,0,0,0,1,1,0,0,0,1,1,0,0.0,0.0,1,1,0,-1,-1,-1,3,0,60,80,36
866,66,66,66,66,0,54,54,55,55,0,54,54,60,60,0,0.009905034208107831,0.009905034208107831,67,67,0,-1,3,3,4,6,84,77,66
867,80,280,69,96,27,84,84,74,74,0,84,84,75,75,0,0.010687906327649,0.02042275094455223,73,84,11,3,2,2,5,6,45,77,12
868,0,206,1,92,91,0,62,1,35,34,0,32,1,46,45,0.0,0.006773545729943157,1,60,59,3,-1,4,11,0,19,36,34
869,128,334,78,96,18,182,182,82,82,0,128,134,79,79,0,0.008203138296061813,0.008713707069675619,63,65,2,3,2,2,9,5,28,47,71
870,64,270,60,97,37,22,22,42,42,0,22,22,46,46,0,0.010143299635794275,0.01746145205759216,69,83,14,3,3,3,2,9,68,27,32
871,2,208,29,92,63,7,20,29,34,5,2,20,29,45,16,0.00013615167296368154,0.007522379931243405,32,61,29,3,5,4,4,1,47,65,32
872,22,124,48,84,36,40,40,44,44,0,22,26,48,49,1,0.002552843868069029,0.003982436434187685,46,51,5,4,3,3,5,2,70,83,61
873,100,100,72,72,0,100,100,77,77,0,100,100,77,77,0,0.03002144388849178,0.05728581639946901,91,99,8,2,1,1,6,6,69,26,2
874,372,1972,96,100,4,200,200,93,93,0,200,200,93,93,0,0.03271043942952449,0.046359644644133564,93,98,5,1,2,2,8,29,27,0,31
875,36,36,53,53,0,28,28,43,43,0,28,28,50,50,0,0.0038462847612240037,0.0038462847612240037,52,52,0,-1,3,3,3,6,66,41,97
876,2,2,26,26,0,8,8,26,26,0,2,2,26,26,0,3.4037918240920386e-05,3.4037918240920386e-05,27,27,0,-1,5,5,7,1,43,78,45
877,8,8,36,36,0,26,26,36,36,0,8,8,36,36,0,0.0005105687736138058,0.0005105687736138058,35,35,0,-1,4,4,5,2,45,56,96
878,0,206,1,97,96,0,7,1,33,32,0,7,1,40,39,0.0,0.002552843868069029,1,47,46,3,-1,4,2,0,97,86,75
879,70,686,67,100,33,48,48,62,62,0,48,48,64,64,0,0.006399128629293032,0.035705776234725484,59,92,33,2,3,3,3,5,64,47,2
880,0,0,1,1,0,0,0,1,1,0,0,0,1,1,0,0.0,0.0,1,1,0,-1,-1,-1,9,0,29,81,59
881,24,126,52,91,39,18,18,53,53,0,18,18,54,54,0,0.002280540522141666,0.002995336805200994,46,49,3,4,3,3,2,3,97,54,71
882,2,104,28,85,57,3,4,28,29,1,2,4,28,33,5,0.00010211375472276115,0.002144388849177984,30,44,14,4,5,5,2,1,93,95,90
883,0,616,1,100,99,0,88,1,51,50,0,88,1,64,63,0.0,0.015589366554341537,1,78,77,2,-1,3,8,0,21,59,30
884,1,1,26,26,0,5,5,26,26,0,1,1,26,26,0,6.807583648184077e-05,6.807583648184077e-05,28,28,0,-1,6,6,5,2,49,58,66
885,100,100,66,66,0,100,100,49,49,0,100,100,66,66,0,0.02913645801422785,0.04819769222914327,88,97,9,2,1,1,9,8,54,8,16
886,100,100,79,79,0,100,100,98,98,0,100,100,98,98,0,0.09574866401170905,0.09714421865958678,100,100,0,4,1,1,2,15,95,16,41
887,132,338,86,100,14,32,32,63,63,0,32,32,64,64,0,0.018959120460192654,0.021137547227611558,84,86,2,3,3,3,2,18,86,30,46
888,240,856,94,100,6,176,176,87,87,0,176,176,91,91,0,0.020524864699274992,0.03580788998944825,83,93,10,2,2,2,8,18,15,5,16
889,0,206,1,90,89,0,22,1,33,32,0,6,1,29,28,0.0,0.0013955546478777359,1,38,37,3,-1,4,5,0,80,87,53
890,0,0,1,1,0,0,0,1,1,0,0,0,1,1,0,0.0,0.0,1,1,0,-1,-1,-1,6,0,48,91,82
891,2,2,26,26,0,11,11,26,26,0,2,2,26,26,0,0.0,0.0,1,1,0,-1,5,5,10,1,0,68,84
892,386,592,98,100,2,184,184,97,97,0,184,184,98,98,0,0.036760951700194014,0.041798563599850236,93,96,3,3,2,2,7,30,62,7,31
893,8,110,34,76,42,40,40,37,37,0,8,10,34,35,1,0.0002042275094455223,0.0002042275094455223,30,30,0,4,4,4,8,2,39,56,68
894,40,40,55,55,0,28,28,46,46,0,28,28,51,51,0,0.003914360597705844,0.003914360597705844,53,53,0,-1,3,3,3,6,85,41,67
895,29,235,55,100,45,22,22,55,55,0,22,22,57,57,0,0.004629156880765172,0.008407365805507334,53,66,13,3,3,3,2,4,97,22,41
896,0,206,1,85,84,0,44,1,34,33,0,19,1,41,40,0.0,0.0025188059498281084,1,45,44,3,-1,4,12,0,2,80,22
897,0,616,1,100,99,0,54,1,35,34,0,54,1,52,51,0.0,0.007998910786616291,1,64,63,2,-1,3,10,0,1,81,32
898,0,1640,1,100,99,0,112,1,72,71,0,112,1,78,77,0.0,0.04009666768780421,1,95,94,1,-1,2,8,0,39,92,2
899,0,616,1,100,99,0,44,1,53,52,0,44,1,57,56,0.0,0.025222097416522007,1,88,87,2,-1,3,4,0,77,36,0
900,100,100,63,63,0,100,100,39,39,0,100,100,63,63,0,0.018891044623710815,0.02808128254875932,79,90,11,2,1,1,14,6,17,13,8
901,0,206,1,90,89,0,31,1,29,28,0,8,1,31,30,0.0,0.0008169100377820892,1,36,35,3,-1,4,14,0,8,80,74
902,6,6,32,32,0,10,10,32,32,0,6,6,32,32,0,0.0002042275094455223,0.0002042275094455223,34,34,0,-1,4,4,3,1,76,88,66
903,334,435,95,96,1,216,216,85,85,0,216,216,87,87,0,0.03441233534157051,0.03441233534157051,94,94,0,5,2,2,12,29,2,0,58
904,1,207,25,90,65,5,26,25,34,9,1,26,25,47,22,3.4037918240920386e-05,0.00622893903808843,26,59,33,3,6,4,5,1,80,68,77
905,339,339,98,98,0,152,152,98,98,0,152,152,98,98,0,0.04360257326661901,0.04360257326661901,96,96,0,-1,2,2,5,29,45,11,67
906,16,16,34,34,0,108,108,60,60,0,16,16,34,34,0,0.0019741992579733825,0.0019741992579733825,43,43,0,-1,3,3,8,1,42,53,79
907,53,669,62,100,38,32,32,70,70,0,32,32,70,70,0,0.008203138296061813,0.0300554818067327,64,93,29,2,3,3,2,8,95,57,0
908,10,626,41,100,59,18,28,38,45,7,10,28,41,50,9,0.0012934408931549745,0.015385139044896015,40,79,39,2,4,3,3,4,85,64,30
909,35,241,55,94,39,44,44,48,48,0,35,44,56,57,1,0.004356853534837809,0.008747744987916539,54,65,11,3,3,3,4,6,47,73,62
910,40,246,47,91,44,66,66,44,44,0,40,66,47,56,9,0.004901460226692535,0.010245413390517035,52,68,16,3,3,3,6,6,51,73,48
911,0,616,1,100,99,0,22,1,47,46,0,22,1,50,49,0.0,0.02205657102011641,1,85,84,2,-1,3,2,0,95,93,0
912,300,300,100,100,0,56,56,86,86,0,56,56,86,86,0,0.051499370298512544,0.051499370298512544,98,98,0,-1,2,2,2,36,95,2,86
913,0,616,1,100,99,0,36,1,35,34,0,23,1,46,45,0.0,0.001497668402600497,1,39,38,2,-1,3,7,0,43,66,64
914,126,126,82,82,0,108,108,69,69,0,108,108,77,77,0,0.008543517478471017,0.008543517478471017,66,66,0,-1,3,3,8,13,39,24,81
915,0,102,1,84,83,0,4,1,28,27,0,2,1,26,25,0.0,0.0007147962830593281,1,37,36,4,-1,5,2,0,98,91,71
916,0,206,1,88,87,0,15,1,27,26,0,6,1,29,28,0.0,3.4037918240920386e-05,1,27,26,3,-1,4,9,0,54,97,95
917,18,634,48,100,52,30,54,46,59,13,18,54,48,61,13,0.0009190237925048504,0.017087034956942034,37,80,43,2,3,3,4,2,78,63,37
918,52,258,61,97,36,48,48,65,65,0,48,48,68,68,0,0.009598692943939549,0.01143674052894925,71,74,3,3,3,3,3,5,66,25,70
919,34,34,56,56,0,22,22,49,49,0,22,22,53,53,0,0.006399128629293032,0.006399128629293032,62,62,0,-1,3,3,2,4,90,38,93
920,0,0,1,1,0,0,0,1,1,0,0,0,1,1,0,0.0,0.0,1,1,0,-1,-1,-1,8,0,21,84,98
921,0,0,1,1,0,0,0,1,1,0,0,0,1,1,0,0.0,0.0,1,1,0,-1,-1,-1,9,0,35,86,89
922,0,206,1,91,90,0,19,1,30,29,0,7,1,34,33,0.0,0.0010892133837094523,1,36,35,3,-1,4,6,0,56,84,61
923,112,112,75,75,0,150,150,85,85,0,112,112,77,77,0,0.010687906327649,0.010687906327649,72,72,0,-1,2,2,7,4,46,38,92
924,100,100,61,61,0,100,100,43,43,0,100,100,61,61,0,0.016882807447496512,0.016882807447496512,75,75,0,5,1,1,12,3,2,29,58
925,226,1866,92,100,8,228,262,77,84,7,226,262,92,94,2,0.013138636440995268,0.040709350216140784,71,96,25,1,2,2,15,14,7,32,10
926,102,102,87,87,0,46,46,87,87,0,46,46,88,88,0,0.019844106334456584,0.019844106334456584,84,84,0,-1,2,2,2,14,97,32,82
927,237,443,93,100,7,96,96,87,87,0,96,96,87,87,0,0.027638789611627353,0.033935804486197624,90,91,1,3,2,2,3,19,87,15,31
928,0,206,1,89,88,0,42,1,32,31,0,6,1,27,26,0.0,0.0020082371762143027,1,41,40,3,-1,4,9,1,29,50,46
929,100,100,66,66,0,100,100,45,45,0,100,100,66,66,0,0.038224582184553595,0.038224582184553595,95,95,0,-1,1,1,10,19,1,15,89
930,0,616,1,100,99,0,22,1,46,45,0,22,1,51,50,0.0,0.01681473161101467,1,81,80,2,-1,3,2,0,89,81,12
931,328,534,95,99,4,224,224,96,96,0,224,224,96,96,0,0.025051907825317403,0.026243234963749616,86,87,1,3,2,2,8,19,42,15,64
932,80,286,61,94,33,106,106,74,74,0,80,88,63,67,4,0.00707988699411144,0.008407365805507334,62,64,2,3,2,2,7,6,62,28,83
933,0,616,1,100,99,0,24,1,41,40,0,16,1,41,40,0.0,0.004969536063174376,1,52,51,2,-1,3,3,1,60,69,46
934,100,100,65,65,0,100,100,47,47,0,100,100,65,65,0,0.02569862827189489,0.0392457197317812,86,94,8,1,1,1,11,7,38,48,31
935,0,0,1,1,0,0,0,1,1,0,0,0,1,1,0,0.0,0.0,1,1,0,-1,-1,-1,6,0,56,79,87
936,16,1656,34,100,66,68,122,41,65,24,16,122,34,77,43,0.002314578440382586,0.026787841655604345,45,87,42,1,3,2,8,2,42,94,16
937,100,100,66,66,0,100,100,52,52,0,100,100,66,66,0,0.048844412675720754,0.05517546546853194,97,99,2,2,1,1,8,29,15,0,31
938,22,228,39,91,52,82,82,35,35,0,22,28,39,41,2,0.001055175465468532,0.0013274788113958951,38,40,2,3,3,3,14,3,8,51,65
939,314,514,98,100,2,96,96,93,93,0,96,96,93,93,0,0.03951802307770857,0.04183260151809115,95,95,0,3,2,2,3,29,58,1,13
940,128,728,80,100,20,232,232,76,76,0,128,144,80,84,4,0.007113924912352361,0.011164437183021887,62,70,8,2,2,2,14,6,8,26,35
941,118,324,80,97,17,148,148,79,79,0,118,148,80,85,5,0.01507879778072773,0.01589570781850982,75,76,1,3,2,2,9,9,26,39,64
942,1,1,26,26,0,6,6,26,26,0,1,1,26,26,0,0.00010211375472276115,0.00010211375472276115,30,30,0,-1,6,6,6,1,32,78,80
943,0,616,1,100,99,0,34,1,46,45,0,34,1,54,53,0.0,0.01943565131556554,1,85,84,2,-1,3,4,0,77,66,9
944,22,22,48,48,0,38,38,57,57,0,22,22,48,48,0,0.0045270431260424114,0.0045270431260424114,54,54,0,-1,3,3,3,3,85,29,99
945,0,0,1,1,0,0,0,1,1,0,0,0,1,1,0,0.0,0.0,1,1,0,-1,-1,-1,4,0,53,96,93
946,68,274,64,97,33,48,48,59,59,0,48,48,63,63,0,0.009632730862180468,0.013751318969331836,71,80,9,3,3,3,3,7,75,48,13
947,0,206,1,93,92,0,34,1,32,31,0,20,1,40,39,0.0,0.004663194799006093,1,52,51,3,-1,4,9,0,23,86,38
948,100,100,66,66,0,100,100,67,67,0,100,100,73,73,0,0.04693828925422921,0.055107389632050106,96,97,1,2,1,1,5,14,52,14,8
949,18,224,40,89,49,60,64,38,40,2,18,30,40,46,6,0.0002382654276864427,0.0016678579938050988,34,41,7,3,3,3,9,2,28,56,51
950,0,0,1,1,0,0,0,1,1,0,0,0,1,1,0,0.0,0.0,1,1,0,-1,-1,-1,10,1,0,69,80
951,100,100,80,80,0,32,32,64,64,0,32,32,64,64,0,0.017087034956942034,0.017087034956942034,80,80,0,-1,3,3,2,18,89,30,96
952,22,124,40,79,39,76,76,37,37,0,22,22,40,40,0,0.00037441710065012424,0.00037441710065012424,32,32,0,4,3,3,12,2,3,56,95
953,100,100,64,64,0,100,100,57,57,0,100,100,66,66,0,0.021614078082984444,0.02219272269308009,87,87,0,3,1,1,7,1,46,88,56
954,192,293,93,99,6,72,72,85,85,0,72,72,85,85,0,0.029510875114877974,0.029681064706082574,88,88,0,5,2,2,3,19,60,15,55
955,0,206,1,89,88,0,46,1,34,33,0,46,1,54,53,0.0,0.006535280302256714,1,61,60,3,-1,4,9,0,28,85,24
956,22,228,46,94,48,28,28,43,43,0,22,28,46,49,3,0.002280540522141666,0.005377991082065421,49,57,8,3,3,3,3,2,66,52,26
957,0,616,1,100,99,0,34,1,46,45,0,34,1,54,53,0.0,0.015317063208414174,1,79,78,2,-1,3,4,0,78,86,23
958,100,100,60,60,0,100,100,40,40,0,100,100,60,60,0,0.01933353756084278,0.01933353756084278,79,79,0,-1,1,1,14,7,25,48,79
959,16,16,39,39,0,42,42,41,41,0,16,16,39,39,0,0.0040845501889104465,0.0040845501889104465,51,51,0,-1,3,3,6,1,69,90,81
960,0,206,1,95,94,0,8,1,31,30,0,8,1,37,36,0.0,0.003199564314646516,1,50,49,3,-1,4,2,0,95,79,13
961,6,1646,29,100,71,36,176,32,69,37,6,176,29,88,59,0.00017018959120460194,0.039824364341876854,30,94,64,1,4,2,12,1,6,60,0
962,64,680,59,100,41,124,124,66,66,0,64,124,59,80,21,0.007352190340038803,0.01657646618332823,62,76,14,2,3,3,9,4,54,38,14
963,0,0,1,1,0,0,0,1,1,0,0,0,1,1,0,0.0,0.0,1,1,0,-1,-1,-1,4,0,79,96,98
964,60,60,64,64,0,28,28,44,44,0,28,28,51,51,0,0.007522379931243405,0.007522379931243405,66,66,0,-1,3,3,3,9,92,31,82
965,104,704,80,100,20,80,80,60,60,0,80,80,65,65,0,0.014772456516559448,0.027604751693386432,78,90,12,2,3,3,5,9,50,39,23
966,0,0,1,1,0,0,0,1,1,0,0,0,1,1,0,0.0,0.0,1,1,0,-1,-1,-1,8,0,10,86,89
967,12,1652,33,100,67,58,116,35,57,22,12,120,33,78,45,0.001157289220191293,0.016236087000919025,38,76,38,1,4,2,11,3,33,51,31
968,100,100,72,72,0,100,100,87,87,0,100,100,87,87,0,0.08938357330065694,0.08938357330065694,100,100,0,-1,1,1,4,36,53,2,84
969,0,616,1,100,99,0,41,1,31,30,0,25,1,42,41,0.0,0.0034037918240920387,1,47,46,2,-1,3,10,0,12,99,41
970,24,1664,46,100,54,52,86,40,52,12,24,86,46,58,12,0.0010211375472276116,0.019912182170938427,39,84,45,1,3,2,7,4,24,64,35
971,118,118,77,77,0,272,272,86,86,0,118,118,77,77,0,0.010177337554035196,0.010177337554035196,69,69,0,-1,2,2,14,5,16,25,59
972,226,842,92,100,8,176,176,85,85,0,176,176,89,89,0,0.019571802988529223,0.030327785152660065,82,88,6,2,2,2,8,18,42,30,37
973,130,746,81,100,19,172,172,75,75,0,130,172,81,87,6,0.008237176214302734,0.012968446849790666,65,73,8,2,3,3,12,13,3,24,28
974,8,8,38,38,0,8,8,33,33,0,8,8,38,38,0,0.002314578440382586,0.002314578440382586,44,44,0,-1,4,4,2,2,99,75,67
975,132,132,80,80,0,100,100,70,70,0,100,100,72,72,0,0.014908608189523128,0.014908608189523128,78,78,0,-1,2,2,6,8,65,8,82
976,100,100,58,58,0,100,100,35,35,0,100,100,59,59,0,0.03230198441063344,0.036488648354266656,92,92,0,2,1,1,17,19,20,15,28
977,0,616,1,100,99,0,52,1,39,38,0,52,1,50,49,0.0,0.008747744987916539,1,65,64,2,-1,3,6,0,56,92,27
978,62,678,57,100,43,154,154,71,71,0,62,109,57,78,21,0.0038462847612240037,0.009836958371625992,53,70,17,2,2,2,10,6,1,70,44
979,0,206,1,89,88,0,33,1,33,32,0,6,1,32,31,0.0,0.0018720855032506212,1,41,40,3,-1,4,9,0,26,98,94
980,0,616,1,100,99,0,48,1,31,30,0,18,1,38,37,0.0,0.001055175465468532,1,37,36,2,-1,3,14,1,25,50,56
981,405,1005,98,100,2,190,190,91,91,0,190,190,91,91,0,0.036590762108989414,0.04802750263793867,96,99,3,2,2,2,8,29,27,1,18
982,258,874,94,100,6,168,168,93,93,0,168,168,94,94,0,0.026787841655604345,0.03185949147350148,88,89,1,2,2,2,6,15,44,16,38
983,100,100,69,69,0,100,100,66,66,0,100,100,72,72,0,0.05888559855679227,0.06453589298478506,99,100,1,2,1,1,6,30,44,7,31
984,97,303,80,99,19,62,62,82,82,0,62,62,82,82,0,0.015827631982027978,0.020354675108070392,79,84,5,3,2,2,3,8,92,44,13
985,16,16,33,33,0,66,66,44,44,0,16,16,33,33,0,0.0028932230504782326,0.0028932230504782326,46,46,0,-1,3,3,6,3,40,46,84
986,121,221,80,91,11,160,160,73,73,0,121,121,80,80,0,0.00793083495013445,0.007998910786616291,64,64,0,5,2,2,11,8,38,44,78
987,166,1806,85,100,15,198,222,83,91,8,166,206,86,91,5,0.01766567956703768,0.0300554818067327,80,89,9,1,2,2,10,9,0,39,46
988,8,214,36,94,58,18,18,36,36,0,8,18,36,44,8,0.0012594029749140542,0.009258313761530345,41,70,29,3,4,4,3,2,66,74,27
989,100,100,78,78,0,100,100,96,96,0,100,100,96,96,0,0.08325674801729126,0.08543517478471016,100,100,0,4,1,1,3,27,81,10,70
990,0,0,1,1,0,0,0,1,1,0,0,0,1,1,0,0.0,0.0,1,1,0,-1,-1,-1,9,0,35,59,86
991,2,208,27,92,65,4,18,27,37,10,2,18,27,46,19,0.0,0.006603356138738555,1,60,59,3,5,4,3,1,85,95,25
992,286,492,99,100,1,136,136,97,97,0,136,136,97,97,0,0.046223492971169886,0.04979747438646653,96,96,0,3,2,2,4,27,72,10,22
993,130,746,81,100,19,172,172,75,75,0,130,172,81,87,6,0.008237176214302734,0.012968446849790666,65,73,8,2,3,3,12,13,3,24,28
994,0,616,1,100,99,0,18,1,46,45,0,18,1,48,47,0.0,0.012832295176826986,1,73,72,2,-1,3,2,0,99,84,5
995,51,257,57,97,40,38,38,46,46,0,38,38,51,51,0,0.005480104836788182,0.01579359406378706,55,80,25,3,3,3,3,6,96,35,32
996,334,950,96,100,4,246,246,95,95,0,246,246,96,96,0,0.025290173253003846,0.028421661731168522,88,90,2,2,2,2,10,19,22,15,46
997,112,112,75,75,0,150,150,85,85,0,112,112,77,77,0,0.009530617107457708,0.009530617107457708,67,67,0,-1,2,2,7,4,46,72,86
998,209,209,94,94,0,144,144,90,90,0,144,144,90,90,0,0.023622315259198747,0.023622315259198747,87,87,0,-1,2,2,6,20,59,23,98
999,6,212,32,94,62,10,14,32,36,4,6,12,32,39,7,0.0004765308553728854,0.002757071377514551,37,47,10,3,4,4,3,1,81,49,94
