,FreeNet_pre_score,FreeNet_post_score,FreeNet_pre_rank,FreeNet_post_rank,FreeNet_delta_ranks,Reversed_pre_score,Reversed_post_score,Reversed_pre_rank,Reversed_post_rank,Reversed_delta_ranks,Independent_pre_score,Independent_post_score,Independent_pre_rank,Independent_post_rank,Independent_delta_ranks,Random_pre_score,Random_post_score,Random_pre_rank,Random_post_rank,Random_delta_ranks,dist_victim_relayer,dist_victim_vilain_pre,dist_victim_vilain_post,out_deg_victim,in_deg_villain,victim,villain,relayer
0,78,284,72,98,26,38,38,56,56,0,38,38,57,57,0,0.013444977705163553,0.016712617856291908,76,81,5,3,3,3,3,9,60,39,22
1,0,0,1,1,0,0,0,1,1,0,0,0,1,1,0,0.0,0.0,1,1,0,-1,-1,-1,3,0,60,91,89
2,6,622,28,100,72,32,118,29,58,29,6,79,28,55,27,0.0002042275094455223,0.011198475101262807,32,67,35,2,4,3,16,1,9,55,39
3,18,120,48,87,39,22,22,49,49,0,18,22,51,52,1,0.0016338200755641784,0.0030634126416828346,43,50,7,4,3,3,2,2,90,61,83
4,134,134,81,81,0,92,92,55,55,0,92,92,67,67,0,0.009734844616903231,0.009734844616903231,69,69,0,-1,3,3,7,9,43,31,89
5,92,708,66,100,34,86,96,56,63,7,86,96,62,72,10,0.009190237925048503,0.013683243132849994,68,75,7,2,3,3,6,8,51,44,13
6,100,100,59,59,0,100,100,40,40,0,100,100,59,59,0,0.018074134585928724,0.0315531502093332,79,92,13,2,1,1,15,4,7,38,30
7,32,238,46,92,46,112,112,58,58,0,32,40,46,48,2,0.002280540522141666,0.003778208924742163,46,53,7,3,3,3,12,2,14,75,52
8,152,358,89,100,11,96,96,91,91,0,96,96,91,91,0,0.022396950202525613,0.033799652813233945,85,91,6,3,2,2,3,14,76,14,37
9,197,197,91,91,0,144,144,90,90,0,144,144,90,90,0,0.01943565131556554,0.01943565131556554,84,84,0,-1,2,2,6,15,59,19,85
10,362,568,98,100,2,158,158,97,97,0,158,158,97,97,0,0.03897341638585384,0.04493005207801491,96,97,1,3,2,2,6,29,71,0,77
11,0,206,1,93,92,0,18,1,40,39,0,18,1,45,44,0.0,0.0038462847612240037,1,50,49,3,-1,4,3,1,60,69,38
12,0,101,1,82,81,0,3,1,25,24,0,1,1,25,24,0.0,3.4037918240920386e-05,1,26,25,6,-1,7,3,0,75,82,58
13,22,638,49,100,51,22,32,49,68,19,22,32,53,68,15,0.0020763130126961434,0.021852343510670887,45,86,41,2,3,3,2,2,90,52,6
14,16,222,35,91,56,100,100,45,45,0,16,26,35,45,10,0.0026549576227917903,0.0036760951700194017,47,50,3,3,3,3,10,2,1,94,43
15,100,100,79,79,0,100,100,97,97,0,100,100,97,97,0,0.0569454372170598,0.0569454372170598,99,99,0,-1,1,1,3,6,60,41,66
16,0,1640,1,100,99,0,210,1,71,70,0,210,1,92,91,0.0,0.034854828278702475,1,94,93,1,-1,2,16,0,4,82,2
17,6,622,28,100,72,20,94,29,48,19,6,94,28,68,40,0.00013615167296368154,0.01933353756084278,30,81,51,2,4,3,9,1,31,55,9
18,497,1097,100,100,0,344,344,99,99,0,344,344,99,99,0,0.03441233534157051,0.043704687021341775,91,96,5,2,2,2,14,29,8,1,5
19,0,0,1,1,0,0,0,1,1,0,0,0,1,1,0,0.0,0.0,1,1,0,-1,-1,-1,8,1,10,69,82
20,405,1005,98,100,2,160,160,86,86,0,160,160,88,88,0,0.03400388032267947,0.04819769222914327,93,97,4,2,2,2,7,29,24,1,23
21,6,212,29,89,60,22,40,29,33,4,6,12,29,34,5,0.0002042275094455223,0.0025188059498281084,32,45,13,3,4,4,10,1,18,55,90
22,6,622,30,100,70,23,46,30,37,7,6,46,30,50,20,0.0002382654276864427,0.014568229007113924,31,78,47,2,4,3,6,1,71,88,18
23,0,616,1,100,99,0,37,1,33,32,0,22,1,42,41,0.0,0.0023486163586235067,1,46,45,2,-1,3,10,0,1,96,75
24,2,208,29,93,64,7,20,29,34,5,2,20,29,47,18,0.0002042275094455223,0.013410939786922631,32,76,44,3,5,4,4,1,73,55,37
25,8,1648,35,100,65,38,84,34,45,11,8,84,35,63,28,0.00037441710065012424,0.025324211171244768,35,89,54,1,4,2,9,2,26,56,30
26,100,100,82,82,0,100,100,98,98,0,100,100,98,98,0,0.10075223799312434,0.10075223799312434,99,99,0,-1,1,1,2,20,98,23,79
27,38,244,49,94,45,60,60,49,49,0,38,60,49,53,4,0.0018380475850097008,0.004629156880765172,44,53,9,3,3,3,5,4,52,64,73
28,375,2015,97,100,3,160,184,93,96,3,160,184,94,97,3,0.03448041117805235,0.0672929643622996,91,100,9,1,2,2,7,29,62,1,10
29,100,100,65,65,0,100,100,75,75,0,100,100,77,77,0,0.04625753088941081,0.04625753088941081,97,97,0,4,1,1,5,16,61,12,95
30,1,617,26,100,74,3,38,26,46,20,1,38,26,52,26,6.807583648184077e-05,0.020695054290479593,29,86,57,2,6,3,3,1,75,68,9
31,8,8,37,37,0,26,26,36,36,0,8,8,37,37,0,0.0011232513019503727,0.0011232513019503727,39,39,0,-1,4,4,5,2,49,74,81
32,82,82,74,74,0,56,56,84,84,0,56,56,84,84,0,0.01681473161101467,0.01681473161101467,78,78,0,-1,2,2,2,6,86,34,84
33,256,462,94,100,6,192,192,100,100,0,192,192,100,100,0,0.030804316008032948,0.038939378467612924,90,95,5,3,2,2,6,16,74,18,8
34,0,616,1,100,99,0,28,1,42,41,0,28,1,48,47,0.0,0.007352190340038803,1,65,64,2,-1,3,3,0,66,84,31
35,0,1640,1,100,99,0,102,1,65,64,0,98,1,67,66,0.0,0.022703291466693896,1,87,86,1,-1,2,8,0,39,67,27
36,0,616,1,99,98,0,126,1,63,62,0,126,1,79,78,0.0,0.024166921951053473,1,89,88,2,-1,3,11,0,19,36,0
37,98,714,68,100,32,66,76,50,53,3,66,76,61,65,4,0.011096361346540046,0.029510875114877974,71,90,19,2,3,3,6,8,56,8,9
38,24,230,44,94,50,66,66,42,42,0,24,60,44,55,11,0.0014295925661186562,0.005480104836788182,41,54,13,3,3,3,9,3,35,43,13
39,56,262,53,93,40,154,154,67,67,0,56,64,53,55,2,0.0033357159876101976,0.003608019333537561,50,52,2,3,2,2,10,2,18,52,63
40,0,206,1,88,87,0,42,1,34,33,0,24,1,44,43,0.0,0.004050512270669526,1,50,49,3,-1,4,9,0,54,86,57
41,282,482,93,98,5,300,300,91,91,0,300,300,94,94,0,0.023111746485584943,0.025936893699581333,85,87,2,3,2,2,14,16,17,12,29
42,6,6,33,33,0,8,8,33,33,0,6,6,33,33,0,0.00037441710065012424,0.00037441710065012424,35,35,0,-1,4,4,2,1,90,49,81
43,0,616,1,100,99,0,42,1,37,36,0,42,1,51,50,0.0,0.008441403723748256,1,64,63,2,-1,3,6,0,65,86,17
44,0,616,1,100,99,0,22,1,41,40,0,22,1,44,43,0.0,0.00707988699411144,1,62,61,2,-1,3,2,0,91,36,47
45,130,336,89,100,11,46,46,83,83,0,46,46,83,83,0,0.02413288403281255,0.042649511555873244,89,97,8,3,2,2,2,20,99,23,1
46,100,100,69,69,0,100,100,55,55,0,100,100,69,69,0,0.03179141563701964,0.03179141563701964,91,91,0,-1,1,1,8,8,30,17,98
47,100,100,65,65,0,100,100,75,75,0,100,100,77,77,0,0.03968821266891317,0.03968821266891317,93,93,0,-1,1,1,5,7,61,48,98
48,0,0,1,1,0,0,0,1,1,0,0,0,1,1,0,0.0,0.0,1,1,0,-1,-1,-1,6,0,56,79,85
49,96,1696,76,100,24,62,62,79,79,0,62,62,79,79,0,0.01575955614554614,0.05568603424214575,78,97,19,1,2,2,3,8,76,17,30
50,16,616,42,100,58,24,24,43,43,0,16,24,42,48,6,0.0009190237925048504,0.006875659484665918,38,62,24,2,3,3,3,1,58,49,26
51,2,2,28,28,0,9,9,31,31,0,2,2,28,28,0,3.4037918240920386e-05,3.4037918240920386e-05,26,26,0,-1,5,5,5,1,45,95,93
52,247,847,92,100,8,248,248,89,89,0,248,248,92,92,0,0.025494400762449368,0.031212771026923995,86,90,4,2,2,2,11,20,5,23,48
53,78,284,61,95,34,100,100,55,55,0,78,100,61,66,5,0.006637394056979475,0.011811157629599374,62,70,8,3,3,3,9,8,23,57,44
54,0,206,1,92,91,0,20,1,35,34,0,20,1,50,49,0.0,0.006943735321147759,1,61,60,3,-1,4,4,0,78,89,32
55,22,228,46,95,49,22,22,42,42,0,22,22,45,45,0,0.0030974505599237552,0.022737329384934817,49,88,39,3,3,3,2,2,91,75,1
56,38,654,51,100,49,40,50,45,49,4,38,50,51,53,2,0.002927260968719153,0.009394465434494027,49,69,20,2,3,3,5,6,37,70,34
57,22,22,40,40,0,56,56,38,38,0,22,22,40,40,0,0.0007147962830593281,0.0007147962830593281,36,36,0,-1,3,3,8,2,42,63,98
58,6,622,33,100,67,22,50,35,47,12,6,50,33,56,23,0.0006126825283365669,0.02130773681881616,37,84,47,2,4,3,5,2,49,42,11
59,86,292,54,95,41,210,210,72,72,0,86,92,54,55,1,0.00803294870485721,0.008441403723748256,62,62,0,3,2,2,16,6,4,34,42
60,2,208,27,90,63,11,16,29,32,3,2,8,27,34,7,6.807583648184077e-05,0.0008169100377820892,28,38,10,3,5,4,6,1,74,95,71
61,190,190,89,89,0,318,318,91,91,0,190,190,89,89,0,0.01330882603219987,0.01330882603219987,74,74,0,-1,2,2,16,9,4,27,45
62,0,616,1,99,98,0,98,1,45,44,0,88,1,57,56,0.0,0.009530617107457708,1,65,64,2,-1,3,11,0,5,81,8
63,0,616,1,100,99,0,72,1,45,44,0,72,1,58,57,0.0,0.016099935327955343,1,79,78,2,-1,3,7,1,43,50,6
64,66,66,60,60,0,114,114,67,67,0,66,66,60,60,0,0.0051397256543789785,0.0051397256543789785,54,54,0,-1,3,3,9,6,23,28,82
65,0,0,1,1,0,0,0,1,1,0,0,0,1,1,0,0.0,0.0,1,1,0,-1,-1,-1,14,0,17,96,82
66,178,384,88,98,10,190,190,94,94,0,190,190,94,94,0,0.018788930868988054,0.019776030497974745,81,82,1,3,2,2,8,12,21,37,61
67,100,100,58,58,0,100,100,38,38,0,100,100,58,58,0,0.04894652643044351,0.06582933387794003,98,100,2,2,1,1,16,30,9,7,0
68,0,101,1,81,80,0,4,1,25,24,0,1,1,25,24,0.0,3.4037918240920386e-05,1,26,25,6,-1,7,4,0,77,80,68
69,88,294,68,95,27,78,78,73,73,0,88,78,77,73,-4,0.010143299635794275,0.01501072194424589,73,80,7,3,2,2,4,4,79,38,57
70,129,335,87,100,13,48,48,72,72,0,48,48,74,74,0,0.014329963579427483,0.01923142380612002,78,85,7,3,3,3,3,15,60,19,34
71,443,443,100,100,0,214,214,97,97,0,214,214,97,97,0,0.03604615541713469,0.03604615541713469,95,95,0,-1,2,2,8,29,10,1,92
72,8,109,36,83,47,18,18,36,36,0,8,9,36,36,0,0.0004084550188910446,0.0004765308553728854,34,34,0,5,4,4,3,2,75,56,65
73,22,228,43,94,51,40,40,39,39,0,22,32,43,50,7,0.0019741992579733825,0.0030293747234419145,44,51,7,3,3,3,5,2,63,52,43
74,91,297,66,94,28,90,90,61,61,0,91,90,66,66,0,0.007590455767725246,0.00793083495013445,62,63,1,3,2,2,6,6,41,35,56
75,362,362,97,97,0,224,224,97,97,0,224,224,97,97,0,0.037509785901494265,0.037509785901494265,93,93,0,-1,2,2,8,27,57,10,76
76,100,100,59,59,0,100,100,40,40,0,100,100,59,59,0,0.018074134585928724,0.04135607066271827,79,97,18,2,1,1,15,4,7,38,1
77,8,624,35,100,65,32,42,37,40,3,8,42,35,56,21,0.00034037918240920387,0.00704584907587052,34,62,28,2,4,3,6,2,32,56,24
78,92,298,69,95,26,96,96,74,74,0,96,96,74,74,0,0.013513053541645392,0.01667857993805099,75,79,4,3,3,3,6,8,69,20,35
79,0,616,1,100,99,0,24,1,41,40,0,16,1,41,40,0.0,0.006262976956329351,1,59,58,2,-1,3,3,0,75,76,90
80,18,224,40,89,49,66,66,37,37,0,18,26,40,44,4,0.0004765308553728854,0.0012594029749140542,34,39,5,3,3,3,10,2,22,56,74
81,118,324,82,96,14,110,110,81,81,0,110,110,85,85,0,0.01330882603219987,0.014534191088873005,76,78,2,3,2,2,6,9,32,27,83
82,16,16,33,33,0,48,48,35,35,0,16,16,33,33,0,0.0006126825283365669,0.0006126825283365669,36,36,0,-1,3,3,9,1,31,88,82
83,0,206,1,90,89,0,11,1,26,25,0,6,1,26,25,0.0,0.00034037918240920387,1,28,27,3,-1,4,6,0,51,86,65
84,80,286,72,96,24,64,64,64,64,0,64,64,67,67,0,0.012083460975526737,0.02021852343510671,74,85,11,3,3,3,4,9,77,27,20
85,0,206,1,92,91,0,24,1,39,38,0,24,1,51,50,0.0,0.009394465434494027,1,66,65,3,-1,4,4,0,47,89,19
86,54,260,59,96,37,38,38,53,53,0,38,38,55,55,0,0.006875659484665918,0.00888389666088022,62,67,5,3,3,3,3,7,64,62,46
87,78,180,64,88,24,110,110,81,81,0,78,80,64,64,0,0.00891793457912114,0.010790020082371761,67,68,1,4,2,2,6,7,65,62,46
88,2,2,26,26,0,11,11,26,26,0,2,2,26,26,0,0.0,0.0,1,1,0,-1,5,5,10,2,11,58,89
89,0,616,1,100,99,0,34,1,54,53,0,34,1,56,55,0.0,0.010109261717553355,1,72,71,2,-1,3,3,0,76,92,38
90,0,102,1,79,78,0,6,1,28,27,0,2,1,26,25,0.0,0.0009190237925048504,1,36,35,4,-1,5,3,0,58,84,71
91,6,622,29,100,71,23,68,29,39,10,6,74,29,54,25,6.807583648184077e-05,0.008679669151434699,30,68,38,2,4,3,10,1,0,65,8
92,22,638,38,100,62,84,126,35,58,23,22,127,38,75,37,0.001157289220191293,0.010960209673576363,38,66,28,2,3,3,15,3,7,51,19
93,0,206,1,92,91,0,30,1,38,37,0,30,1,49,48,0.0,0.01143674052894925,1,71,70,3,-1,4,5,0,37,80,5
94,0,616,1,100,99,0,50,1,38,37,0,34,1,47,46,0.0,0.006262976956329351,1,61,60,2,-1,3,8,0,39,91,62
95,184,800,88,100,12,318,318,91,91,0,184,200,88,90,2,0.013444977705163553,0.015214949453691413,75,78,3,2,2,2,16,8,4,17,53
96,128,128,81,81,0,150,150,85,85,0,128,128,86,86,0,0.00796487286837537,0.00796487286837537,61,61,0,-1,2,2,7,5,46,47,89
97,22,638,41,100,59,64,74,41,41,0,22,50,41,55,14,0.0021784267674189047,0.005412029000306341,47,58,11,2,3,3,9,2,28,75,35
98,60,60,60,60,0,76,76,54,54,0,60,60,60,60,0,0.0053099152455835805,0.0053099152455835805,56,56,0,-1,3,3,6,6,32,28,40
99,163,263,88,95,7,72,72,77,77,0,72,72,77,77,0,0.017903944994724124,0.017903944994724124,82,82,0,5,2,2,3,15,82,19,68
100,0,0,1,1,0,0,0,1,1,0,0,0,1,1,0,0.0,0.0,1,1,0,-1,-1,-1,3,0,60,92,87
101,100,100,61,61,0,100,100,43,42,-1,100,100,61,61,0,0.016882807447496512,0.03713536880084414,75,97,22,1,1,1,12,3,2,29,37
102,0,206,1,86,85,0,36,1,33,32,0,21,1,41,40,0.0,0.0030634126416828346,1,47,46,3,-1,4,8,0,27,98,28
103,0,0,1,1,0,0,0,1,1,0,0,0,1,1,0,0.0,0.0,1,1,0,-1,-1,-1,5,0,45,81,66
104,164,370,85,99,14,144,144,88,88,0,144,144,89,89,0,0.020763130126961436,0.02290751897613942,84,86,2,3,2,2,6,12,34,37,46
105,32,1672,45,100,55,72,106,45,66,21,32,106,45,75,30,0.002757071377514551,0.031280846863405834,46,91,45,1,3,2,7,2,46,52,5
106,68,684,65,100,35,56,56,80,80,0,56,56,81,81,0,0.011198475101262807,0.0156914803090643,72,79,7,2,2,2,2,4,91,72,51
107,46,46,61,61,0,46,46,83,83,0,46,46,83,83,0,0.02130773681881616,0.02130773681881616,86,86,0,-1,2,2,2,3,99,51,85
108,58,674,55,100,45,100,124,45,62,17,58,124,55,79,24,0.002110350930937064,0.017223186629905716,43,78,35,2,2,2,10,4,12,64,23
109,0,102,1,80,79,0,5,1,27,26,0,2,1,27,26,0.0,0.0010892133837094523,1,38,37,4,-1,5,3,0,76,82,71
110,100,100,61,61,0,100,100,40,40,0,100,100,61,61,0,0.04625753088941081,0.04625753088941081,97,97,0,4,1,1,14,29,8,11,68
111,56,262,58,94,36,54,54,53,53,0,54,54,57,57,0,0.004935498144933456,0.006024711528642908,55,58,3,3,3,3,4,6,79,35,61
112,72,1712,56,100,44,142,166,78,83,5,72,166,56,84,28,0.006024711528642908,0.0247115286429082,57,85,28,1,2,2,8,6,27,70,20
113,54,155,52,82,30,134,134,69,69,0,54,55,52,52,0,0.006909697402906838,0.007011811157629599,59,61,2,5,3,3,9,4,54,72,55
114,41,41,56,56,0,34,34,46,46,0,34,34,52,52,0,0.004186663943633207,0.004186663943633207,53,53,0,-1,3,3,4,6,73,35,40
115,80,280,68,93,25,60,60,55,55,0,60,60,60,60,0,0.008135062459579971,0.015453214881377854,66,76,10,3,3,3,5,13,70,24,8
116,16,632,46,100,54,12,22,41,47,6,12,22,41,50,9,0.002927260968719153,0.03226794649239253,49,93,44,2,4,3,2,6,95,41,2
117,266,266,97,97,0,288,288,95,95,0,288,288,95,95,0,0.022839443139657578,0.022839443139657578,84,84,0,-1,2,2,12,16,6,18,76
118,0,206,1,89,88,0,14,1,31,30,0,8,1,35,34,0.0,0.002212464685659825,1,46,45,3,-1,4,5,0,61,99,75
119,6,622,29,100,71,26,70,32,41,9,6,62,29,55,26,0.00013615167296368154,0.007352190340038803,32,61,29,2,4,3,9,1,28,4,21
120,104,1744,71,100,29,148,182,71,81,10,104,182,71,87,16,0.00704584907587052,0.03441233534157051,61,92,31,1,2,2,9,6,28,26,23
121,192,392,94,100,6,56,56,85,85,0,56,56,85,85,0,0.032914666938970015,0.039415909322985804,93,94,1,3,2,2,2,22,90,9,33
122,1,1641,26,100,74,12,156,26,67,41,1,156,26,85,59,0.00010211375472276115,0.028625889240614044,27,91,64,1,6,2,12,1,14,78,7
123,78,78,72,72,0,56,56,82,82,0,56,56,82,82,0,0.015317063208414174,0.015317063208414174,78,78,0,-1,2,2,2,4,89,72,40
124,2,2,28,28,0,8,8,29,29,0,2,2,28,28,0,0.00010211375472276115,0.00010211375472276115,30,30,0,-1,5,5,5,1,70,95,67
125,2,2,27,27,0,5,5,27,27,0,2,2,27,27,0,6.807583648184077e-05,6.807583648184077e-05,28,28,0,-1,5,5,3,1,94,95,45
126,420,522,100,100,0,280,280,100,100,0,280,280,100,100,0,0.036624800027230335,0.03672691378195309,93,93,0,4,2,2,10,27,36,10,65
127,100,100,70,70,0,100,100,68,68,0,100,100,73,73,0,0.03264236359304265,0.03965417475067225,90,93,3,2,1,1,6,7,48,62,21
128,100,100,76,76,0,100,100,97,97,0,100,100,97,97,0,0.06028115320467,0.07491745804826577,99,99,0,3,1,1,3,6,94,34,9
129,40,656,48,100,52,108,138,63,74,11,40,138,48,81,33,0.003642057251778481,0.04203682902753668,50,96,46,2,2,2,9,2,31,94,2
130,144,1784,85,100,15,220,254,82,91,9,144,254,85,94,9,0.00704584907587052,0.025868817863099493,60,89,29,1,2,2,12,6,6,13,39
131,110,110,79,79,0,70,70,63,63,0,70,70,66,66,0,0.012185574730249497,0.012185574730249497,72,72,0,-1,3,3,5,14,49,32,40
132,16,632,35,100,65,58,72,42,44,2,16,72,35,58,23,0.0007828721195411688,0.021716191837707205,38,86,48,2,3,3,7,1,24,49,11
133,6,212,32,91,59,24,24,38,38,0,6,24,32,49,17,0.002723033459273631,0.007692569522448007,48,63,15,3,4,4,4,3,79,46,44
134,0,0,1,1,0,0,0,1,1,0,0,0,1,1,0,0.0,0.0,1,1,0,-1,-1,-1,8,0,27,85,69
135,309,925,98,100,2,120,120,100,100,0,120,120,100,100,0,0.04499812791449675,0.07634705061438442,96,100,4,2,2,2,3,29,76,11,2
136,0,0,1,1,0,0,0,1,1,0,0,0,1,1,0,0.0,0.0,1,1,0,-1,-1,-1,6,0,48,99,87
137,267,467,98,100,2,48,48,67,67,0,48,48,70,70,0,0.02998740597025086,0.03025970931617822,92,92,0,3,3,3,3,29,96,1,49
138,0,616,1,100,99,0,74,1,41,40,0,74,1,61,60,0.0,0.0141938119064638,1,76,75,2,-1,3,9,1,31,69,18
139,24,24,47,47,0,34,34,39,39,0,24,24,47,47,0,0.0013274788113958951,0.0013274788113958951,41,41,0,-1,3,3,4,3,53,43,97
140,475,681,99,100,1,216,216,99,99,0,216,216,99,99,0,0.04697232717247013,0.055039313795568263,95,98,3,3,2,2,6,40,48,3,77
141,0,102,1,74,73,0,22,1,28,27,0,2,1,25,24,0.0,0.00030634126416828345,1,33,32,4,-1,5,16,0,9,85,88
142,166,267,95,100,5,32,32,67,67,0,32,32,68,68,0,0.03185949147350148,0.032199870655910685,94,94,0,5,3,3,2,29,97,0,65
143,49,255,52,94,42,44,44,44,44,0,49,44,56,50,-6,0.0051397256543789785,0.005922597773920147,52,53,1,3,3,3,4,4,67,22,49
144,100,100,62,62,0,100,100,45,45,0,100,100,62,62,0,0.025970931617822254,0.03298274277545185,86,91,5,3,1,1,12,8,3,17,8
145,0,0,1,1,0,0,0,1,1,0,0,0,1,1,0,0.0,0.0,1,1,0,-1,-1,-1,10,0,1,93,87
146,126,332,80,97,17,110,110,83,83,0,110,110,83,83,0,0.01504475986248681,0.024337111542258077,76,86,10,3,2,2,6,8,71,17,37
147,96,696,56,100,44,190,190,69,69,0,96,104,56,74,18,0.007011811157629599,0.008237176214302734,59,62,3,2,2,2,16,6,4,35,54
148,38,38,54,54,0,32,32,58,58,0,32,32,60,60,0,0.0031314884781646754,0.0031314884781646754,50,50,0,-1,3,3,2,3,91,54,82
149,16,222,40,97,57,38,38,51,51,0,16,38,40,53,13,0.002280540522141666,0.005786446100956465,45,55,10,3,3,3,3,1,94,71,73
150,198,404,88,100,12,120,120,85,85,0,120,120,87,87,0,0.020150447598624867,0.021818305592429966,80,84,4,3,2,2,6,17,74,6,46
151,0,206,1,89,88,0,28,1,33,32,0,28,1,43,42,0.0,0.007522379931243405,1,59,58,3,-1,4,6,0,71,84,20
152,190,190,88,88,0,190,190,92,92,0,190,190,94,94,0,0.019571802988529223,0.019571802988529223,82,82,0,-1,2,2,8,9,42,39,84
153,144,350,85,97,12,220,220,82,82,0,144,154,85,87,2,0.00704584907587052,0.008645631233193778,60,66,6,3,2,2,12,6,6,13,54
154,100,100,57,57,0,100,100,38,38,0,100,100,57,57,0,0.024064808196330712,0.031314884781646755,84,90,6,1,1,1,16,9,4,39,56
155,100,100,63,63,0,100,100,39,39,0,100,100,63,63,0,0.046734061744783686,0.05132918070730794,95,99,4,2,1,1,14,30,17,7,22
156,0,1640,1,100,99,0,52,1,74,73,0,52,1,75,74,0.0,0.04053916062493618,1,95,94,1,-1,2,3,0,87,97,24
157,0,102,1,77,76,0,8,1,28,27,0,4,1,29,28,0.0,0.0015317063208414173,1,42,41,4,-1,5,4,0,53,93,75
158,6,212,31,97,66,12,12,37,37,0,6,12,31,41,10,0.004288777698355968,0.008577555396711936,51,66,15,3,4,4,2,1,99,90,21
159,16,222,38,90,52,56,56,46,46,0,16,23,38,47,9,0.002484768031587188,0.0033016780693692774,48,51,3,3,3,3,6,3,74,46,61
160,0,206,1,92,91,0,18,1,32,31,0,18,1,44,43,0.0,0.005412029000306341,1,54,53,3,-1,4,5,1,88,69,24
161,0,616,1,100,99,0,138,1,60,59,0,138,1,85,84,0.0,0.017155110793423873,1,77,76,2,-1,3,13,1,13,69,16
162,32,238,44,94,50,44,44,44,44,0,32,44,44,49,5,0.004288777698355968,0.008339289969025495,48,62,14,3,3,3,4,3,67,29,47
163,0,616,1,100,99,0,18,1,52,51,0,18,1,53,52,0.0,0.011164437183021887,1,72,71,2,-1,3,2,0,97,66,73
164,58,160,66,89,23,28,28,45,45,0,28,28,49,49,0,0.008169100377820893,0.008543517478471017,66,67,1,4,3,3,3,7,60,48,56
165,0,206,1,92,91,0,18,1,34,33,0,18,1,47,46,0.0,0.005650294427992784,1,55,54,3,-1,4,3,0,87,66,25
166,199,815,91,100,9,168,168,87,87,0,168,168,89,89,0,0.02396269444160795,0.0348888661969434,86,92,6,2,2,2,9,15,35,16,5
167,0,616,1,100,99,0,72,1,48,47,0,72,1,60,59,0.0,0.018244324177133328,1,81,80,2,-1,3,7,0,62,67,23
168,12,218,40,97,57,18,18,38,38,0,12,18,40,46,6,0.0010892133837094523,0.021341774737057083,38,86,48,3,4,4,3,2,81,74,11
169,0,0,1,1,0,0,0,1,1,0,0,0,1,1,0,0.0,0.0,1,1,0,-1,-1,-1,11,0,38,76,80
170,0,616,1,100,99,0,54,1,34,33,0,42,1,48,47,0.0,0.007386228258279724,1,61,60,2,-1,3,8,0,42,67,77
171,0,0,1,1,0,0,0,1,1,0,0,0,1,1,0,0.0,0.0,1,1,0,-1,-1,-1,17,0,20,84,96
172,190,1830,90,100,10,158,182,80,86,6,158,182,86,91,5,0.02042275094455223,0.0424112461281868,84,96,12,1,2,2,9,17,23,6,30
173,74,690,66,100,34,60,60,52,52,0,60,60,62,62,0,0.009870996289866912,0.014295925661186561,70,76,6,2,3,3,5,9,45,27,90
174,70,171,59,86,27,82,82,56,56,0,70,71,60,60,0,0.005956635692161067,0.005956635692161067,56,56,0,6,3,3,7,5,62,47,78
175,625,1241,100,100,0,368,368,100,100,0,368,368,100,100,0,0.053269342047040404,0.05987269818577896,99,100,1,2,2,2,11,36,19,2,31
176,100,100,71,71,0,100,100,79,79,0,100,100,79,79,0,0.030361823070900983,0.03352734946730658,88,90,2,3,1,1,5,4,70,64,35
177,0,0,1,1,0,0,0,1,1,0,0,0,1,1,0,0.0,0.0,1,1,0,-1,-1,-1,4,0,47,36,66
178,118,324,78,96,18,140,140,70,70,0,118,126,78,80,2,0.012559991830899623,0.012696143503863304,73,73,0,3,3,3,10,8,11,8,63
179,285,1926,93,100,7,144,168,76,81,5,144,168,82,84,2,0.03104258143571939,0.04697232717247013,91,97,6,1,3,2,9,29,54,0,35
180,88,88,56,56,0,276,276,79,79,0,88,88,56,56,0,0.008441403723748256,0.008441403723748256,59,59,0,-1,2,2,17,4,20,38,40
181,200,200,88,88,0,198,198,83,83,0,198,198,88,88,0,0.014227849824704722,0.014227849824704722,75,75,0,-1,2,2,10,14,11,14,50
182,48,664,55,100,45,90,100,58,67,9,48,100,55,72,17,0.0045270431260424114,0.014534191088873005,51,80,29,2,2,2,6,6,48,70,8
183,6,6,30,30,0,12,12,30,30,0,6,6,30,30,0,0.00010211375472276115,0.00010211375472276115,29,29,0,-1,4,4,4,1,83,65,92
184,314,314,96,96,0,150,150,90,90,0,150,150,91,91,0,0.03699921712788046,0.03699921712788046,94,94,0,-1,2,2,7,29,62,0,93
185,16,222,38,89,51,33,60,33,38,5,16,36,38,46,8,0.00013615167296368154,0.004765308553728854,31,51,20,3,3,3,9,1,54,95,72
186,88,688,61,100,39,104,104,73,73,0,88,104,68,78,10,0.008543517478471017,0.013036522686272508,63,76,13,2,2,2,5,4,52,72,62
187,140,140,85,85,0,170,170,78,78,0,140,140,85,85,0,0.010279451308757957,0.010279451308757957,68,68,0,-1,2,2,11,13,38,24,86
188,100,100,63,63,0,100,100,45,45,0,100,100,63,63,0,0.02314578440382586,0.023486163586235065,87,88,1,4,1,1,11,4,19,38,88
189,149,765,82,100,18,110,110,74,74,0,110,110,76,76,0,0.018040096667687803,0.025834779944858572,80,87,7,2,2,2,6,12,41,37,27
190,0,0,1,1,0,0,0,1,1,0,0,0,1,1,0,0.0,0.0,1,1,0,-1,-1,-1,3,0,66,40,97
191,100,100,73,73,0,100,100,94,94,0,100,100,94,94,0,0.0851628714387828,0.08975799040130705,100,100,0,3,1,1,4,40,67,3,38
192,0,616,1,100,99,0,20,1,41,40,0,20,1,46,45,0.0,0.010994247591817285,1,71,70,2,-1,3,3,0,60,85,32
193,22,638,47,100,53,34,44,43,48,5,22,44,47,54,7,0.0017018959120460194,0.01058579257292624,44,73,29,2,3,3,4,3,79,51,17
194,48,150,64,89,25,12,12,40,40,0,12,12,42,42,0,0.009020048333843901,0.009939072126348753,70,70,0,4,4,4,2,8,90,8,51
195,110,726,76,100,24,142,152,72,77,5,110,152,76,84,8,0.010517716736444398,0.01960584090677014,71,84,13,2,2,2,8,6,42,77,32
196,116,732,77,100,23,88,88,73,73,0,88,88,74,74,0,0.015112835698968652,0.02382654276864427,78,86,8,2,2,2,4,8,83,20,33
197,270,270,94,94,0,88,88,73,73,0,88,88,74,74,0,0.0315531502093332,0.0315531502093332,89,89,0,-1,2,2,4,27,83,10,69
198,0,1640,1,100,99,0,154,1,73,72,0,154,1,85,84,0.0,0.038939378467612924,1,96,95,1,-1,2,10,0,22,36,3
199,0,206,1,92,91,0,10,1,31,30,0,6,1,31,30,0.0,0.0005105687736138058,1,36,35,3,-1,4,3,0,64,92,42
200,64,64,70,70,0,18,18,47,47,0,18,18,49,49,0,0.005650294427992784,0.005650294427992784,59,59,0,-1,3,3,2,8,99,57,59
201,32,648,45,100,55,92,92,50,50,0,32,50,45,50,5,0.004118588107151367,0.005820484019197386,51,55,4,2,3,3,7,3,46,29,61
202,150,150,85,85,0,148,148,79,79,0,148,148,84,84,0,0.010721944245889922,0.010721944245889922,71,71,0,-1,2,2,9,13,31,24,89
203,62,678,52,100,48,154,164,66,68,2,62,106,52,71,19,0.003778208924742163,0.00966676878042139,51,69,18,2,2,2,10,6,0,70,62
204,0,0,1,1,0,0,0,1,1,0,0,0,1,1,0,0.0,0.0,1,1,0,-1,-1,-1,11,0,38,87,92
205,154,255,88,93,5,152,152,95,95,0,152,152,95,95,0,0.019980258007420267,0.019980258007420267,84,84,0,6,2,2,5,8,88,20,68
206,2,2,28,28,0,3,3,28,28,0,2,2,28,28,0,3.4037918240920386e-05,3.4037918240920386e-05,28,28,0,-1,5,5,2,1,95,65,96
207,0,0,1,1,0,0,0,1,1,0,0,0,1,1,0,0.0,0.0,1,1,0,-1,-1,-1,9,1,23,45,86
208,121,737,76,100,24,148,148,71,71,0,121,148,76,85,9,0.009734844616903231,0.017052997038701112,68,79,11,2,2,2,9,8,28,44,34
209,397,603,100,100,0,136,136,100,100,0,136,136,100,100,0,0.05384798665713605,0.058613295210864905,97,97,0,3,2,2,4,36,73,2,62
210,16,632,33,100,67,42,56,36,41,5,16,56,33,53,20,0.0032336022328874367,0.022533101875489295,45,84,39,2,3,3,6,3,51,46,9
211,0,206,1,93,92,0,12,1,33,32,0,6,1,32,31,0.0,0.0007488342013002485,1,37,36,3,-1,4,4,0,72,36,49
212,0,0,1,1,0,0,0,1,1,0,0,0,1,1,0,0.0,0.0,1,1,0,-1,-1,-1,5,0,88,82,79
213,64,680,58,100,42,70,70,54,54,0,64,70,61,61,0,0.006977773239388679,0.02130773681881616,60,83,23,2,3,3,5,4,50,72,18
214,0,206,1,89,88,0,24,1,30,29,0,6,1,26,25,0.0,0.0015317063208414173,1,38,37,3,-1,4,6,0,40,85,53
215,6,622,28,99,71,38,212,29,71,42,6,212,28,88,60,0.00013615167296368154,0.02236291228428469,30,86,56,2,4,3,17,1,20,95,7
216,0,206,1,94,93,0,18,1,35,34,0,18,1,44,43,0.0,0.00796487286837537,1,66,65,3,-1,4,3,0,66,87,17
217,87,87,59,59,0,146,146,77,77,0,87,87,59,59,0,0.006535280302256714,0.006535280302256714,58,58,0,-1,2,2,8,4,42,22,67
218,0,101,1,82,81,0,2,1,24,23,0,1,1,24,23,0.0,3.4037918240920386e-05,1,25,24,6,-1,7,2,1,91,50,68
219,94,300,61,97,36,196,196,72,72,0,94,108,61,75,14,0.005922597773920147,0.006909697402906838,58,60,2,3,2,2,12,6,14,28,43
220,186,786,91,100,9,104,104,80,80,0,104,104,81,81,0,0.024200959869294394,0.03267640151128357,88,91,3,2,2,2,5,15,63,16,37
221,154,254,91,95,4,48,48,73,73,0,48,48,75,75,0,0.021341774737057083,0.022124646856598252,84,86,2,4,3,3,3,19,92,15,43
222,190,790,89,100,11,166,166,86,86,0,166,166,88,88,0,0.015725518227305217,0.024064808196330712,79,85,6,2,2,2,8,14,57,14,8
223,46,1686,48,100,52,106,150,55,68,13,46,125,48,79,31,0.0009190237925048504,0.0141938119064638,37,73,36,1,2,2,11,2,33,56,28
224,0,616,1,100,99,0,86,1,36,35,0,38,1,45,44,0.0,0.00622893903808843,1,59,58,2,-1,3,14,0,17,76,77
225,0,616,1,100,99,0,56,1,37,36,0,35,1,45,44,0.0,0.004561081044283332,1,54,53,2,-1,3,8,0,42,98,22
226,0,0,1,1,0,0,0,1,1,0,0,0,1,1,0,0.0,0.0,1,1,0,-1,-1,-1,14,1,25,50,96
227,88,88,61,61,0,132,132,72,72,0,88,88,61,61,0,0.007488342013002485,0.007488342013002485,61,61,0,-1,2,2,8,7,27,62,76
228,286,902,94,100,6,272,272,95,95,0,272,272,95,95,0,0.025222097416522007,0.032336022328874364,85,92,7,2,2,2,11,16,5,18,72
229,136,752,83,100,17,104,104,82,82,0,104,104,83,83,0,0.01589570781850982,0.03859899928520372,79,94,15,2,2,2,5,8,50,20,1
230,197,397,88,96,8,208,208,85,85,0,208,208,91,91,0,0.017052997038701112,0.017257224548146634,79,79,0,3,2,2,10,15,18,19,4
231,0,206,1,88,87,0,32,1,33,32,0,29,1,45,44,0.0,0.00439089145307873,1,53,52,3,-1,4,8,0,10,86,57
232,62,678,52,100,48,154,154,63,63,0,62,82,52,56,4,0.0030634126416828346,0.004322815616596889,49,51,2,2,2,2,15,3,7,54,43
233,270,886,94,100,6,88,88,73,73,0,88,88,74,74,0,0.0315531502093332,0.038428809693999116,89,92,3,2,2,2,4,27,83,10,24
234,0,0,1,1,0,0,0,1,1,0,0,0,1,1,0,0.0,0.0,1,1,0,-1,-1,-1,6,0,56,96,67
235,200,302,88,97,9,304,304,87,87,0,200,202,88,88,0,0.01415977398822288,0.0141938119064638,73,73,0,4,2,2,17,8,20,8,78
236,54,260,55,94,39,80,80,68,68,0,54,80,55,71,16,0.008747744987916539,0.01504475986248681,67,77,10,3,3,3,5,4,88,72,34
237,22,638,43,100,57,52,62,39,42,3,22,62,43,58,15,0.0020082371762143027,0.007726607440688927,44,62,18,2,3,3,7,2,43,83,13
238,144,350,89,99,10,72,72,84,84,0,72,72,84,84,0,0.019129310051397258,0.023315973995030465,84,87,3,3,2,2,3,14,85,32,57
239,78,278,69,94,25,60,60,49,49,0,60,60,59,59,0,0.014329963579427483,0.018108172504169646,77,80,3,3,3,3,5,9,88,39,34
240,14,220,45,97,52,12,12,35,35,0,12,12,42,42,0,0.0019061234214915416,0.005548180673270023,45,59,14,3,4,4,2,3,98,54,47
241,0,102,1,76,75,0,13,1,26,25,0,2,1,24,23,0.0,0.00017018959120460194,1,28,27,4,-1,5,10,0,36,67,4
242,0,206,1,87,86,0,23,1,29,28,0,7,1,34,33,0.0,0.0004084550188910446,1,33,32,3,-1,4,10,0,22,91,56
243,100,100,71,71,0,100,100,80,80,0,100,100,81,81,0,0.031621226045815035,0.031621226045815035,90,90,0,5,1,1,5,2,49,61,65
244,0,0,1,1,0,0,0,1,1,0,0,0,1,1,0,0.0,0.0,1,1,0,-1,-1,-1,2,0,93,92,66
245,2,208,29,92,63,8,24,31,36,5,2,24,29,53,24,0.0002382654276864427,0.007352190340038803,32,62,30,3,5,4,4,1,77,55,27
246,186,287,90,96,6,296,296,92,92,0,186,187,90,90,0,0.01776779332176044,0.01776779332176044,78,78,0,5,2,2,14,9,8,39,78
247,0,102,1,86,85,0,4,1,29,28,0,4,1,32,31,0.0,0.004765308553728854,1,53,52,4,-1,5,2,0,97,87,31
248,0,0,1,1,0,0,0,1,1,0,0,0,1,1,0,0.0,0.0,1,1,0,-1,-1,-1,10,0,0,89,76
249,369,575,99,100,1,96,96,89,89,0,96,96,89,89,0,0.0510909152796215,0.05129514278906702,97,97,0,3,2,2,3,36,64,2,63
250,118,324,82,96,14,110,110,81,81,0,110,110,85,85,0,0.01330882603219987,0.016882807447496512,76,82,6,3,2,2,6,9,32,27,47
251,2,208,29,94,65,4,8,31,32,1,2,8,29,37,8,3.4037918240920386e-05,0.0036760951700194017,27,50,23,3,5,4,2,1,90,65,22
252,8,624,39,100,61,12,22,35,51,16,8,22,39,53,14,0.0011913271384322134,0.016304162837400864,39,80,41,2,4,3,2,2,86,74,6
253,142,142,89,89,0,72,72,87,87,0,72,72,87,87,0,0.01960584090677014,0.01960584090677014,86,86,0,-1,2,2,3,16,55,12,99
254,52,668,52,100,48,104,114,58,61,3,52,76,52,56,4,0.002552843868069029,0.005207801490860819,46,55,9,2,2,2,10,3,18,43,54
255,166,782,84,100,16,208,208,85,85,0,166,208,84,90,6,0.013785356887572755,0.021443888491779844,74,84,10,2,2,2,10,9,18,27,20
256,6,6,32,32,0,28,28,36,36,0,6,6,32,32,0,0.00088498587426393,0.00088498587426393,39,39,0,-1,4,4,6,1,69,71,84
257,100,100,59,59,0,100,100,39,39,0,100,100,59,59,0,0.023622315259198747,0.023622315259198747,84,84,0,-1,1,1,14,8,16,20,87
258,58,58,67,67,0,46,46,82,82,0,46,46,82,82,0,0.012151536812008578,0.012151536812008578,72,72,0,-1,2,2,2,4,86,72,36
259,110,110,72,72,0,154,154,66,66,0,110,110,72,72,0,0.010313489226998877,0.010313489226998877,72,72,0,-1,2,2,10,6,0,34,84
260,100,100,70,70,0,100,100,73,73,0,100,100,74,74,0,0.024949794070594642,0.027162258756254467,87,88,1,2,1,1,6,1,71,65,74
261,145,761,81,100,19,188,198,80,82,2,145,198,81,90,9,0.009905034208107831,0.034854828278702475,70,92,22,2,2,2,10,8,0,44,11
262,40,141,54,89,35,62,62,77,77,0,40,41,60,62,2,0.008679669151434699,0.008713707069675619,69,69,0,6,2,2,3,1,75,90,58
263,0,616,1,100,99,0,66,1,46,45,0,66,1,54,53,0.0,0.030566050580346504,1,94,93,2,-1,3,6,0,71,86,2
264,396,1012,96,100,4,358,368,97,97,0,358,368,97,97,0,0.023520201504475986,0.045508696688110556,86,98,12,2,2,2,14,19,25,15,0
265,292,498,95,98,3,272,272,94,94,0,272,272,94,94,0,0.02743456210218183,0.039449947241226725,89,94,5,3,2,2,11,20,33,23,18
266,86,86,64,64,0,86,86,56,56,0,86,86,66,66,0,0.006297014874570271,0.006297014874570271,59,59,0,-1,3,3,6,6,59,13,91
267,134,750,80,100,20,208,208,89,89,0,134,208,80,92,12,0.010177337554035196,0.033765614894993023,70,91,21,2,2,2,10,7,12,21,11
268,40,40,47,47,0,104,104,57,57,0,40,40,47,47,0,0.003778208924742163,0.003778208924742163,51,51,0,-1,2,2,10,2,0,94,86
269,1,1,26,26,0,3,3,26,26,0,1,1,26,26,0,0.0,0.0,1,1,0,-1,6,6,3,2,64,58,96
270,14,14,46,46,0,12,12,39,39,0,12,12,45,45,0,0.004322815616596889,0.004322815616596889,54,54,0,-1,4,4,2,6,93,73,80
271,223,839,99,100,1,56,56,93,93,0,56,56,93,93,0,0.03808843051158991,0.050954763606657814,97,97,0,2,2,2,2,30,99,7,39
272,0,616,1,100,99,0,30,1,45,44,0,30,1,54,53,0.0,0.008271214132543654,1,65,64,2,-1,3,4,0,78,86,8
273,40,656,53,100,47,72,72,77,77,0,40,72,67,78,11,0.00970080669866231,0.021443888491779844,71,88,17,2,2,2,3,1,96,90,19
274,292,498,95,98,3,272,272,94,94,0,272,272,94,94,0,0.02743456210218183,0.027808979202831954,89,90,1,3,2,2,11,20,33,23,63
275,135,341,78,97,19,228,228,77,77,0,135,162,78,81,3,0.008271214132543654,0.01242384015793594,61,69,8,3,2,2,15,8,7,57,35
276,22,228,40,94,54,40,44,36,37,1,22,34,40,46,6,0.0005786446100956465,0.0024507301133462676,34,44,10,3,3,3,7,2,46,63,52
277,168,368,92,99,7,56,56,76,76,0,56,56,77,77,0,0.028013206712277475,0.03693114129139862,91,96,5,3,2,2,2,20,68,23,39
278,236,236,93,93,0,288,288,88,88,0,236,236,93,93,0,0.02198849518363457,0.02198849518363457,85,85,0,-1,2,2,15,18,7,30,76
279,112,318,81,97,16,110,110,77,77,0,110,110,81,81,0,0.014534191088873005,0.016133973246196264,76,79,3,3,2,2,6,8,74,17,94
280,51,667,53,100,47,50,50,46,46,0,50,50,53,53,0,0.004322815616596889,0.010960209673576363,51,73,22,2,3,3,5,6,50,35,34
281,0,206,1,93,92,0,26,1,35,34,0,26,1,49,48,0.0,0.0037441710065012424,1,50,49,3,-1,4,5,1,49,69,13
282,84,186,59,89,30,206,206,81,81,0,84,86,59,59,0,0.009836958371625992,0.009973110044589673,71,71,0,4,2,2,12,5,3,25,65
283,54,54,57,57,0,76,76,57,57,0,54,54,57,57,0,0.007692569522448007,0.007692569522448007,64,64,0,-1,3,3,6,4,74,38,40
284,0,616,1,100,99,0,28,1,43,42,0,28,1,53,52,0.0,0.022396950202525613,1,88,87,2,-1,3,3,0,76,84,0
285,16,632,37,100,63,46,66,41,47,6,16,66,37,57,20,0.0014636304843595766,0.016984921202219273,41,82,41,2,3,3,6,1,59,71,23
286,70,172,67,91,24,48,48,62,62,0,48,48,64,64,0,0.006399128629293032,0.006467204465774873,59,59,0,4,3,3,3,5,64,47,60
287,22,228,45,91,46,98,98,53,53,0,22,40,45,53,8,0.004356853534837809,0.007454304094761564,54,62,8,3,3,3,8,3,57,29,35
288,16,222,39,95,56,42,46,41,44,3,16,36,39,51,12,0.0007488342013002485,0.005071649817897137,37,54,17,3,3,3,6,1,32,88,38
289,16,117,48,85,37,22,22,52,52,0,16,17,51,53,2,0.0033016780693692774,0.0033357159876101976,52,52,0,5,3,3,2,3,98,46,65
290,32,648,45,100,55,74,74,41,41,0,32,78,45,61,16,0.002757071377514551,0.008407365805507334,48,67,19,2,3,3,9,2,54,83,21
291,180,282,86,94,8,102,102,64,64,0,102,102,72,72,0,0.019367575479083698,0.01940161339732462,84,84,0,4,3,3,7,17,24,6,60
292,0,102,1,77,76,0,6,1,24,23,0,2,1,24,23,0.0,0.00010211375472276115,1,29,28,4,-1,5,5,0,50,80,55
293,6,6,29,29,0,27,27,30,30,0,6,6,29,29,0,0.0002382654276864427,0.0002382654276864427,31,31,0,-1,4,4,12,1,14,65,81
294,56,262,51,93,42,156,156,72,72,0,56,64,51,55,4,0.0030293747234419145,0.0034718676605738795,48,51,3,3,2,2,12,2,3,52,63
295,0,0,1,1,0,0,0,1,1,0,0,0,1,1,0,0.0,0.0,1,1,0,-1,-1,-1,8,1,39,69,99
296,82,184,76,93,17,32,32,69,69,0,32,32,69,69,0,0.013717281051090916,0.013921508560536438,73,73,0,4,3,3,2,8,93,17,4
297,16,632,42,100,58,28,38,45,55,10,16,38,42,58,16,0.003267640151128357,0.01841451376833793,50,83,33,2,3,3,3,3,58,46,15
298,529,529,100,100,0,392,392,99,99,0,392,392,99,99,0,0.03478675244222063,0.03478675244222063,93,93,0,-1,2,2,14,29,16,11,76
299,161,367,93,100,7,80,80,96,96,0,80,80,96,96,0,0.03271043942952449,0.03802035467510807,93,95,2,3,2,2,2,15,98,16,62
300,40,40,52,52,0,60,60,52,52,0,40,40,52,52,0,0.006671431975220395,0.006671431975220395,58,58,0,-1,2,2,5,1,45,90,82
301,40,142,51,82,31,102,102,66,66,0,40,42,51,53,2,0.0024166921951053475,0.002586881786309949,47,47,0,4,2,2,8,1,10,53,55
302,76,282,56,95,39,142,142,62,62,0,76,92,56,63,7,0.005888559855679227,0.010449640899962559,56,70,14,3,2,2,13,6,13,35,26
303,16,632,40,100,60,94,114,51,72,21,16,114,40,79,39,0.0020422750944552232,0.036658837945471257,43,95,52,2,3,3,9,1,26,53,2
304,6,212,33,96,63,14,18,33,35,2,6,18,33,44,11,0.0006467204465774873,0.004493005207801491,36,53,17,3,4,4,3,2,75,42,13
305,176,278,93,100,7,56,56,85,85,0,56,56,85,85,0,0.03094046768099663,0.03141699853636951,92,92,0,4,2,2,2,17,90,6,63
306,0,0,1,1,0,0,0,1,1,0,0,0,1,1,0,0.0,0.0,1,1,0,-1,-1,-1,10,0,11,59,81
307,6,622,29,100,71,29,70,31,40,9,6,46,29,51,22,0.0002042275094455223,0.009428503352734947,31,67,36,2,4,3,9,1,23,65,34
308,0,0,1,1,0,0,0,1,1,0,0,0,1,1,0,0.0,0.0,1,1,0,-1,-1,-1,5,0,88,96,81
309,100,100,58,58,0,100,100,35,35,0,100,100,59,59,0,0.013751318969331836,0.01501072194424589,71,75,4,2,1,1,17,6,20,35,64
310,0,206,1,90,89,0,13,1,27,26,0,11,1,33,32,0.0,0.002723033459273631,1,47,46,3,-1,4,5,0,50,93,73
311,0,0,1,1,0,0,0,1,1,0,0,0,1,1,0,0.0,0.0,1,1,0,-1,-1,-1,15,0,7,87,36
312,0,0,1,1,0,0,0,1,1,0,0,0,1,1,0,0.0,0.0,1,1,0,-1,-1,-1,4,0,84,76,45
313,0,206,1,92,91,0,20,1,31,30,0,6,1,28,27,0.0,0.0019061234214915416,1,45,44,3,-1,4,6,0,59,66,94
314,0,1640,1,100,99,0,100,1,65,64,0,100,1,71,70,0.0,0.03829265802103543,1,91,90,1,-1,2,6,0,44,66,11
315,189,1789,92,100,8,120,120,90,90,0,120,120,90,90,0,0.02392865652336703,0.03975628850539501,85,96,11,1,2,2,6,16,69,18,41
316,16,1656,40,100,60,50,84,47,76,29,16,84,40,77,37,0.002144388849177984,0.03563770039824364,46,95,49,1,3,2,5,2,88,94,5
317,0,206,1,93,92,0,10,1,31,30,0,10,1,36,35,0.0,0.0068075836481840775,1,59,58,3,-1,4,3,0,55,36,8
318,6,6,28,28,0,20,20,28,28,0,6,6,28,28,0,6.807583648184077e-05,6.807583648184077e-05,27,27,0,-1,4,4,9,1,29,95,93
319,246,452,95,98,3,144,144,92,92,0,144,144,92,92,0,0.024064808196330712,0.029817216379046257,87,89,2,3,2,2,6,19,48,15,34
320,174,174,89,89,0,174,174,92,92,0,174,174,93,93,0,0.014670342761836687,0.014670342761836687,77,77,0,-1,2,2,7,7,43,48,99
321,2,618,26,100,74,10,54,27,37,10,2,54,26,51,25,3.4037918240920386e-05,0.010994247591817285,26,73,47,2,5,3,8,2,30,58,39
322,108,724,78,100,22,182,182,87,87,0,108,182,78,91,13,0.011130399264780965,0.019776030497974745,70,84,14,2,2,2,9,5,23,25,77
323,62,62,56,56,0,100,100,66,66,0,62,62,56,56,0,0.004220701861874128,0.004220701861874128,50,50,0,-1,2,2,6,3,51,43,84
324,189,291,96,100,4,32,32,69,69,0,32,32,69,69,0,0.03240409816535621,0.03315293236665646,93,93,0,4,3,3,2,29,93,11,49
325,91,297,76,99,23,22,22,48,48,0,22,22,51,51,0,0.016236087000919025,0.021954457265393648,80,85,5,3,3,3,2,12,95,37,25
326,70,276,60,96,36,86,86,56,56,0,70,86,59,65,6,0.005820484019197386,0.006943735321147759,56,62,6,3,3,3,6,6,59,26,74
327,16,632,37,100,63,34,52,35,47,12,16,52,37,54,17,0.0005786446100956465,0.00891793457912114,35,67,32,2,3,3,6,1,65,4,24
328,100,100,69,69,0,100,100,55,55,0,100,100,69,69,0,0.02375846693216243,0.02491575615235372,85,87,2,3,1,1,9,5,26,47,54
329,6,622,32,100,68,26,40,36,42,6,6,40,32,51,19,0.0002382654276864427,0.014602266925354846,32,77,45,2,4,3,5,1,45,49,30
330,6,6,27,27,0,36,36,34,34,0,6,6,27,27,0,0.00017018959120460194,0.00017018959120460194,30,30,0,-1,4,4,6,1,40,49,86
331,6,6,32,32,0,10,10,32,32,0,6,6,32,32,0,0.00017018959120460194,0.00017018959120460194,31,31,0,-1,4,4,3,1,76,4,93
332,0,616,1,100,99,0,34,1,46,45,0,34,1,54,53,0.0,0.008986010415602982,1,66,65,2,-1,3,4,0,77,82,25
333,0,616,1,100,99,0,40,1,39,38,0,30,1,47,46,0.0,0.005888559855679227,1,55,54,2,-1,3,5,0,52,59,38
334,583,1199,100,100,0,432,432,100,100,0,432,432,100,100,0,0.03897341638585384,0.04680213758126553,96,98,2,2,2,2,15,29,7,1,44
335,6,622,28,100,72,42,74,33,41,8,6,74,28,57,29,0.0002382654276864427,0.014329963579427483,30,76,46,2,4,3,9,1,29,88,5
336,1,617,25,100,75,6,30,25,39,14,1,30,25,47,22,3.4037918240920386e-05,0.007182000748834201,28,59,31,2,6,3,6,1,69,78,44
337,72,174,61,89,28,60,60,51,51,0,60,60,57,57,0,0.008611593314952858,0.010211375472276116,67,69,2,4,3,3,5,7,37,48,75
338,0,0,1,1,0,0,0,1,1,0,0,0,1,1,0,0.0,0.0,1,1,0,-1,-1,-1,6,0,40,96,87
339,68,68,56,56,0,158,158,68,68,0,68,68,56,56,0,0.006024711528642908,0.006024711528642908,56,56,0,-1,2,2,14,6,17,73,91
340,130,130,85,85,0,72,72,85,85,0,72,72,85,85,0,0.021035433472888797,0.021035433472888797,84,84,0,-1,2,2,3,12,94,37,81
341,0,0,1,1,0,0,0,1,1,0,0,0,1,1,0,0.0,0.0,1,1,0,-1,-1,-1,9,0,35,36,93
342,24,640,49,100,51,56,76,45,53,8,24,76,49,60,11,0.002314578440382586,0.014329963579427483,46,78,32,2,3,3,6,3,44,54,19
343,138,344,84,96,12,158,158,82,82,0,138,158,84,86,2,0.0158616699002689,0.021239660982334322,77,83,6,3,2,2,9,9,35,39,24
344,0,206,1,96,95,0,12,1,34,33,0,12,1,42,41,0.0,0.00439089145307873,1,57,56,3,-1,4,2,0,86,99,26
345,126,126,80,80,0,238,238,90,90,0,126,126,80,80,0,0.010619830491167161,0.010619830491167161,67,67,0,-1,2,2,11,4,19,72,93
346,0,0,1,1,0,0,0,1,1,0,0,0,1,1,0,0.0,0.0,1,1,0,-1,-1,-1,2,0,98,81,84
347,0,0,1,1,0,0,0,1,1,0,0,0,1,1,0,0.0,0.0,1,1,0,-1,-1,-1,6,0,71,76,98
348,288,1928,95,100,5,248,272,89,94,5,248,272,92,94,2,0.027536675856904592,0.04350045951189625,89,95,6,1,2,2,11,15,5,16,17
349,6,622,29,100,71,29,132,31,62,31,6,132,29,81,52,0.0002042275094455223,0.023486163586235065,31,85,54,2,4,3,12,1,3,65,0
350,377,377,100,100,0,192,192,99,99,0,192,192,99,99,0,0.04666598590830185,0.04666598590830185,98,98,0,-1,2,2,6,29,69,11,81
351,222,222,88,88,0,332,332,92,92,0,222,222,88,88,0,0.017903944994724124,0.017903944994724124,83,83,0,-1,2,2,16,12,9,37,87
352,100,100,70,70,0,100,100,73,73,0,100,100,74,74,0,0.025766704108376733,0.025766704108376733,88,88,0,-1,1,1,6,3,71,43,79
353,18,634,41,100,59,66,104,37,57,20,18,108,41,74,33,0.00034037918240920387,0.008169100377820893,32,63,31,2,3,3,12,2,2,56,24
354,158,260,86,95,9,94,94,71,71,0,94,94,72,72,0,0.014261887742945642,0.014840532353041287,77,78,1,4,2,2,5,14,63,32,42
355,96,712,80,100,20,32,32,71,71,0,32,32,71,71,0,0.018040096667687803,0.033255046121379216,80,95,15,2,3,3,2,18,99,30,16
356,0,206,1,92,91,0,24,1,36,35,0,24,1,53,52,0.0,0.0195377650702883,1,85,84,3,-1,4,4,0,77,98,1
357,100,100,72,72,0,100,100,79,79,0,100,100,80,80,0,0.06034922904115184,0.06034922904115184,99,99,0,-1,1,1,5,27,37,10,86
358,16,222,41,94,53,24,24,43,43,0,16,24,42,50,8,0.002110350930937064,0.0034037918240920387,45,49,4,3,3,3,3,2,55,42,43
359,0,206,1,89,88,0,40,1,31,30,0,8,1,32,31,0.0,0.0014295925661186562,1,40,39,3,-1,4,12,0,14,59,52
360,454,1054,100,100,0,144,144,89,89,0,144,144,90,90,0,0.04496408999625583,0.05466489669491814,97,98,1,2,2,2,6,40,40,3,19
361,112,318,76,96,20,198,198,83,83,0,112,121,76,78,2,0.00881582082439838,0.00970080669866231,64,65,1,3,2,2,10,7,11,62,64
362,82,288,69,95,26,48,48,54,54,0,48,48,56,56,0,0.012764219340345145,0.013479015623404473,74,76,2,3,3,3,3,8,87,20,42
363,126,742,82,100,18,180,190,80,85,5,126,180,82,86,4,0.013444977705163553,0.021035433472888797,74,83,9,2,2,2,11,8,38,17,62
364,58,58,69,69,0,22,22,49,49,0,22,22,53,53,0,0.008373327887266415,0.008373327887266415,68,68,0,-1,3,3,2,13,90,24,99
365,0,616,1,100,99,0,46,1,39,38,0,46,1,56,55,0.0,0.00888389666088022,1,65,64,2,-1,3,6,0,44,84,17
366,240,446,93,99,6,190,190,92,92,0,190,190,93,93,0,0.02100139555464788,0.021954457265393648,83,83,0,3,2,2,8,18,57,5,53
367,99,299,75,97,22,52,52,74,74,0,52,52,76,76,0,0.012662105585622384,0.016916845365737433,73,81,8,3,2,2,3,13,58,24,21
368,2,208,28,93,65,4,8,30,31,1,2,8,28,35,7,0.0002723033459273631,0.0013955546478777359,31,40,9,3,5,4,2,1,68,55,74
369,16,222,41,93,52,28,28,42,42,0,16,28,41,50,9,0.002212464685659825,0.021035433472888797,47,85,38,3,3,3,3,2,64,94,7
370,18,120,43,80,37,46,46,45,45,0,18,18,43,43,0,0.0008509479560230097,0.0009190237925048504,38,38,0,4,3,3,5,2,80,56,95
371,110,212,83,92,9,72,72,80,80,0,72,72,80,80,0,0.012117498893767658,0.012491915994417782,75,75,0,4,2,2,3,13,76,24,49
372,62,62,56,56,0,76,76,54,54,0,62,62,58,58,0,0.007147962830593281,0.007147962830593281,59,59,0,-1,3,3,6,6,56,35,69
373,47,148,56,85,29,66,66,54,54,0,47,66,56,61,5,0.005820484019197386,0.005956635692161067,54,54,0,5,3,3,6,6,69,35,55
374,100,100,59,59,0,100,100,45,45,0,100,100,59,59,0,0.047789237210252224,0.047789237210252224,96,96,0,-1,1,1,10,22,0,9,89
375,16,16,31,31,0,74,74,35,35,0,16,16,31,31,0,0.00037441710065012424,0.00037441710065012424,35,35,0,-1,3,3,14,1,25,49,93
376,100,100,78,78,0,100,100,97,97,0,100,100,97,97,0,0.05163552197147622,0.06589740971442187,98,98,0,2,1,1,3,3,96,46,19
377,0,616,1,100,99,0,70,1,35,34,0,36,1,44,43,0.0,0.003778208924742163,1,50,49,2,-1,3,14,0,17,91,28
378,16,16,40,40,0,70,70,43,43,0,16,16,40,40,0,0.003608019333537561,0.003608019333537561,48,48,0,-1,3,3,9,1,26,90,76
379,284,490,96,100,4,256,256,96,96,0,256,256,96,96,0,0.021818305592429966,0.02236291228428469,86,86,0,3,2,2,10,18,0,30,63
380,0,616,1,100,99,0,18,1,50,49,0,18,1,53,52,0.0,0.008305252050784574,1,64,63,2,-1,3,2,0,86,93,57
381,204,306,92,97,5,120,120,86,86,0,120,120,86,86,0,0.02021852343510671,0.020729092208720514,85,85,0,4,2,2,6,16,65,12,49
382,40,142,50,80,30,150,150,65,65,0,40,44,50,51,1,0.0026549576227917903,0.002825147213996392,48,49,1,4,2,2,11,1,5,53,63
383,90,190,62,88,26,90,90,49,49,0,90,90,62,62,0,0.007182000748834201,0.007454304094761564,59,60,1,4,3,3,9,9,35,31,56
384,6,1646,29,100,71,32,134,33,68,35,6,134,29,80,51,0.0002382654276864427,0.026821879573845263,32,88,56,1,4,2,10,1,11,4,23
385,128,334,87,99,12,72,72,80,80,0,72,72,80,80,0,0.018788930868988054,0.025868817863099493,84,88,4,3,2,2,3,13,76,33,32
386,0,206,1,89,88,0,44,1,34,33,0,48,1,50,49,0.0,0.007113924912352361,1,61,60,3,-1,4,8,1,42,50,8
387,518,1134,99,100,1,424,424,98,98,0,424,424,98,98,0,0.035569624561761805,0.041219918989754585,94,95,1,2,2,2,16,27,4,10,44
388,136,342,84,98,14,144,144,90,90,0,144,144,90,90,0,0.01579359406378706,0.021341774737057083,80,85,5,3,2,2,6,8,59,17,21
389,84,700,64,100,36,100,100,68,68,0,84,100,63,72,9,0.006535280302256714,0.01147077844719017,59,74,15,2,2,2,6,5,48,47,57
390,6,622,29,100,71,27,66,32,36,4,6,42,29,54,25,0.0004765308553728854,0.005548180673270023,35,58,23,2,4,3,10,1,11,55,26
391,190,790,91,100,9,88,88,71,71,0,88,88,71,71,0,0.021035433472888797,0.03179141563701964,86,94,8,2,2,2,4,17,53,6,37
392,94,710,70,100,30,68,68,72,72,0,68,68,74,74,0,0.012730181422104225,0.017937982912965042,71,82,11,2,2,2,4,9,67,31,83
393,0,0,1,1,0,0,0,1,1,0,0,0,1,1,0,0.0,0.0,1,1,0,-1,-1,-1,2,0,93,67,40
394,1,103,26,82,56,2,4,26,30,4,1,4,26,31,5,0.0,0.0019741992579733825,1,43,42,4,6,5,2,1,95,78,75
395,0,206,1,94,93,0,14,1,31,30,0,14,1,40,39,0.0,0.00707988699411144,1,59,58,3,-1,4,3,0,96,86,27
396,0,1640,1,100,99,0,118,1,60,59,0,92,1,63,62,0.0,0.016610504101569147,1,78,77,1,-1,2,13,0,13,97,33
397,100,100,80,80,0,100,100,98,98,0,100,100,98,98,0,0.08655842608666053,0.08655842608666053,99,99,0,-1,1,1,2,14,90,32,86
398,100,100,60,60,0,100,100,50,50,0,100,100,60,60,0,0.027877055039313797,0.05466489669491814,89,98,9,2,1,1,9,7,28,48,3
399,52,258,58,97,39,48,48,67,67,0,48,48,70,70,0,0.008986010415602982,0.010109261717553355,66,72,6,3,3,3,3,5,96,25,43
400,100,100,61,61,0,100,100,43,43,0,100,100,61,61,0,0.023520201504475986,0.025222097416522007,84,87,3,3,1,1,12,5,2,25,54
401,132,132,80,80,0,100,100,66,66,0,100,100,72,72,0,0.01415977398822288,0.01415977398822288,77,77,0,-1,2,2,6,8,59,8,36
402,100,100,59,59,0,100,100,45,45,0,100,100,59,59,0,0.01841451376833793,0.022430988120766535,81,86,5,2,1,1,10,3,0,46,41
403,36,36,48,48,0,50,50,45,45,0,36,36,48,48,0,0.004118588107151367,0.004118588107151367,52,52,0,-1,3,3,5,6,52,73,84
404,0,206,1,95,94,0,8,1,32,31,0,8,1,37,36,0.0,0.003880322679464924,1,52,51,3,-1,4,2,0,89,67,13
405,6,6,29,29,0,30,30,29,29,0,6,6,29,29,0,0.0002382654276864427,0.0002382654276864427,32,32,0,-1,4,4,15,1,7,55,45
406,16,1656,37,100,63,30,80,35,53,18,16,80,37,62,25,0.0006467204465774873,0.032063718982947,36,90,54,1,3,2,6,1,48,88,23
407,0,206,1,92,91,0,12,1,33,32,0,6,1,33,32,0.0,0.0005786446100956465,1,36,35,3,-1,4,4,0,77,82,49
408,39,245,51,97,46,38,38,46,46,0,38,38,51,51,0,0.005377991082065421,0.02324789815854862,54,89,35,3,3,3,3,6,96,73,1
409,0,1640,1,100,99,0,88,1,46,45,0,88,1,66,65,0.0,0.022737329384934817,1,85,84,1,-1,2,8,0,39,81,32
410,34,34,51,51,0,50,50,46,46,0,34,34,51,51,0,0.00176997174852786,0.00176997174852786,42,42,0,-1,3,3,5,4,80,64,40
411,2,2,27,27,0,9,9,27,27,0,2,2,27,27,0,3.4037918240920386e-05,3.4037918240920386e-05,26,26,0,-1,5,5,8,1,21,68,40
412,0,1640,1,100,99,0,118,1,74,73,0,118,1,79,78,0.0,0.03866707512168556,1,96,95,1,-1,2,9,0,26,97,3
413,16,632,34,100,66,40,94,33,43,10,16,58,34,51,17,0.0004084550188910446,0.005105687736138058,35,55,20,2,3,3,12,1,3,4,26
414,12,12,35,35,0,18,18,36,36,0,12,12,35,35,0,0.002212464685659825,0.002212464685659825,46,46,0,-1,4,4,3,2,82,75,91
415,0,616,1,100,99,0,158,1,65,64,0,158,1,86,85,0.0,0.02481364239763096,1,85,84,2,-1,3,13,0,13,79,0
416,0,616,1,100,99,0,118,1,58,57,0,73,1,55,54,0.0,0.010960209673576363,1,63,62,2,-1,3,16,0,9,40,39
417,1,617,25,100,75,3,24,25,44,19,1,24,25,50,25,0.0,0.009020048333843901,1,66,65,2,6,3,3,2,85,58,72
418,101,101,77,77,0,94,94,75,75,0,94,94,75,75,0,0.010313489226998877,0.010313489226998877,68,68,0,-1,2,2,5,8,49,44,45
419,6,622,29,100,71,28,66,31,36,5,6,40,29,49,20,0.00013615167296368154,0.005820484019197386,28,56,28,2,4,3,10,1,22,60,38
420,0,1640,1,100,99,0,52,1,80,79,0,52,1,81,80,0.0,0.05408625208482249,1,96,95,1,-1,2,3,0,81,89,10
421,230,330,91,98,7,196,196,72,72,0,196,196,88,88,0,0.017427414139351238,0.017427414139351238,80,80,0,4,2,2,12,16,14,12,4
422,0,616,1,100,99,0,46,1,39,38,0,46,1,56,55,0.0,0.014295925661186561,1,79,78,2,-1,3,6,0,44,96,15
423,101,717,73,100,27,104,104,81,81,0,104,104,84,84,0,0.00796487286837537,0.03318697028489737,63,89,26,2,2,2,5,8,61,57,0
424,0,206,1,86,85,0,28,1,30,29,0,6,1,27,26,0.0,0.0016678579938050988,1,39,38,3,-1,4,8,0,27,81,46
425,138,754,82,100,18,236,246,81,83,2,138,246,82,90,8,0.007658531604207087,0.019707954661492902,62,78,16,2,2,2,14,6,25,28,14
426,16,16,37,37,0,60,60,48,48,0,16,16,37,37,0,0.0030634126416828346,0.0030634126416828346,51,51,0,-1,3,3,5,2,63,94,80
427,76,282,68,97,29,32,32,58,58,0,32,32,59,59,0,0.010075223799312433,0.013138636440995268,68,75,7,3,3,3,2,6,68,77,29
428,0,616,1,100,99,0,74,1,43,42,0,74,1,56,55,0.0,0.016508390346846386,1,77,76,2,-1,3,8,1,27,69,16
429,88,294,60,94,34,152,152,78,78,0,88,94,60,61,1,0.009054086252084823,0.010824058000612683,67,72,5,3,2,2,8,4,42,38,94
430,136,336,86,97,11,70,70,62,62,0,70,70,69,69,0,0.01589570781850982,0.018244324177133328,78,83,5,3,3,3,5,16,45,12,35
431,108,108,85,85,0,56,56,93,93,0,56,56,93,93,0,0.021954457265393648,0.021954457265393648,88,88,0,-1,2,2,2,9,99,39,93
432,111,1751,76,100,24,164,198,74,84,10,111,198,76,87,11,0.008203138296061813,0.045849075870519757,64,96,32,1,2,2,10,8,22,44,2
433,0,616,1,99,98,0,76,1,40,39,0,76,1,57,56,0.0,0.014636304843595765,1,77,76,2,-1,3,11,0,19,66,18
434,22,638,47,100,53,28,28,42,42,0,22,28,47,50,3,0.0017359338302869397,0.010858095918853602,44,72,28,2,3,3,3,2,64,61,27
435,184,390,95,100,5,96,96,94,94,0,96,96,94,94,0,0.028932230504782327,0.03185949147350148,92,94,2,3,2,2,3,16,94,18,28
436,160,760,89,100,11,72,72,83,83,0,72,72,83,83,0,0.023315973995030465,0.05320126621055856,86,96,10,2,2,2,3,18,58,30,2
437,42,42,54,54,0,126,126,63,63,0,40,40,49,49,0,0.003948398515946765,0.003948398515946765,52,52,0,-1,3,3,11,6,38,41,93
438,208,208,92,92,0,222,222,92,92,0,208,208,92,92,0,0.02032063718982947,0.02032063718982947,85,85,0,-1,2,2,10,12,0,37,86
439,62,62,59,59,0,22,22,42,42,0,22,22,46,46,0,0.00881582082439838,0.00881582082439838,64,64,0,-1,3,3,2,6,68,34,98
440,0,0,1,1,0,0,0,1,1,0,0,0,1,1,0,0.0,0.0,1,1,0,-1,-1,-1,10,0,0,87,81
441,23,229,53,92,39,38,38,49,49,0,23,38,53,53,0,0.002314578440382586,0.008373327887266415,49,63,14,3,3,3,3,4,87,64,31
442,28,28,44,44,0,88,88,47,47,0,28,28,44,44,0,0.0023486163586235067,0.0023486163586235067,46,46,0,-1,3,3,8,3,10,54,86
443,48,48,51,51,0,122,122,62,62,0,48,48,51,51,0,0.0030634126416828346,0.0030634126416828346,50,50,0,-1,3,3,12,6,2,70,96
444,150,150,83,83,0,140,140,88,88,0,150,150,91,91,0,0.017257224548146634,0.017257224548146634,79,79,0,-1,2,2,7,8,62,20,92
445,144,760,82,100,18,170,170,73,73,0,144,170,82,86,4,0.008747744987916539,0.01674665577453283,67,78,11,2,2,2,11,13,33,24,27
446,78,180,72,93,21,72,72,77,77,0,72,72,79,79,0,0.009632730862180468,0.009973110044589673,69,72,3,4,2,2,3,4,96,72,63
447,420,1036,100,100,0,280,280,100,100,0,280,280,100,100,0,0.036624800027230335,0.041049729398549985,93,94,1,2,2,2,10,27,36,10,57
448,0,206,1,94,93,0,18,1,35,34,0,18,1,44,43,0.0,0.007828721195411689,1,65,64,3,-1,4,3,0,66,96,17
449,16,117,44,82,38,38,38,49,49,0,16,17,43,46,3,0.0030974505599237552,0.0030974505599237552,51,51,0,6,3,3,3,3,87,46,68
450,0,0,1,1,0,0,0,1,1,0,0,0,1,1,0,0.0,0.0,1,1,0,-1,-1,-1,9,0,23,67,81
451,22,228,40,92,52,74,74,36,36,0,22,30,40,45,5,0.0013955546478777359,0.0024507301133462676,40,45,5,3,3,3,12,2,3,74,51
452,100,100,80,80,0,100,100,98,98,0,100,100,98,98,0,0.08655842608666053,0.08662650192314238,99,99,0,6,1,1,2,14,90,32,78
453,0,206,1,93,92,0,10,1,30,29,0,10,1,40,39,0.0,0.004595118962524252,1,51,50,3,-1,4,3,0,92,87,34
454,2,2,27,27,0,3,3,27,27,0,2,2,27,27,0,0.0,0.0,1,1,0,-1,5,5,2,1,98,95,86
455,397,1013,97,100,3,184,184,94,94,0,184,184,94,94,0,0.035603662480002726,0.050818611933694136,92,97,5,2,2,2,7,30,43,7,16
456,492,698,99,100,1,168,168,95,95,0,168,168,95,95,0,0.046359644644133564,0.04717655468191565,96,96,0,3,2,2,6,36,41,2,64
457,62,62,55,55,0,90,90,65,65,0,62,62,55,55,0,0.005582218591510943,0.005582218591510943,55,55,0,-1,2,2,6,4,59,64,85
458,100,100,69,69,0,100,100,71,71,0,100,100,72,72,0,0.05813676435549202,0.05936212941216515,98,98,0,3,1,1,6,27,56,10,61
459,1,207,26,96,70,3,18,26,35,9,1,18,26,44,18,3.4037918240920386e-05,0.004595118962524252,27,52,25,3,6,4,3,2,75,58,25
460,76,178,73,93,20,56,56,84,84,0,56,56,85,85,0,0.016236087000919025,0.018040096667687803,81,83,2,4,2,2,2,5,98,25,70
461,100,100,62,62,0,100,100,45,45,0,100,100,62,62,0,0.047448858027843016,0.04915075393988903,98,99,1,2,1,1,12,30,3,7,64
462,0,206,1,92,91,0,40,1,33,32,0,13,1,33,32,0.0,0.0010892133837094523,1,38,37,3,-1,4,12,0,6,99,64
463,74,690,72,100,28,32,32,69,69,0,32,32,69,69,0,0.01147077844719017,0.0392457197317812,71,96,25,2,3,3,2,9,93,27,3
464,0,0,1,1,0,0,0,1,1,0,0,0,1,1,0,0.0,0.0,1,1,0,-1,-1,-1,5,0,70,96,45
465,76,282,63,95,32,70,70,63,63,0,70,70,66,66,0,0.00796487286837537,0.01153885428367201,63,69,6,3,3,3,5,7,49,21,29
466,0,0,1,1,0,0,0,1,1,0,0,0,1,1,0,0.0,0.0,1,1,0,-1,-1,-1,6,0,44,59,79
467,0,206,1,87,86,0,49,1,32,31,0,14,1,32,31,0.0,0.0007488342013002485,1,35,34,3,-1,4,15,0,7,36,64
468,101,101,81,81,0,54,54,55,55,0,54,54,60,60,0,0.016202049082678104,0.016202049082678104,79,79,0,-1,3,3,4,12,73,37,76
469,2,618,29,100,71,8,34,30,45,15,2,34,29,51,22,6.807583648184077e-05,0.020014295925661188,27,84,57,2,5,3,4,1,73,95,7
470,0,101,1,81,80,0,4,1,25,24,0,1,1,25,24,0.0,6.807583648184077e-05,1,28,27,5,-1,6,4,1,77,45,60
471,0,206,1,92,91,0,15,1,29,28,0,6,1,29,28,0.0,0.0008169100377820892,1,36,35,3,-1,4,6,0,65,82,71
472,235,435,94,100,6,56,56,76,76,0,56,56,77,77,0,0.033969842404438545,0.0425814357193914,93,96,3,3,2,2,2,29,68,0,6
473,32,648,55,100,45,22,22,47,47,0,22,22,52,52,0,0.0046972327172470135,0.024269035705776234,55,88,33,2,3,3,2,6,89,35,23
474,190,806,90,100,10,206,216,92,93,1,190,216,91,93,2,0.016372238673882704,0.041049729398549985,77,96,19,2,2,2,9,8,31,8,7
475,104,206,80,93,13,50,50,45,45,0,50,50,56,56,0,0.010960209673576363,0.011606930120153852,74,75,1,4,3,3,5,14,45,32,42
476,79,285,66,95,29,78,78,73,73,0,78,78,73,73,0,0.007794683277170768,0.010449640899962559,64,74,10,3,2,2,4,6,79,28,90
477,88,704,78,100,22,32,32,63,63,0,32,32,65,65,0,0.01232172640321318,0.02032063718982947,76,84,8,2,3,3,2,9,98,27,72
478,270,470,100,100,0,56,56,88,88,0,56,56,88,88,0,0.049593246877021,0.054698934613159056,98,98,0,3,2,2,2,36,93,2,25
479,0,616,1,100,99,0,40,1,42,41,0,40,1,52,51,0.0,0.01872085503250621,1,81,80,2,-1,3,5,0,49,92,7
480,22,22,47,47,0,48,48,60,60,0,22,22,47,47,0,0.0046972327172470135,0.0046972327172470135,53,53,0,-1,3,3,3,3,58,29,93
481,291,291,99,99,0,96,96,94,94,0,96,96,94,94,0,0.044453521222642026,0.044453521222642026,94,94,0,-1,2,2,3,29,92,11,89
482,100,100,58,58,0,100,100,35,35,0,100,100,59,59,0,0.03192756730998332,0.03917764389529936,91,94,3,2,1,1,17,16,20,18,27
483,132,132,81,81,0,158,158,78,78,0,132,132,82,82,0,0.017052997038701112,0.017052997038701112,78,78,0,-1,2,2,9,9,29,39,91
484,72,672,66,100,34,32,32,58,58,0,32,32,59,59,0,0.008271214132543654,0.024983831988835564,62,90,28,2,3,3,2,7,68,48,23
485,256,256,97,97,0,86,86,94,94,0,86,86,94,94,0,0.03887130263113108,0.03887130263113108,93,93,0,-1,2,2,3,27,55,10,96
486,56,672,53,100,47,154,154,67,67,0,56,154,53,83,30,0.004731270635487933,0.027060145001531706,55,88,33,2,2,2,10,3,18,29,0
487,44,44,54,54,0,80,80,70,70,0,44,44,54,54,0,0.006875659484665918,0.006875659484665918,59,59,0,-1,3,3,5,4,45,38,81
488,0,0,1,1,0,0,0,1,1,0,0,0,1,1,0,0.0,0.0,1,1,0,-1,-1,-1,9,0,35,85,91
489,18,634,39,100,61,36,50,36,45,9,18,50,39,52,13,0.000442492937131965,0.015453214881377854,34,78,44,2,3,3,5,2,50,56,23
490,12,218,37,93,56,20,24,32,35,3,12,18,37,43,6,0.0010211375472276116,0.002382654276864427,40,44,4,3,4,4,6,3,69,51,53
491,0,1640,1,100,99,0,112,1,65,64,0,112,1,77,76,0.0,0.043023928656523366,1,97,96,1,-1,2,8,0,21,67,3
492,108,1708,85,100,15,72,72,80,80,0,72,72,80,80,0,0.020150447598624867,0.06137036658837945,85,97,12,1,2,2,3,9,66,39,23
493,1,617,23,100,77,4,30,23,37,14,1,30,23,43,20,3.4037918240920386e-05,0.006909697402906838,24,58,34,2,6,3,4,2,67,58,44
494,22,22,40,40,0,126,126,63,63,0,22,22,40,40,0,0.002212464685659825,0.002212464685659825,45,45,0,-1,3,3,11,2,38,61,98
495,100,100,69,69,0,100,100,66,66,0,100,100,75,75,0,0.025902855781340415,0.026175159127267776,87,88,1,4,1,1,6,3,51,54,88
496,22,638,41,100,59,110,130,59,62,3,22,130,41,80,39,0.0018040096667687805,0.01756356581231492,43,79,36,2,3,3,10,2,18,61,12
497,64,64,58,58,0,140,140,70,70,0,64,64,58,58,0,0.006977773239388679,0.006977773239388679,61,61,0,-1,3,3,10,4,12,38,80
498,88,190,73,91,18,64,64,68,68,0,64,64,71,71,0,0.01245787807617686,0.01405766023350012,74,79,5,4,3,3,4,13,72,33,46
499,2,618,29,100,71,7,34,29,45,16,2,34,29,51,22,0.0002042275094455223,0.010824058000612683,32,73,41,2,5,3,4,1,73,55,33
500,166,366,95,100,5,32,32,67,67,0,32,32,68,68,0,0.03185949147350148,0.04319411824772797,94,95,1,3,3,3,2,29,97,0,15
501,51,257,57,97,40,38,38,46,46,0,38,38,51,51,0,0.005480104836788182,0.009939072126348753,55,73,18,3,3,3,3,6,96,35,31
502,0,206,1,90,89,0,44,1,35,34,0,26,1,48,47,0.0,0.003880322679464924,1,50,49,3,-1,4,8,0,30,89,26
503,100,100,61,61,0,100,100,43,43,0,100,100,61,61,0,0.024881718234112803,0.024881718234112803,87,87,0,-1,1,1,12,15,2,19,79
504,10,216,41,93,52,18,18,40,40,0,10,18,41,44,3,0.001157289220191293,0.007250076585316042,40,67,27,3,4,4,3,3,92,43,27
505,40,142,54,89,35,62,62,77,77,0,40,62,60,79,19,0.008679669151434699,0.009428503352734947,69,69,0,4,2,2,3,1,75,90,64
506,159,159,90,90,0,88,88,80,80,0,88,88,80,80,0,0.025290173253003846,0.025290173253003846,87,87,0,-1,2,2,4,16,84,18,93
507,2,208,26,89,63,10,18,26,27,1,2,10,26,31,5,0.0,0.0005786446100956465,1,33,32,3,5,4,9,2,29,58,63
508,48,1688,58,100,42,58,92,69,87,18,48,92,59,87,28,0.007658531604207087,0.04220701861874128,64,96,32,1,2,2,4,4,84,64,6
509,0,0,1,1,0,0,0,1,1,0,0,0,1,1,0,0.0,0.0,1,1,0,-1,-1,-1,5,0,45,89,67
510,104,720,75,100,25,240,240,77,77,0,104,168,75,86,11,0.005548180673270023,0.012389802239695021,56,72,16,2,2,2,16,5,4,47,38
511,16,1656,34,100,66,42,180,32,69,37,16,180,34,83,49,0.0002042275094455223,0.02658361414615882,32,89,57,1,3,2,16,1,9,95,10
512,0,616,1,100,99,0,60,1,36,35,0,40,1,48,47,0.0,0.003982436434187685,1,51,50,2,-1,3,11,0,38,67,47
513,0,206,1,89,88,0,18,1,32,31,0,16,1,35,34,0.0,0.0045270431260424114,1,54,53,3,-1,4,5,1,61,69,38
514,0,206,1,88,87,0,22,1,32,31,0,6,1,29,28,0.0,0.0004084550188910446,1,33,32,3,-1,4,9,0,54,40,49
515,16,222,43,97,54,28,28,46,46,0,16,28,43,52,9,0.0019741992579733825,0.009632730862180468,45,72,27,3,3,3,3,1,81,53,77
516,2,618,27,100,73,6,38,29,50,21,2,38,27,53,26,0.00017018959120460194,0.02743456210218183,29,91,62,2,5,3,3,1,94,88,10
517,16,117,41,81,40,50,50,48,48,0,16,17,41,44,3,0.002927260968719153,0.0030634126416828346,48,49,1,5,3,3,5,3,49,46,60
518,0,0,1,1,0,0,0,1,1,0,0,0,1,1,0,0.0,0.0,1,1,0,-1,-1,-1,8,0,21,92,99
519,70,172,59,88,29,124,124,68,68,0,70,72,59,60,1,0.005684332346233704,0.006058749446883829,59,59,0,4,3,3,9,5,31,47,42
520,67,683,62,100,38,98,108,52,68,16,67,108,62,76,14,0.006705469893461316,0.016474352428605468,63,79,16,2,3,3,8,8,39,57,8
521,56,262,59,96,37,122,122,76,76,0,56,66,59,61,2,0.006126825283365669,0.007692569522448007,60,65,5,3,2,2,8,3,39,29,54
522,28,28,44,44,0,64,64,41,41,0,28,28,44,44,0,0.0017018959120460194,0.0017018959120460194,42,42,0,-1,3,3,9,3,31,43,96
523,100,100,71,71,0,100,100,79,79,0,100,100,79,79,0,0.0392457197317812,0.044045066203750975,94,97,3,3,1,1,5,9,70,31,44
524,16,16,43,43,0,48,48,73,73,0,16,16,43,43,0,0.004561081044283332,0.004561081044283332,51,51,0,-1,3,3,3,1,92,90,36
525,18,634,40,100,60,46,68,37,40,3,18,68,40,55,15,0.0005446066918547262,0.01327478811395895,37,75,38,2,3,3,8,2,10,56,6
526,2,2,27,27,0,6,6,29,29,0,2,2,27,27,0,0.0002042275094455223,0.0002042275094455223,31,31,0,-1,5,5,3,1,85,65,59
527,242,442,96,100,4,56,56,76,76,0,56,56,77,77,0,0.0333911977943429,0.03917764389529936,92,96,4,3,2,2,2,27,68,10,8
528,72,174,70,90,20,64,64,68,68,0,64,64,71,71,0,0.013444977705163553,0.013615167296368155,77,77,0,4,3,3,4,8,72,20,55
529,46,662,53,100,47,76,96,49,55,6,46,96,53,67,14,0.005616256509751864,0.012798257258586064,55,74,19,2,2,2,7,2,43,75,44
530,0,102,1,79,78,0,7,1,24,23,0,3,1,26,25,0.0,0.00030634126416828345,1,28,27,4,-1,5,4,0,67,85,56
531,58,58,55,55,0,100,100,45,45,0,58,58,55,55,0,0.002110350930937064,0.002110350930937064,43,43,0,-1,2,2,10,4,12,64,36
532,88,688,59,100,41,164,164,73,73,0,88,120,59,77,18,0.007113924912352361,0.014568229007113924,59,75,16,2,2,2,10,7,18,62,20
533,1,1641,25,100,75,6,72,25,58,33,1,72,25,64,39,3.4037918240920386e-05,0.028489737567650362,28,89,61,1,6,2,6,1,69,78,37
534,0,206,1,90,89,0,14,1,30,29,0,8,1,36,35,0.0,0.0011232513019503727,1,38,37,3,-1,4,5,1,80,69,74
535,26,642,49,100,51,38,38,46,46,0,38,38,51,51,0,0.0038462847612240037,0.010041185881071514,50,72,22,2,3,3,3,6,96,41,38
536,128,334,80,98,18,252,252,83,83,0,128,146,80,85,5,0.0068075836481840775,0.008203138296061813,60,63,3,3,2,2,14,5,8,47,43
537,0,1640,1,100,99,0,108,1,66,65,0,93,1,63,62,0.0,0.023452125667994147,1,87,86,1,-1,2,9,0,23,67,39
538,118,118,80,80,0,148,148,79,79,0,118,118,80,80,0,0.01507879778072773,0.01507879778072773,75,75,0,-1,2,2,9,9,26,39,36
539,207,207,93,93,0,112,112,94,94,0,112,112,94,94,0,0.02644746247319514,0.02644746247319514,87,87,0,-1,2,2,4,19,78,15,82
540,6,107,28,80,52,26,26,31,31,0,6,7,28,32,4,0.00037441710065012424,0.0004084550188910446,32,32,0,5,4,4,9,1,31,4,78
541,12,12,36,36,0,28,28,33,33,0,12,12,36,36,0,0.0004084550188910446,0.0004084550188910446,33,33,0,-1,4,4,6,2,65,56,82
542,16,222,37,93,56,34,38,35,37,2,16,22,37,41,4,0.0005786446100956465,0.002280540522141666,35,43,8,3,3,3,6,1,65,4,53
543,100,100,67,67,0,100,100,54,54,0,100,100,67,67,0,0.01950372715204738,0.01950372715204738,81,81,0,5,1,1,9,2,35,52,68
544,12,218,39,93,54,20,24,35,37,2,12,24,39,49,10,0.0012253650566731338,0.008747744987916539,41,66,25,3,4,4,4,3,73,51,32
545,0,616,1,100,99,0,28,1,44,43,0,28,1,51,50,0.0,0.02889819258654141,1,93,92,2,-1,3,3,0,94,82,3
546,160,366,86,99,13,134,134,92,92,0,134,134,93,93,0,0.019776030497974745,0.020729092208720514,84,85,1,3,2,2,6,12,65,37,71
547,478,478,100,100,0,304,304,100,100,0,304,304,100,100,0,0.03492290411518432,0.03492290411518432,91,91,0,-1,2,2,10,27,0,10,36
548,12,12,35,35,0,14,14,32,32,0,12,12,35,35,0,0.0012253650566731338,0.0012253650566731338,38,38,0,-1,4,4,3,3,82,51,98
549,0,206,1,92,91,0,32,1,39,38,0,26,1,47,46,0.0,0.007011811157629599,1,59,58,3,-1,4,6,0,69,82,25
550,67,67,60,60,0,76,76,57,57,0,76,76,61,61,0,0.007318152421797883,0.007318152421797883,62,62,0,-1,3,3,6,8,74,44,82
551,18,634,41,100,59,82,106,42,56,14,18,106,41,75,34,0.0006807583648184077,0.015283025290173252,37,75,38,2,3,3,10,2,12,56,15
552,137,239,88,97,9,48,48,68,68,0,48,48,69,69,0,0.023452125667994147,0.025868817863099493,87,88,1,4,3,3,3,15,81,16,22
553,126,227,77,90,13,158,158,74,74,0,126,127,78,78,0,0.011096361346540046,0.011164437183021887,70,70,0,5,2,2,9,8,28,17,78
554,0,616,1,100,99,0,40,1,35,34,0,40,1,49,48,0.0,0.008645631233193778,1,66,65,2,-1,3,7,0,43,81,8
555,0,206,1,91,90,0,26,1,34,33,0,6,1,30,29,0.0,0.0015317063208414173,1,42,41,3,-1,4,7,0,62,59,53
556,6,6,29,29,0,15,15,29,29,0,6,6,29,29,0,3.4037918240920386e-05,3.4037918240920386e-05,26,26,0,-1,4,4,8,1,39,68,40
557,185,185,93,93,0,78,78,75,75,0,78,78,76,76,0,0.024983831988835564,0.024983831988835564,87,87,0,-1,2,2,4,15,73,16,93
558,258,458,95,98,3,216,216,96,96,0,216,216,96,96,0,0.024234997787535316,0.024779604479390042,87,88,1,3,2,2,9,15,29,16,64
559,256,358,97,99,2,72,72,80,80,0,72,72,80,80,0,0.03475271452397971,0.03492290411518432,94,94,0,4,2,2,3,27,66,10,49
560,0,0,1,1,0,0,0,1,1,0,0,0,1,1,0,0.0,0.0,1,1,0,-1,-1,-1,4,0,67,97,66
561,0,206,1,92,91,0,24,1,39,38,0,24,1,51,50,0.0,0.009496579189216788,1,69,68,3,-1,4,4,0,78,91,39
562,2,1642,27,100,73,7,58,28,62,34,2,58,27,62,35,0.0002042275094455223,0.036658837945471257,31,92,61,1,5,2,4,1,79,60,5
563,190,806,89,100,11,318,318,91,91,0,190,206,89,91,2,0.01330882603219987,0.015283025290173252,74,78,4,2,2,2,16,9,4,27,53
564,0,616,1,99,98,0,58,1,33,32,0,16,1,33,32,0.0,0.002280540522141666,1,45,44,2,-1,3,12,0,6,79,53
565,2,102,28,84,56,3,3,28,28,0,2,3,28,33,5,0.00013615167296368154,0.0007828721195411688,31,38,7,4,5,5,2,1,93,55,51
566,166,166,84,84,0,208,208,85,85,0,166,166,84,84,0,0.013785356887572755,0.013785356887572755,74,74,0,-1,2,2,10,9,18,27,86
567,102,102,87,87,0,46,46,87,87,0,46,46,88,88,0,0.019844106334456584,0.019844106334456584,84,84,0,-1,2,2,2,14,97,32,84
568,76,282,69,98,29,32,32,58,58,0,32,32,60,60,0,0.011062323428299126,0.02379250485040335,71,89,18,3,3,3,2,6,91,77,18
569,0,0,1,1,0,0,0,1,1,0,0,0,1,1,0,0.0,0.0,1,1,0,-1,-1,-1,12,0,14,36,98
570,0,616,1,100,99,0,46,1,42,41,0,46,1,53,52,0.0,0.014568229007113924,1,79,78,2,-1,3,6,0,69,84,23
571,66,66,63,63,0,48,48,62,62,0,48,48,64,64,0,0.006705469893461316,0.006705469893461316,61,61,0,-1,3,3,3,6,64,13,87
572,0,102,1,76,75,0,13,1,26,25,0,2,1,24,23,0.0,0.00017018959120460194,1,28,27,4,-1,5,10,1,36,45,4
573,56,672,53,100,47,120,168,57,70,13,56,168,53,84,31,0.0035739814152966403,0.018210286258892407,49,79,30,2,2,2,14,2,17,83,12
574,231,333,94,100,6,72,72,86,86,0,72,72,86,86,0,0.03761189965621702,0.03870111303992648,92,92,0,4,2,2,3,29,92,0,52
575,0,206,1,90,89,0,32,1,31,30,0,6,1,28,27,0.0,0.002995336805200994,1,46,45,3,-1,4,8,0,39,36,90
576,144,245,86,92,6,80,80,68,68,0,80,80,72,72,0,0.019469689233806462,0.0195377650702883,83,83,0,5,3,3,5,18,88,30,55
577,0,616,1,99,98,0,46,1,33,32,0,23,1,44,43,0.0,0.002927260968719153,1,47,46,2,-1,3,12,1,14,69,64
578,0,616,1,100,99,0,62,1,45,44,0,62,1,58,57,0.0,0.021920419347152727,1,82,81,2,-1,3,7,0,62,76,1
579,14,116,42,84,42,24,24,38,38,0,14,16,42,42,0,0.0017018959120460194,0.0024507301133462676,44,47,3,4,4,4,4,4,73,64,71
580,46,252,57,96,39,38,38,53,53,0,38,38,55,55,0,0.0045270431260424114,0.008577555396711936,55,68,13,3,3,3,3,6,64,28,13
581,66,66,56,56,0,102,102,58,58,0,64,64,55,55,0,0.00442492937131965,0.00442492937131965,54,54,0,-1,2,2,8,6,42,41,45
582,76,676,65,100,35,108,108,69,69,0,76,108,65,76,11,0.006331052792811192,0.024609414888185438,61,88,27,2,3,3,8,6,39,13,9
583,28,130,50,83,33,34,34,43,43,0,28,34,50,51,1,0.001497668402600497,0.00353994349705572,42,51,9,4,3,3,4,4,79,64,75
584,47,253,51,94,43,44,44,44,44,0,44,44,50,50,0,0.005037611899656217,0.01674665577453283,50,80,30,3,3,3,4,6,67,35,12
585,28,234,52,94,42,28,28,42,42,0,28,28,51,51,0,0.002314578440382586,0.007862759113652609,48,64,16,3,3,3,3,6,64,70,31
586,20,121,46,84,38,24,24,43,43,0,20,24,47,50,3,0.0015317063208414173,0.0015317063208414173,41,41,0,5,3,3,3,3,55,43,95
587,22,228,47,93,46,22,22,42,42,0,22,22,46,46,0,0.004016474352428605,0.006331052792811192,54,58,4,3,3,3,2,3,68,29,41
588,230,830,92,100,8,208,208,85,85,0,208,208,91,91,0,0.016270124919159943,0.02386058068688519,78,85,7,2,2,2,10,14,18,14,31
589,0,616,1,100,99,0,68,1,39,38,0,48,1,55,54,0.0,0.008373327887266415,1,63,62,2,-1,3,10,1,11,45,34
590,111,727,82,100,18,72,72,84,84,0,72,72,84,84,0,0.019776030497974745,0.02365635317743967,84,87,3,2,2,2,3,12,81,37,42
591,66,272,60,95,35,114,114,67,67,0,66,72,60,60,0,0.0051397256543789785,0.005514142755029102,54,56,2,3,3,3,9,6,23,28,49
592,0,616,1,100,99,0,26,1,33,32,0,18,1,37,36,0.0,0.0026209197045508697,1,40,39,2,-1,3,6,1,51,45,83
593,0,206,1,89,88,0,28,1,31,30,0,19,1,41,40,0.0,0.0026889955410327104,1,45,44,3,-1,4,6,0,40,36,22
594,0,206,1,87,86,0,28,1,28,27,0,6,1,28,27,0.0,0.0002723033459273631,1,33,32,3,-1,4,14,1,16,50,88
595,28,28,46,46,0,50,50,46,46,0,28,28,46,46,0,0.0023486163586235067,0.0023486163586235067,47,47,0,-1,3,3,5,3,50,54,40
596,236,836,95,100,5,184,184,96,96,0,184,184,96,96,0,0.02644746247319514,0.036454610436025735,90,92,2,2,2,2,7,20,46,23,39
597,144,350,89,99,10,72,72,84,84,0,72,72,84,84,0,0.019129310051397258,0.02743456210218183,84,89,5,3,2,2,3,14,85,32,19
598,0,0,1,1,0,0,0,1,1,0,0,0,1,1,0,0.0,0.0,1,1,0,-1,-1,-1,3,0,96,91,89
599,2,1642,28,100,72,12,90,30,58,28,2,90,28,65,37,0.00017018959120460194,0.03703325504612138,31,92,61,1,5,2,6,1,44,60,7
600,118,718,88,100,12,32,32,67,67,0,32,32,68,68,0,0.02117158514585248,0.02913645801422785,85,93,8,2,3,3,2,19,97,15,73
601,0,616,1,100,99,0,44,1,49,48,0,44,1,56,55,0.0,0.012594029749140543,1,75,74,2,-1,3,4,0,73,76,25
602,0,206,1,88,87,0,23,1,29,28,0,8,1,34,33,0.0,0.0016338200755641784,1,42,41,3,-1,4,8,1,10,50,83
603,0,616,1,100,99,0,74,1,41,40,0,74,1,60,59,0.0,0.012696143503863304,1,70,69,2,-1,3,9,0,23,92,37
604,16,117,43,85,42,48,48,73,73,0,16,17,43,44,1,0.004561081044283332,0.004561081044283332,51,51,0,6,3,3,3,1,92,90,78
605,22,222,40,90,50,78,78,38,38,0,22,66,40,56,16,0.0026889955410327104,0.0068075836481840775,47,60,13,3,3,3,12,2,3,75,31
606,2,103,28,78,50,7,7,28,28,0,2,2,28,28,0,0.00017018959120460194,0.0002042275094455223,31,33,2,6,5,5,4,1,84,95,58
607,189,290,91,95,4,152,152,83,83,0,152,152,86,86,0,0.022328874366043774,0.022328874366043774,84,84,0,5,2,2,8,20,21,23,68
608,18,18,43,43,0,30,30,39,39,0,18,18,43,43,0,0.0020763130126961434,0.0020763130126961434,46,46,0,-1,4,4,5,3,37,54,86
609,16,16,41,41,0,27,27,40,40,0,16,16,41,41,0,0.0004765308553728854,0.0004765308553728854,35,35,0,-1,3,3,5,1,70,4,40
610,174,1814,87,100,13,192,216,86,92,6,192,216,89,93,4,0.020150447598624867,0.03601211749889377,83,93,10,1,2,2,9,12,28,37,20
611,6,212,33,94,61,13,22,33,34,1,6,12,33,39,6,0.00013615167296368154,0.0032336022328874367,31,49,18,3,4,4,5,1,49,4,90
612,60,266,61,95,34,60,60,52,52,0,60,60,62,62,0,0.005650294427992784,0.006262976956329351,56,56,0,3,3,3,5,6,45,28,63
613,0,616,1,100,99,0,42,1,35,34,0,42,1,50,49,0.0,0.008169100377820893,1,65,64,2,-1,3,6,0,51,67,20
614,0,616,1,100,99,0,50,1,47,46,0,50,1,56,55,0.0,0.030532012662105586,1,89,88,2,-1,3,5,0,49,91,2
615,0,206,1,93,92,0,42,1,35,34,0,30,1,46,45,0.0,0.003642057251778481,1,50,49,3,-1,4,9,0,23,81,47
616,49,665,55,100,45,146,156,68,72,4,49,156,55,85,30,0.004731270635487933,0.025324211171244768,56,87,31,2,3,3,11,4,38,22,10
617,55,671,55,100,45,56,56,48,48,0,55,56,56,56,0,0.004561081044283332,0.010143299635794275,53,68,15,2,3,3,6,6,65,28,44
618,60,266,60,95,35,76,76,54,54,0,60,76,60,65,5,0.0053099152455835805,0.012253650566731339,56,73,17,3,3,3,6,6,32,28,8
619,2,618,27,100,73,12,34,29,35,6,2,30,27,47,20,0.00010211375472276115,0.0053439531638245,30,56,26,2,5,3,6,1,48,65,41
620,100,100,68,68,0,100,100,63,63,0,100,100,68,68,0,0.05888559855679227,0.0669525851798904,100,100,0,2,1,1,6,30,41,7,27
621,2,618,28,100,72,12,56,30,44,14,2,56,28,57,29,0.00017018959120460194,0.012253650566731339,31,75,44,2,5,3,6,1,44,60,19
622,60,60,61,61,0,60,60,52,52,0,60,60,62,62,0,0.005650294427992784,0.005650294427992784,56,56,0,-1,3,3,5,6,45,28,69
623,12,218,37,94,57,14,18,34,39,5,12,18,37,45,8,0.002280540522141666,0.0036760951700194017,47,51,4,3,4,4,3,2,55,75,52
624,120,736,78,100,22,124,124,91,91,0,124,124,91,91,0,0.011981347220803976,0.021648116001225366,70,85,15,2,2,2,6,7,65,48,8
625,88,88,57,57,0,174,174,72,72,0,88,88,57,57,0,0.008305252050784574,0.008305252050784574,62,62,0,-1,2,2,10,4,0,38,98
626,339,539,100,100,0,112,112,92,92,0,112,112,92,92,0,0.03710133088260322,0.037645937574457944,96,96,0,3,2,2,4,30,53,7,71
627,40,40,55,55,0,28,28,46,46,0,28,28,51,51,0,0.005582218591510943,0.005582218591510943,57,57,0,-1,3,3,3,5,85,47,91
628,0,1640,1,100,99,0,76,1,58,57,0,76,1,65,64,0.0,0.029919330133769018,1,90,89,1,-1,2,6,0,34,82,12
629,57,673,56,100,44,82,102,56,73,17,57,102,56,78,22,0.005412029000306341,0.032063718982947,54,91,37,2,3,3,7,6,62,35,11
630,36,137,59,91,32,32,32,63,63,0,32,32,65,65,0,0.005684332346233704,0.005786446100956465,60,60,0,5,3,3,2,6,98,26,78
631,184,800,88,100,12,318,328,91,95,4,184,248,88,94,6,0.013444977705163553,0.020626978453997753,75,82,7,2,2,2,16,8,4,17,38
632,2,618,27,99,72,12,106,27,54,27,2,106,27,77,50,0.0,0.017393376221110316,1,79,78,2,5,3,11,1,33,68,23
633,52,252,65,99,34,12,12,37,37,0,12,12,42,42,0,0.007794683277170768,0.015555328636100617,66,77,11,3,4,4,2,13,99,24,19
634,96,302,68,96,28,104,104,66,66,0,104,104,79,79,0,0.008441403723748256,0.010755982164130842,62,68,6,3,3,3,9,13,26,24,70
635,40,40,48,48,0,146,146,67,67,0,40,40,48,48,0,0.002314578440382586,0.002314578440382586,45,45,0,-1,2,2,12,1,3,53,98
636,0,102,1,77,76,0,12,1,26,25,0,2,1,25,24,0.0,0.0,1,1,0,4,-1,5,10,1,1,69,95
637,258,858,94,100,6,176,176,85,85,0,176,176,89,89,0,0.019810068416215663,0.02290751897613942,84,85,1,2,2,2,8,16,42,12,29
638,222,838,93,100,7,220,220,82,82,0,220,220,93,93,0,0.01415977398822288,0.0245413390517036,75,89,14,2,2,2,12,14,6,32,37
639,112,728,75,100,25,150,150,85,85,0,112,150,77,88,11,0.010687906327649,0.020456788862793153,72,85,13,2,2,2,7,4,46,38,33
640,270,476,98,100,2,96,96,94,94,0,96,96,94,94,0,0.041185881071513664,0.043023928656523366,95,95,0,3,2,2,3,27,85,10,52
641,50,666,62,100,38,32,32,63,63,0,32,32,64,64,0,0.006501242384015794,0.029749140542564417,62,93,31,2,3,3,2,6,86,26,1
642,0,206,1,93,92,0,14,1,33,32,0,14,1,40,39,0.0,0.003267640151128357,1,49,48,3,-1,4,3,0,60,96,35
643,52,52,53,53,0,80,80,54,54,0,52,52,53,53,0,0.004322815616596889,0.004322815616596889,54,54,0,-1,2,2,6,3,40,43,59
644,188,188,92,92,0,48,48,63,63,0,48,48,64,64,0,0.0230436706491031,0.0230436706491031,86,86,0,-1,3,3,3,19,82,15,76
645,12,12,37,37,0,12,12,32,32,0,12,12,37,37,0,0.0018380475850097008,0.0018380475850097008,44,44,0,-1,4,4,2,2,91,83,67
646,16,16,36,36,0,40,40,42,42,0,16,16,36,36,0,0.002110350930937064,0.002110350930937064,46,46,0,-1,3,3,5,1,61,53,92
647,80,80,70,70,0,38,38,57,57,0,38,38,59,59,0,0.009122162088566664,0.009122162088566664,66,66,0,-1,3,3,3,9,55,31,98
648,0,616,1,100,99,0,32,1,39,38,0,32,1,50,49,0.0,0.008509479560230097,1,67,66,2,-1,3,5,0,37,85,24
649,76,76,63,63,0,64,64,63,63,0,64,64,64,64,0,0.009973110044589673,0.009973110044589673,71,71,0,-1,3,3,4,6,79,77,93
650,144,760,84,100,16,116,116,74,74,0,116,116,81,81,0,0.010245413390517035,0.012083460975526737,70,74,4,2,2,2,7,13,46,24,61
651,70,686,65,100,35,70,70,59,59,0,70,70,67,67,0,0.00622893903808843,0.02743456210218183,56,87,31,2,3,3,5,5,88,47,10
652,47,253,56,93,37,56,56,46,46,0,47,56,56,57,1,0.004799346471969774,0.00888389666088022,56,65,9,3,3,3,6,6,74,35,47
653,86,188,70,88,18,70,70,67,67,0,70,70,71,71,0,0.01147077844719017,0.011743081793117532,72,72,0,4,3,3,5,6,70,77,88
654,94,300,69,95,26,104,104,85,85,0,94,104,72,85,13,0.013785356887572755,0.01409169815174104,76,77,1,3,2,2,5,5,37,25,49
655,0,1640,1,100,99,0,134,1,76,75,0,134,1,84,83,0.0,0.0337315769767521,1,92,91,1,-1,2,9,1,23,50,1
656,16,632,34,100,66,122,132,62,66,4,16,62,34,54,20,0.0018040096667687805,0.007998910786616291,41,61,20,2,3,3,12,1,2,53,21
657,94,94,69,69,0,94,94,68,68,0,94,94,71,71,0,0.007454304094761564,0.007454304094761564,62,62,0,-1,2,2,5,5,50,47,80
658,0,206,1,93,92,0,18,1,34,33,0,8,1,36,35,0.0,0.0033357159876101976,1,50,49,3,-1,4,3,0,58,79,29
659,51,51,58,58,0,60,60,52,52,0,60,60,62,62,0,0.004629156880765172,0.004629156880765172,52,52,0,-1,3,3,5,6,45,35,76
660,0,1640,1,100,99,0,66,1,53,52,0,58,1,60,59,0.0,0.020558902617515914,1,81,80,1,-1,2,6,0,69,40,26
661,88,1728,62,100,38,152,176,76,86,10,88,176,62,90,28,0.00803294870485721,0.03264236359304265,62,92,30,1,2,2,8,4,15,72,18
662,0,206,1,90,89,0,36,1,32,31,0,14,1,35,34,0.0,0.0023486163586235067,1,45,44,3,-1,4,8,0,39,79,70
663,0,616,1,100,99,0,22,1,46,45,0,22,1,51,50,0.0,0.017903944994724124,1,80,79,2,-1,3,2,0,89,82,9
664,47,1687,54,100,46,40,74,44,72,28,40,74,53,74,21,0.004799346471969774,0.02661765206439974,52,88,36,1,3,2,5,6,70,35,64
665,132,233,89,96,7,96,96,90,90,0,96,96,90,90,0,0.02032063718982947,0.02042275094455223,84,86,2,5,2,2,3,13,75,33,55
666,16,632,35,100,65,100,130,45,65,20,16,130,35,80,45,0.0026549576227917903,0.01746145205759216,47,81,34,2,3,3,10,2,1,94,18
667,46,252,57,97,40,62,62,80,80,0,46,62,71,80,9,0.008373327887266415,0.01858470335954253,64,80,16,3,2,2,3,3,94,29,5
668,44,146,60,88,28,12,12,37,37,0,12,12,41,41,0,0.009156200006807584,0.010858095918853602,69,70,1,4,4,4,2,8,89,8,46
669,0,616,1,100,99,0,28,1,42,41,0,28,1,49,48,0.0,0.006331052792811192,1,61,60,2,-1,3,3,0,75,96,72
670,0,0,1,1,0,0,0,1,1,0,0,0,1,1,0,0.0,0.0,1,1,0,-1,-1,-1,8,0,15,59,76
671,188,394,92,100,8,128,128,93,93,0,128,128,93,93,0,0.027604751693386432,0.03230198441063344,87,89,2,3,2,2,5,20,88,23,62
672,16,16,36,36,0,42,42,38,38,0,16,16,36,36,0,0.0005105687736138058,0.0005105687736138058,36,36,0,-1,3,3,8,1,39,88,91
673,38,244,52,95,43,66,66,49,49,0,38,66,53,62,9,0.0034718676605738795,0.008237176214302734,51,65,14,3,3,3,6,6,32,70,62
674,0,0,1,1,0,0,0,1,1,0,0,0,1,1,0,0.0,0.0,1,1,0,-1,-1,-1,17,0,20,99,79
675,14,630,40,100,60,12,32,32,57,25,12,32,37,59,22,0.0012253650566731338,0.017291262466387555,39,83,44,2,4,3,2,4,91,64,33
676,6,212,32,97,65,12,12,35,35,0,6,12,32,41,9,0.0009870996289866913,0.006603356138738555,38,62,24,3,4,4,2,1,98,71,62
677,12,628,37,100,63,20,34,32,39,7,12,34,37,49,12,0.00034037918240920387,0.005173763572619898,33,51,18,2,4,3,6,2,69,56,28
678,0,206,1,96,95,0,8,1,32,31,0,8,1,37,36,0.0,0.004050512270669526,1,52,51,3,-1,4,2,0,99,76,72
679,0,0,1,1,0,0,0,1,1,0,0,0,1,1,0,0.0,0.0,1,1,0,-1,-1,-1,13,0,13,79,96
680,0,206,1,86,85,0,28,1,31,30,0,6,1,28,27,0.0,0.0006126825283365669,1,36,35,3,-1,4,11,0,5,98,42
681,1,102,25,81,56,3,3,25,25,0,1,2,25,27,2,3.4037918240920386e-05,3.4037918240920386e-05,29,29,0,5,6,6,3,1,96,78,60
682,16,632,47,100,53,22,32,49,68,19,16,32,48,68,20,0.002382654276864427,0.026141121209026855,47,89,42,2,3,3,2,1,93,53,30
683,22,638,41,100,59,40,50,40,45,5,22,38,41,48,7,0.002314578440382586,0.006467204465774873,46,57,11,2,3,3,5,2,50,83,46
684,100,100,62,62,0,100,100,45,45,0,100,100,62,62,0,0.04915075393988903,0.05180571156268083,99,100,1,2,1,1,12,29,3,11,41
685,16,118,36,79,43,52,52,40,40,0,16,18,36,39,3,0.001940161339732462,0.0020422750944552232,40,41,1,4,3,3,6,1,56,53,60
686,16,632,39,100,61,56,86,45,56,11,16,86,39,63,24,0.0010211375472276116,0.0088498587426393,39,66,27,2,3,3,6,2,44,42,21
687,0,206,1,88,87,0,18,1,30,29,0,10,1,33,32,0.0,0.0007147962830593281,1,36,35,3,-1,4,7,0,24,89,43
688,16,222,33,90,57,42,46,36,39,3,16,46,33,52,19,0.0005446066918547262,0.00796487286837537,31,64,33,3,3,3,6,1,51,49,17
689,100,100,69,69,0,100,100,76,76,0,100,100,76,76,0,0.04823173014738419,0.05085264985193506,97,98,1,3,1,1,5,14,80,14,29
690,8,214,37,91,54,20,20,35,35,0,8,20,37,47,10,0.0006807583648184077,0.0012934408931549745,37,42,5,3,4,4,4,3,83,51,43
691,2,208,27,90,63,5,16,27,32,5,2,16,27,41,14,6.807583648184077e-05,0.005888559855679227,28,58,30,3,5,4,4,1,79,78,57
692,44,660,62,100,38,32,32,69,69,0,32,32,69,69,0,0.007590455767725246,0.0156914803090643,67,81,14,2,3,3,2,4,90,72,44
693,100,100,81,81,0,100,100,98,98,0,100,100,98,98,0,0.07835528779059872,0.09278736512474897,99,99,0,2,1,1,2,2,99,94,39
694,16,117,40,83,43,38,38,51,51,0,16,17,40,45,5,0.0038462847612240037,0.003982436434187685,51,51,0,5,3,3,3,1,94,90,88
695,22,638,40,100,60,54,58,35,38,3,22,58,40,52,12,0.0019741992579733825,0.012491915994417782,43,76,33,2,3,3,8,2,42,83,37
696,40,40,48,48,0,176,176,70,70,0,40,40,48,48,0,0.003778208924742163,0.003778208924742163,52,52,0,-1,2,2,12,3,6,46,89
697,0,616,1,100,99,0,68,1,40,39,0,68,1,57,56,0.0,0.01773375540351952,1,81,80,2,-1,3,8,0,30,36,23
698,102,308,83,98,15,80,80,95,95,0,80,80,95,95,0,0.016882807447496512,0.027808979202831954,82,90,8,3,2,2,2,4,68,38,6
699,128,728,77,100,23,188,188,80,80,0,128,128,77,77,0,0.007284114503556962,0.008475441641989176,59,64,5,2,2,2,10,6,0,28,88
700,62,62,61,61,0,64,64,64,64,0,64,64,67,67,0,0.008713707069675619,0.008713707069675619,65,65,0,-1,3,3,4,6,77,34,80
701,6,212,32,91,59,16,24,33,37,4,6,24,32,49,17,0.0005786446100956465,0.0061949011198475104,36,58,22,3,4,4,4,2,79,42,25
702,54,155,58,89,31,86,86,62,62,0,54,55,58,59,1,0.006569318220497634,0.006569318220497634,59,59,0,5,3,3,6,4,32,38,68
703,111,711,73,100,27,154,154,66,66,0,111,124,73,76,3,0.008203138296061813,0.010994247591817285,61,74,13,2,2,2,10,8,0,57,22
704,270,870,94,100,6,110,110,86,86,0,110,110,86,86,0,0.0335613873855475,0.03720344463732598,92,94,2,2,2,2,6,27,69,10,28
705,34,240,54,93,39,34,34,47,47,0,34,34,55,55,0,0.0030293747234419145,0.006399128629293032,49,59,10,3,3,3,4,6,77,70,28
706,0,0,1,1,0,0,0,1,1,0,0,0,1,1,0,0.0,0.0,1,1,0,-1,-1,-1,5,0,88,89,97
707,100,100,62,62,0,100,100,45,45,0,100,100,62,62,0,0.022124646856598252,0.022567139793730217,82,82,0,3,1,1,12,8,3,44,42
708,0,1640,1,100,99,0,120,1,56,55,0,77,1,59,58,0.0,0.012287688484972258,1,72,71,1,-1,2,14,0,17,59,57
709,353,353,97,97,0,128,128,92,92,0,128,128,92,92,0,0.037509785901494265,0.037509785901494265,94,94,0,-1,2,2,5,30,50,7,82
710,32,132,51,86,35,38,38,51,51,0,38,38,54,54,0,0.0040845501889104465,0.004186663943633207,52,52,0,4,3,3,3,6,94,41,60
711,388,489,98,100,2,240,240,98,98,0,240,240,98,98,0,0.038394771775758195,0.038428809693999116,95,95,0,5,2,2,9,30,26,7,65
712,0,1640,1,100,99,0,80,1,70,69,0,80,1,71,70,0.0,0.03386772864971578,1,95,94,1,-1,2,5,0,49,81,37
713,194,194,90,90,0,132,132,98,98,0,132,132,98,98,0,0.020150447598624867,0.020150447598624867,81,81,0,-1,2,2,5,14,70,14,99
714,0,0,1,1,0,0,0,1,1,0,0,0,1,1,0,0.0,0.0,1,1,0,-1,-1,-1,14,0,17,36,80
715,391,493,99,100,1,208,208,100,100,0,208,208,100,100,0,0.039449947241226725,0.03951802307770857,95,95,0,4,2,2,7,29,62,11,65
716,74,690,63,100,37,110,120,76,82,6,74,120,62,84,22,0.007147962830593281,0.014227849824704722,63,77,14,2,2,2,6,6,59,28,25
717,73,73,62,62,0,144,144,72,72,0,73,73,62,62,0,0.005684332346233704,0.005684332346233704,57,57,0,-1,2,2,10,4,12,22,87
718,158,774,86,100,14,168,168,93,93,0,158,168,93,93,0,0.012764219340345145,0.020014295925661188,75,83,8,2,2,2,6,7,44,21,25
719,0,0,1,1,0,0,0,1,1,0,0,0,1,1,0,0.0,0.0,1,1,0,-1,-1,-1,11,0,5,86,92
720,46,147,58,89,31,22,22,48,48,0,22,22,51,51,0,0.009088124170325743,0.009122162088566664,67,67,0,5,3,3,2,5,95,25,65
721,8,110,38,86,48,12,12,37,37,0,8,12,38,41,3,0.001055175465468532,0.0013274788113958951,38,39,1,4,4,4,2,2,99,74,4
722,84,700,66,100,34,64,74,61,70,9,64,74,64,71,7,0.009564655025698629,0.026141121209026855,66,88,22,2,2,2,5,9,49,31,23
723,0,206,1,92,91,0,10,1,31,30,0,10,1,39,38,0.0,0.010960209673576363,1,74,73,3,-1,4,3,0,76,87,12
724,0,1640,1,100,99,0,54,1,46,45,0,42,1,56,55,0.0,0.02018448551686579,1,86,85,1,-1,2,6,1,32,45,75
725,0,206,1,94,93,0,10,1,31,30,0,10,1,38,37,0.0,0.003710133088260322,1,52,51,3,-1,4,3,0,81,98,72
726,255,455,96,100,4,72,72,80,80,0,72,72,80,80,0,0.03315293236665646,0.03427618366860683,92,93,1,3,2,2,3,30,66,7,52
727,84,290,63,94,31,90,90,67,67,0,84,90,66,69,3,0.007420266176520644,0.009905034208107831,59,64,5,3,2,2,6,6,71,26,22
728,307,513,97,100,3,104,104,86,86,0,104,104,86,86,0,0.03311889444841554,0.03478675244222063,91,93,2,3,2,2,5,29,45,1,52
729,39,39,56,56,0,32,32,58,58,0,32,32,59,59,0,0.005241839409101739,0.005241839409101739,57,57,0,-1,3,3,2,4,68,22,45
730,100,100,58,58,0,100,100,38,38,0,100,100,58,58,0,0.014806494434800367,0.01579359406378706,75,77,2,3,1,1,16,6,9,28,51
731,256,357,97,100,3,86,86,94,94,0,86,86,94,94,0,0.03887130263113108,0.03887130263113108,93,93,0,6,2,2,3,27,55,10,68
732,240,840,94,100,6,72,72,80,80,0,72,72,80,80,0,0.031110657272201234,0.05391606249361789,91,97,6,2,2,2,3,27,87,10,7
733,94,710,79,100,21,48,48,73,73,0,48,48,75,75,0,0.014772456516559448,0.033799652813233945,77,91,14,2,3,3,3,13,92,33,9
734,34,136,54,87,33,32,32,58,58,0,32,32,59,59,0,0.0033016780693692774,0.004118588107151367,51,55,4,4,3,3,2,6,68,70,83
735,150,766,85,100,15,150,150,85,85,0,150,150,89,89,0,0.017121072875182955,0.027026107083290785,81,90,9,2,2,2,7,8,46,20,33
736,370,576,97,100,3,88,88,73,73,0,88,88,74,74,0,0.04094761564382722,0.04326219408420981,94,95,1,3,2,2,4,40,83,3,35
737,100,100,72,72,0,100,100,79,79,0,100,100,80,80,0,0.06034922904115184,0.06034922904115184,99,99,0,-1,1,1,5,27,37,10,50
738,22,638,41,100,59,76,96,39,41,2,22,82,41,60,19,0.0019061234214915416,0.013104598522754349,42,73,31,2,3,3,11,2,33,83,39
739,8,8,36,36,0,14,14,33,33,0,8,8,36,36,0,0.0002042275094455223,0.0002042275094455223,31,31,0,-1,4,4,3,2,66,56,92
740,0,616,1,100,99,0,38,1,45,44,0,38,1,50,49,0.0,0.01245787807617686,1,77,76,2,-1,3,3,0,96,82,33
741,6,108,29,82,53,14,14,32,32,0,6,10,29,34,5,0.0002042275094455223,0.0012594029749140542,31,38,7,4,4,4,3,1,82,4,74
742,0,206,1,89,88,0,42,1,32,31,0,42,1,51,50,0.0,0.007420266176520644,1,60,59,3,-1,4,9,0,29,66,14
743,18,18,47,47,0,44,44,48,48,0,18,18,47,47,0,0.0018380475850097008,0.0018380475850097008,44,44,0,-1,3,3,4,2,83,61,91
744,74,280,69,95,26,38,38,55,55,0,38,38,58,58,0,0.011096361346540046,0.014636304843595765,72,77,5,3,3,3,3,9,76,27,35
745,0,616,1,100,99,0,30,1,34,33,0,16,1,36,35,0.0,0.0030974505599237552,1,48,47,2,-1,3,6,0,48,92,94
746,100,100,58,58,0,100,100,38,38,0,100,100,58,58,0,0.016508390346846386,0.02733244834745907,79,90,11,1,1,1,16,6,9,13,47
747,254,254,92,92,0,190,190,91,91,0,190,190,91,91,0,0.025936893699581333,0.025936893699581333,87,87,0,-1,2,2,8,15,27,16,82
748,86,686,67,100,33,60,60,53,53,0,60,60,60,60,0,0.008577555396711936,0.022022533101875488,65,83,18,2,3,3,5,13,49,24,6
749,76,282,63,96,33,86,86,63,63,0,76,86,66,66,0,0.008066986623098132,0.009428503352734947,62,67,5,3,3,3,6,7,56,21,83
750,126,332,79,95,16,184,184,78,78,0,126,132,79,80,1,0.012832295176826986,0.013479015623404473,72,73,1,3,2,2,10,8,18,20,49
751,0,206,1,90,89,0,36,1,37,36,0,36,1,50,49,0.0,0.009428503352734947,1,67,66,3,-1,4,6,0,74,82,39
752,200,816,91,100,9,268,268,82,82,0,200,268,91,95,4,0.014500153170632085,0.025290173253003846,78,85,7,2,2,2,16,8,4,8,30
753,189,395,87,96,9,120,120,78,78,0,120,120,78,78,0,0.02403077027808979,0.024507301133462677,87,87,0,3,2,2,6,20,41,23,63
754,16,632,39,100,61,28,38,40,50,10,16,38,39,53,14,0.0014636304843595766,0.020558902617515914,41,85,44,2,3,3,3,1,82,71,9
755,0,206,1,95,94,0,18,1,34,33,0,18,1,45,44,0.0,0.015112835698968652,1,77,76,3,-1,4,3,0,94,84,9
756,100,100,80,80,0,100,100,98,98,0,100,100,98,98,0,0.09547636066578168,0.10299874059702509,100,100,0,3,1,1,2,16,93,18,17
757,166,372,87,100,13,96,96,69,69,0,96,96,70,70,0,0.019844106334456584,0.023384049831512304,84,87,3,3,3,3,6,16,56,12,72
758,16,1656,36,100,64,52,86,40,64,24,16,63,36,53,17,0.0032336022328874367,0.021409850573538922,43,83,40,1,3,2,6,1,71,90,43
759,218,424,97,100,3,48,48,70,70,0,48,48,72,72,0,0.02923857176895061,0.03972225058715409,93,95,2,3,3,3,3,29,94,1,6
760,120,736,80,100,20,164,164,77,77,0,120,164,80,86,6,0.00891793457912114,0.015657442390823378,67,81,14,2,2,2,10,7,36,21,31
761,138,240,79,88,9,142,142,78,78,0,138,142,81,81,0,0.0160318594914735,0.016168011164437182,74,74,0,4,2,2,8,9,27,39,55
762,22,124,45,82,37,38,38,39,39,0,22,27,45,48,3,0.0013615167296368155,0.002110350930937064,40,45,5,4,3,3,6,3,74,51,43
763,72,272,58,94,36,66,66,44,44,0,66,66,57,57,0,0.007726607440688927,0.014806494434800367,62,78,16,3,3,3,6,8,51,57,17
764,0,102,1,74,73,0,11,1,27,26,0,2,1,25,24,0.0,0.0002723033459273631,1,32,31,4,-1,5,8,0,10,79,88
765,0,616,1,100,99,0,136,1,60,59,0,124,1,75,74,0.0,0.01746145205759216,1,79,78,2,-1,3,15,0,7,89,23
766,232,438,95,100,5,64,64,68,68,0,64,64,69,69,0,0.02811532046700024,0.033221008203138294,90,92,2,3,3,3,4,27,73,10,77
767,8,214,40,96,56,12,12,39,39,0,8,12,40,44,4,0.0018380475850097008,0.008577555396711936,44,66,22,3,4,4,2,2,93,83,77
768,106,208,78,93,15,72,72,77,77,0,72,72,77,77,0,0.014874570271282209,0.015453214881377854,78,79,1,4,2,2,3,8,64,20,74
769,98,304,77,98,21,72,72,84,84,0,72,72,84,84,0,0.015487252799618776,0.018006058749446885,77,78,1,3,2,2,3,9,81,27,94
770,56,672,53,100,47,150,160,65,67,2,56,160,53,83,30,0.005650294427992784,0.015283025290173252,55,74,19,2,2,2,11,3,5,29,32
771,154,154,90,90,0,88,88,76,76,0,88,88,79,79,0,0.02049082678103407,0.02049082678103407,85,85,0,-1,2,2,4,18,47,5,81
772,16,16,34,34,0,42,42,32,32,0,16,16,34,34,0,0.0002042275094455223,0.0002042275094455223,32,32,0,-1,3,3,16,1,9,95,89
773,135,341,85,98,13,80,80,70,70,0,80,80,74,74,0,0.015487252799618776,0.023315973995030465,77,85,8,3,3,3,5,15,45,19,32
774,0,1640,1,100,99,0,138,1,62,61,0,122,1,82,81,0.0,0.016440314510364547,1,76,75,1,-1,2,14,0,17,81,19
775,162,778,81,100,19,142,142,78,78,0,142,142,82,82,0,0.016304162837400864,0.0352292453793526,75,95,20,2,2,2,8,13,27,33,9
776,16,222,36,92,56,34,50,34,36,2,16,22,36,42,6,0.0004084550188910446,0.0020763130126961434,35,44,9,3,3,3,8,1,30,4,46
777,100,100,63,63,0,100,100,56,56,0,100,100,63,63,0,0.056673133871132444,0.06154055617958406,99,99,0,2,1,1,7,29,24,0,31
778,6,6,32,32,0,8,8,32,32,0,6,6,32,32,0,0.0004084550188910446,0.0004084550188910446,35,35,0,-1,4,4,2,1,98,88,87
779,6,6,33,33,0,12,12,35,35,0,6,6,33,33,0,0.0004765308553728854,0.0004765308553728854,37,37,0,-1,4,4,2,1,86,49,91
780,47,149,63,90,27,22,22,49,49,0,22,22,50,50,0,0.006467204465774873,0.00704584907587052,60,61,1,4,3,3,2,8,93,44,74
781,86,188,69,91,22,48,48,63,63,0,48,48,64,64,0,0.008747744987916539,0.00881582082439838,68,68,0,4,3,3,3,7,82,21,95
782,2,104,27,83,56,3,3,27,27,0,2,3,27,30,3,0.0002723033459273631,0.001940161339732462,30,42,12,4,5,5,2,1,99,88,75
783,88,190,57,85,28,248,248,84,84,0,88,90,57,57,0,0.007216038667075122,0.007284114503556962,59,60,1,4,2,2,14,4,25,72,58
784,0,0,1,1,0,0,0,1,1,0,0,0,1,1,0,0.0,0.0,1,1,0,-1,-1,-1,4,0,73,81,93
785,32,648,44,100,56,102,112,56,59,3,32,48,44,50,6,0.0025188059498281084,0.003880322679464924,45,52,7,2,3,3,12,2,2,52,71
786,200,200,88,88,0,118,118,66,66,0,118,118,80,80,0,0.01763164164879676,0.01763164164879676,80,80,0,-1,3,3,8,16,30,12,76
787,16,1656,37,100,63,56,90,48,62,14,16,56,37,56,19,0.0035739814152966403,0.021341774737057083,50,85,35,1,3,2,6,1,65,90,68
788,338,338,96,96,0,206,206,95,95,0,206,206,96,96,0,0.03277851526600633,0.03277851526600633,90,90,0,-1,2,2,9,22,23,9,50
789,0,616,1,100,99,0,64,1,42,41,0,64,1,57,56,0.0,0.01504475986248681,1,76,75,2,-1,3,9,0,26,67,15
790,97,199,79,96,17,46,46,84,84,0,46,46,84,84,0,0.017121072875182955,0.01841451376833793,81,83,2,4,2,2,2,13,93,33,61
791,6,212,29,94,65,32,36,35,37,2,6,30,29,48,19,0.0005105687736138058,0.0053439531638245,35,54,19,3,4,4,6,1,59,49,72
792,46,662,53,100,47,64,94,57,77,20,46,94,52,78,26,0.004935498144933456,0.030361823070900983,52,88,36,2,2,2,5,2,88,52,1
793,16,632,43,100,57,34,44,47,53,6,16,44,44,57,13,0.0020082371762143027,0.012389802239695021,47,75,28,2,3,3,4,2,77,94,32
794,54,670,55,100,45,114,124,73,75,2,54,72,55,59,4,0.00616086320160659,0.00888389666088022,56,64,8,2,3,3,9,4,26,38,63
795,68,68,76,76,0,32,32,67,67,0,32,32,68,68,0,0.014534191088873005,0.014534191088873005,78,78,0,-1,3,3,2,8,97,20,89
796,40,246,51,94,43,118,118,64,64,0,40,46,51,54,3,0.004016474352428605,0.004561081044283332,52,54,2,3,2,2,9,2,28,94,71
797,0,206,1,92,91,0,10,1,31,30,0,8,1,36,35,0.0,0.0002382654276864427,1,31,30,3,-1,4,3,0,64,80,63
798,0,102,1,73,72,0,11,1,25,24,0,2,1,25,24,0.0,0.00030634126416828345,1,32,31,4,-1,5,10,0,22,67,55
799,0,206,1,94,93,0,16,1,34,33,0,15,1,37,36,0.0,0.0023486163586235067,1,46,45,3,-1,4,4,0,53,80,41
800,2,618,27,100,73,12,52,29,44,15,2,52,27,57,30,0.0002042275094455223,0.014261887742945642,31,80,49,2,5,3,6,1,48,60,12
801,2,208,29,93,64,8,24,30,37,7,2,24,29,49,20,6.807583648184077e-05,0.003880322679464924,27,52,25,3,5,4,4,1,73,95,47
802,158,1798,92,100,8,22,56,42,79,37,22,56,45,80,35,0.018959120460192654,0.07335171380918343,85,98,13,1,3,2,2,19,91,15,29
803,0,0,1,1,0,0,0,1,1,0,0,0,1,1,0,0.0,0.0,1,1,0,-1,-1,-1,6,0,34,59,79
804,388,388,97,97,0,392,392,99,99,0,392,392,99,99,0,0.032199870655910685,0.032199870655910685,91,91,0,-1,2,2,14,15,17,16,40
805,100,100,68,68,0,100,100,57,57,0,100,100,68,68,0,0.0545968208584363,0.061098063242452094,97,98,1,2,1,1,8,29,39,1,62
806,0,616,1,100,99,0,52,1,35,34,0,28,1,43,42,0.0,0.004050512270669526,1,51,50,2,-1,3,9,0,31,36,26
807,8,624,38,100,62,24,54,40,54,14,8,54,38,59,21,0.0018720855032506212,0.03315293236665646,44,91,47,2,4,3,4,2,84,83,2
808,60,266,57,95,38,100,100,55,55,0,60,100,57,68,11,0.0088498587426393,0.00970080669866231,65,67,2,3,3,3,9,9,26,31,64
809,0,616,1,100,99,0,74,1,44,43,0,74,1,59,58,0.0,0.017529527894074,1,80,79,2,-1,3,9,0,26,36,9
810,0,206,1,93,92,0,18,1,39,38,0,18,1,44,43,0.0,0.008713707069675619,1,67,66,3,-1,4,3,0,92,87,33
811,70,686,62,100,38,64,64,67,67,0,64,64,68,68,0,0.006331052792811192,0.013785356887572755,54,75,21,2,3,3,4,5,67,47,44
812,2,208,26,89,63,10,28,28,33,5,2,16,26,33,7,0.0,0.0010892133837094523,1,38,37,3,5,4,8,2,42,58,64
813,0,616,1,100,99,0,40,1,42,41,0,40,1,51,50,0.0,0.01681473161101467,1,80,79,2,-1,3,5,0,45,92,15
814,25,641,52,100,48,22,32,42,57,15,22,32,46,58,12,0.004016474352428605,0.02556247659893121,54,90,36,2,3,3,2,6,68,73,9
815,18,118,43,78,35,42,42,39,39,0,18,21,43,44,1,0.0013955546478777359,0.0020422750944552232,39,45,6,4,3,3,6,2,59,74,43
816,0,616,1,100,99,0,46,1,40,39,0,46,1,50,49,0.0,0.01501072194424589,1,80,79,2,-1,3,6,0,59,66,16
817,1,617,26,100,74,13,58,26,32,6,1,35,26,49,23,0.0,0.0024507301133462676,1,44,43,2,6,3,13,1,13,78,43
818,6,622,31,100,69,12,22,37,52,15,6,22,31,52,21,0.0016678579938050988,0.020763130126961436,41,85,44,2,4,3,2,1,99,71,34
819,56,262,61,97,36,38,38,51,51,0,38,38,54,54,0,0.006092787365124749,0.009564655025698629,57,68,11,3,3,3,3,6,94,13,28
820,0,0,1,1,0,0,0,1,1,0,0,0,1,1,0,0.0,0.0,1,1,0,-1,-1,-1,2,1,91,45,86
821,98,199,77,92,15,78,78,77,77,0,78,78,79,79,0,0.014432077334150244,0.014432077334150244,78,78,0,6,2,2,4,8,78,8,58
822,0,0,1,1,0,0,0,1,1,0,0,0,1,1,0,0.0,0.0,1,1,0,-1,-1,-1,6,0,44,80,81
823,16,16,42,42,0,22,22,42,42,0,16,16,42,42,0,0.002484768031587188,0.002484768031587188,49,49,0,-1,3,3,2,3,68,46,84
824,0,206,1,92,91,0,20,1,31,30,0,8,1,33,32,0.0,0.00176997174852786,1,43,42,3,-1,4,6,0,59,93,75
825,0,616,1,100,99,0,100,1,44,43,0,100,1,65,64,0.0,0.021341774737057083,1,83,82,2,-1,3,10,0,1,99,7
826,0,206,1,92,91,0,24,1,39,38,0,24,1,51,50,0.0,0.005888559855679227,1,57,56,3,-1,4,4,0,47,86,25
827,96,96,65,65,0,134,134,77,77,0,96,96,65,65,0,0.008169100377820893,0.008169100377820893,65,65,0,-1,3,3,9,7,23,21,85
828,107,208,82,93,11,72,72,83,83,0,72,72,83,83,0,0.01841451376833793,0.01844855168657885,84,84,0,6,2,2,3,9,58,39,68
829,16,222,42,94,52,24,24,43,43,0,16,24,42,48,6,0.00088498587426393,0.004561081044283332,37,53,16,3,3,3,3,2,58,42,38
830,128,728,80,100,20,120,120,79,79,0,120,120,81,81,0,0.015317063208414174,0.029374723441914292,80,89,9,2,2,2,6,9,44,39,16
831,226,432,92,99,7,228,228,77,77,0,226,232,92,92,0,0.013138636440995268,0.013921508560536438,71,72,1,3,2,2,15,14,7,32,71
832,38,38,45,45,0,106,106,55,55,0,38,38,45,45,0,0.0015317063208414173,0.0015317063208414173,41,41,0,-1,3,3,11,4,33,64,85
833,0,102,1,77,76,0,8,1,29,28,0,6,1,31,30,0.0,0.0021784267674189047,1,46,45,4,-1,5,4,0,84,59,73
834,0,616,1,100,99,0,22,1,41,40,0,22,1,45,44,0.0,0.021682153919466287,1,87,86,2,-1,3,2,0,68,86,10
835,100,100,72,72,0,100,100,71,71,0,100,100,75,75,0,0.04428333163143742,0.0480955784744205,94,96,2,3,1,1,6,16,32,12,38
836,16,632,32,99,67,48,134,32,59,27,16,111,32,76,44,0.0002723033459273631,0.010007147962830594,33,67,34,2,3,3,17,1,20,55,19
837,42,658,58,100,42,48,48,59,59,0,48,48,63,63,0,0.007862759113652609,0.023350011913271386,63,88,25,2,3,3,3,5,75,25,5
838,363,569,100,100,0,96,96,94,94,0,96,96,94,94,0,0.05480104836788182,0.05960039483985159,97,99,2,3,2,2,3,36,85,2,31
839,0,0,1,1,0,0,0,1,1,0,0,0,1,1,0,0.0,0.0,1,1,0,-1,-1,-1,11,0,5,82,69
840,16,16,40,40,0,28,28,45,45,0,16,16,40,40,0,0.0012253650566731338,0.0012253650566731338,37,37,0,-1,3,3,3,1,94,49,85
841,0,616,1,100,99,0,32,1,35,34,0,16,1,35,34,0.0,0.003437829742332959,1,48,47,2,-1,3,7,0,43,66,94
842,0,616,1,100,99,0,68,1,42,41,0,68,1,62,61,0.0,0.015146873617209572,1,79,78,2,-1,3,8,0,57,99,6
843,106,208,76,92,16,110,110,76,76,0,110,110,81,81,0,0.00970080669866231,0.009870996289866912,68,69,1,4,2,2,6,7,59,48,55
844,36,138,53,88,35,28,28,43,43,0,28,28,50,50,0,0.0038462847612240037,0.003982436434187685,52,53,1,4,3,3,3,6,66,41,56
845,0,102,1,83,82,0,4,1,30,29,0,4,1,32,31,0.0,0.0053439531638245,1,57,56,4,-1,5,2,0,90,93,8
846,16,222,41,93,52,24,28,41,41,0,16,28,41,50,9,0.0006807583648184077,0.018959120460192654,37,84,47,3,3,3,3,1,64,49,7
847,130,232,85,92,7,48,48,54,54,0,48,48,56,56,0,0.018312400013615168,0.018822968787228972,83,83,0,4,3,3,3,18,87,30,49
848,218,418,92,98,6,200,200,94,94,0,200,200,93,93,0,0.016610504101569147,0.016882807447496512,79,79,0,3,2,2,8,13,30,33,42
849,54,260,63,97,34,32,32,70,70,0,32,32,70,70,0,0.0088498587426393,0.010755982164130842,66,69,3,3,3,3,2,7,95,48,63
850,95,301,61,96,35,106,106,67,67,0,95,106,63,75,12,0.0088498587426393,0.015214949453691413,63,78,15,3,2,2,7,6,46,35,48
851,54,260,54,95,41,86,86,57,57,0,54,61,55,58,3,0.006705469893461316,0.007590455767725246,60,62,2,3,3,3,6,4,65,72,61
852,176,382,85,96,11,110,110,72,72,0,110,110,76,76,0,0.014534191088873005,0.01664454201981007,77,79,2,3,2,2,6,14,40,14,75
853,50,650,52,100,48,134,134,62,62,0,44,134,49,81,32,0.0035059055788147996,0.013581129378127233,51,72,21,2,3,3,14,6,8,41,5
854,0,0,1,1,0,0,0,1,1,0,0,0,1,1,0,0.0,0.0,1,1,0,-1,-1,-1,5,0,80,99,97
855,506,1122,98,100,2,440,440,100,100,0,440,440,100,100,0,0.037679975492698865,0.05391606249361789,96,98,2,2,2,2,14,22,16,9,18
856,122,223,76,90,14,106,106,71,71,0,106,106,76,76,0,0.013479015623404473,0.013479015623404473,76,76,0,5,2,2,7,8,43,8,68
857,77,1717,65,100,35,44,78,49,72,23,44,78,55,72,17,0.006535280302256714,0.04346642159365533,60,95,35,1,3,2,4,8,79,57,18
858,38,654,50,100,50,82,92,48,52,4,38,92,50,61,11,0.0029612988869600733,0.009973110044589673,48,67,19,2,3,3,7,6,24,70,25
859,6,6,33,33,0,20,20,36,36,0,6,6,33,33,0,0.0012594029749140542,0.0012594029749140542,41,41,0,-1,4,4,4,1,78,71,66
860,6,6,29,29,0,29,29,33,33,0,6,6,29,29,0,0.00017018959120460194,0.00017018959120460194,33,33,0,-1,4,4,9,1,28,55,85
861,58,264,59,93,34,72,76,59,59,0,58,76,61,64,3,0.006126825283365669,0.010619830491167161,55,69,14,3,2,2,6,3,69,54,72
862,0,1640,1,100,99,0,72,1,79,78,0,72,1,79,78,0.0,0.05575411007862759,1,97,96,1,-1,2,3,0,66,96,1
863,0,0,1,1,0,0,0,1,1,0,0,0,1,1,0,0.0,0.0,1,1,0,-1,-1,-1,10,0,1,93,97
864,132,732,84,100,16,88,88,77,77,0,88,88,77,77,0,0.017087034956942034,0.040709350216140784,82,93,11,2,2,2,4,8,79,8,1
865,74,280,60,95,35,100,100,66,66,0,68,80,58,60,2,0.006024711528642908,0.006297014874570271,55,55,0,3,2,2,6,6,51,41,56
866,192,792,88,100,12,210,210,81,81,0,210,210,91,91,0,0.011913271384322134,0.023690391095680587,69,87,18,2,2,2,12,14,14,32,12
867,0,102,1,80,79,0,6,1,28,27,0,5,1,31,30,0.0,0.0009870996289866913,1,40,39,4,-1,5,3,0,87,82,43
868,16,16,45,45,0,38,38,57,57,0,16,16,44,44,0,0.0045270431260424114,0.0045270431260424114,54,54,0,-1,3,3,3,1,85,90,86
869,208,808,92,100,8,136,136,86,86,0,136,136,87,87,0,0.023520201504475986,0.034718676605738796,86,91,5,2,2,2,7,17,62,6,37
870,0,0,1,1,0,0,0,1,1,0,0,0,1,1,0,0.0,0.0,1,1,0,-1,-1,-1,8,1,10,45,98
871,2,1642,27,100,73,17,84,29,45,16,2,84,27,61,34,0.00010211375472276115,0.022703291466693896,30,83,53,1,5,2,9,1,54,55,18
872,12,628,37,100,63,18,28,36,42,6,12,28,37,48,11,0.0013274788113958951,0.007284114503556962,42,63,21,2,4,3,3,3,75,51,47
873,155,361,92,100,8,72,72,85,85,0,72,72,85,85,0,0.02277136730317574,0.026004969536063176,88,90,2,3,2,2,3,13,94,33,28
874,86,188,64,87,23,96,96,60,60,0,86,96,64,68,4,0.00803294870485721,0.008407365805507334,64,64,0,4,3,3,6,6,44,34,88
875,34,634,48,100,52,74,74,46,46,0,34,74,48,64,16,0.004322815616596889,0.013853432724054596,53,76,23,2,3,3,8,6,39,73,37
876,68,170,72,90,18,48,48,68,68,0,48,48,69,69,0,0.009360427516253106,0.009939072126348753,70,72,2,4,3,3,3,9,81,31,74
877,48,254,56,92,36,64,64,58,58,0,48,60,56,61,5,0.003880322679464924,0.005446066918547262,52,58,6,3,2,2,5,3,80,43,75
878,8,214,38,91,53,16,16,33,33,0,8,16,38,43,5,0.0004084550188910446,0.0011232513019503727,35,40,5,3,4,4,4,2,84,63,43
879,16,118,31,79,48,48,48,32,32,0,16,18,31,39,8,0.0002042275094455223,0.00030634126416828345,30,33,3,4,3,3,14,1,25,95,55
880,150,766,85,100,15,150,150,85,85,0,150,150,89,89,0,0.017121072875182955,0.02215868477483917,81,87,6,2,2,2,7,8,46,20,35
881,0,206,1,92,91,0,12,1,32,31,0,7,1,36,35,0.0,0.0014295925661186562,1,41,40,3,-1,4,4,0,78,85,52
882,16,16,36,36,0,68,68,45,45,0,16,16,36,36,0,0.001599782157323258,0.001599782157323258,40,40,0,-1,3,3,7,2,43,42,89
883,101,717,76,100,24,116,116,76,76,0,101,116,77,79,2,0.008645631233193778,0.02314578440382586,66,86,20,2,2,2,7,8,62,44,18
884,0,0,1,1,0,0,0,1,1,0,0,0,1,1,0,0.0,0.0,1,1,0,-1,-1,-1,5,0,63,80,97
885,182,182,88,88,0,242,242,80,80,0,182,182,88,88,0,0.010790020082371761,0.010790020082371761,68,68,0,-1,2,2,14,9,8,31,36
886,74,174,73,92,19,38,38,61,61,0,38,38,63,63,0,0.011777119711358454,0.012696143503863304,74,75,1,4,3,3,3,8,81,8,54
887,6,622,29,99,70,25,68,30,35,5,6,68,29,54,25,0.00010211375472276115,0.012015385139044895,30,73,43,2,4,3,11,1,5,60,12
888,1,103,25,81,56,3,6,25,29,4,1,6,25,31,6,3.4037918240920386e-05,0.003437829742332959,27,51,24,4,6,5,3,2,81,58,22
889,22,124,49,85,36,30,30,43,43,0,22,24,49,49,0,0.002144388849177984,0.004118588107151367,47,52,5,4,3,3,4,2,73,52,90
890,23,23,53,53,0,38,38,49,49,0,23,23,53,53,0,0.002314578440382586,0.002314578440382586,49,49,0,-1,3,3,3,4,87,64,76
891,162,368,88,98,10,128,128,90,90,0,128,128,90,90,0,0.01766567956703768,0.020524864699274992,79,84,5,3,2,2,5,13,63,33,73
892,152,253,88,95,7,118,118,75,75,0,118,118,81,81,0,0.013376901868681712,0.013444977705163553,74,74,0,5,3,3,8,14,39,14,78
893,100,100,61,61,0,100,100,44,44,0,100,100,61,61,0,0.030327785152660065,0.056468906361686916,90,99,9,1,1,1,12,9,6,39,7
894,187,393,89,98,9,128,128,92,92,0,128,128,92,92,0,0.020661016372238675,0.02294155689438034,83,85,2,3,2,2,5,15,50,19,73
895,0,206,1,89,88,0,42,1,32,31,0,42,1,51,50,0.0,0.007624493685966166,1,61,60,3,-1,4,9,0,29,96,14
896,0,101,1,84,83,0,2,1,24,23,0,1,1,24,23,0.0,0.0,1,1,0,5,-1,6,2,1,98,45,95
897,0,616,1,100,99,0,60,1,40,39,0,60,1,60,59,0.0,0.008101024541339052,1,65,64,2,-1,3,8,0,39,79,31
898,16,222,39,95,56,66,66,49,49,0,16,36,39,51,12,0.002586881786309949,0.007488342013002485,49,63,14,3,3,3,6,2,32,94,62
899,364,570,99,100,1,128,128,93,93,0,128,128,93,93,0,0.05051227066952585,0.05122706695258518,100,100,0,3,2,2,5,36,70,2,49
900,305,511,98,100,2,128,128,96,96,0,128,128,96,96,0,0.03465060076925695,0.036658837945471257,93,93,0,3,2,2,5,29,49,11,41
901,0,616,1,100,99,0,56,1,44,43,0,56,1,58,57,0.0,0.015725518227305217,1,81,80,2,-1,3,6,1,48,45,15
902,172,788,87,100,13,120,120,90,90,0,120,120,90,90,0,0.02757071377514551,0.03311889444841554,87,91,4,2,2,2,6,19,69,15,31
903,22,228,48,91,43,36,36,38,38,0,22,30,48,51,3,0.0013274788113958951,0.002484768031587188,40,47,7,3,3,3,5,3,61,51,52
904,2,103,29,83,54,6,6,29,29,0,2,2,29,29,0,0.00010211375472276115,0.0002042275094455223,30,32,2,5,5,5,3,1,75,65,60
905,0,0,1,1,0,0,0,1,1,0,0,0,1,1,0,0.0,0.0,1,1,0,-1,-1,-1,10,0,18,97,93
906,60,60,69,69,0,32,32,63,63,0,32,32,64,64,0,0.008747744987916539,0.008747744987916539,66,66,0,-1,3,3,2,7,86,48,96
907,0,0,1,1,0,0,0,1,1,0,0,0,1,1,0,0.0,0.0,1,1,0,-1,-1,-1,9,0,26,36,69
908,270,270,98,98,0,96,96,94,94,0,96,96,94,94,0,0.041185881071513664,0.041185881071513664,95,95,0,-1,2,2,3,27,85,10,80
909,108,708,85,100,15,48,48,73,73,0,48,48,75,75,0,0.017529527894074,0.03516116954287076,82,91,9,2,3,3,3,17,92,6,9
910,0,0,1,1,0,0,0,1,1,0,0,0,1,1,0,0.0,0.0,1,1,0,-1,-1,-1,6,1,48,50,97
911,314,314,96,96,0,150,150,90,90,0,150,150,91,91,0,0.03699921712788046,0.03699921712788046,94,94,0,-1,2,2,7,29,62,0,86
912,16,1656,36,100,64,52,116,41,73,32,16,116,36,80,44,0.0008169100377820892,0.03451444909629327,38,91,53,1,3,2,7,1,46,49,7
913,20,122,45,85,40,32,32,58,58,0,32,32,60,60,0,0.0022465026039007454,0.0023486163586235067,46,46,0,4,3,3,2,3,91,43,88
914,84,186,75,93,18,32,32,58,58,0,32,32,60,60,0,0.014466115252391163,0.015555328636100617,78,79,1,4,3,3,2,9,91,39,71
915,6,6,31,31,0,36,36,36,36,0,6,6,31,31,0,0.0013274788113958951,0.0013274788113958951,39,39,0,-1,4,4,6,1,48,71,45
916,134,235,82,92,10,230,230,89,89,0,134,135,82,84,2,0.00980292045338507,0.009939072126348753,70,71,1,5,2,2,12,7,3,21,78
917,8,8,37,37,0,26,26,36,36,0,8,8,37,37,0,0.00030634126416828345,0.00030634126416828345,34,34,0,-1,4,4,5,2,49,56,40
918,34,240,50,95,45,60,60,52,52,0,34,60,50,61,11,0.0031314884781646754,0.006126825283365669,50,56,6,3,3,3,5,6,45,70,35
919,12,218,37,95,58,28,28,34,34,0,12,28,37,50,13,0.0009870996289866913,0.006399128629293032,38,58,20,3,4,4,6,2,32,74,34
920,92,298,79,100,21,46,46,83,83,0,46,46,83,83,0,0.015317063208414174,0.018142210422410564,77,80,3,3,2,2,2,8,99,17,47
921,100,100,77,77,0,100,100,96,96,0,100,100,96,96,0,0.08369924095442323,0.08628612274073318,99,99,0,3,1,1,3,29,66,0,35
922,334,540,100,100,0,80,80,96,96,0,80,80,96,96,0,0.05745600599067361,0.06239150413560707,98,98,0,3,2,2,2,36,86,2,31
923,40,656,53,100,47,72,96,56,66,10,40,80,53,64,11,0.00353994349705572,0.011675005956635693,52,68,16,2,2,2,6,2,74,42,62
924,0,206,1,89,88,0,40,1,35,34,0,7,1,35,34,0.0,0.0012594029749140542,1,40,39,3,-1,4,8,0,57,98,61
925,46,147,63,89,26,22,22,49,49,0,22,22,53,53,0,0.004288777698355968,0.004288777698355968,54,54,0,6,3,3,2,6,90,28,68
926,161,777,94,100,6,32,32,67,67,0,32,32,68,68,0,0.028728002995336805,0.046223492971169886,90,95,5,2,3,3,2,29,97,1,6
927,0,102,1,84,83,0,3,1,26,25,0,2,1,26,25,0.0,0.00030634126416828345,1,33,32,4,-1,5,2,0,98,87,55
928,0,102,1,76,75,0,10,1,26,25,0,2,1,26,25,0.0,0.0002042275094455223,1,29,28,4,-1,5,8,1,39,45,55
929,461,1077,100,100,0,256,256,96,96,0,256,256,96,96,0,0.03625038292658021,0.039620136832431326,93,95,2,2,2,2,10,30,1,7,22
930,8,214,38,91,53,24,24,40,40,0,8,24,38,50,12,0.0018720855032506212,0.025936893699581333,44,88,44,3,4,4,4,2,84,83,3
931,100,100,64,64,0,100,100,57,57,0,100,100,65,65,0,0.020695054290479593,0.025936893699581333,83,87,4,3,1,1,8,1,10,90,24
932,0,616,1,100,99,0,52,1,35,34,0,28,1,43,42,0.0,0.0028591851322373124,1,45,44,2,-1,3,9,0,31,99,70
933,98,1738,60,100,40,222,266,74,86,12,98,186,60,89,29,0.006126825283365669,0.020014295925661188,58,81,23,1,2,2,14,4,8,22,27
934,135,751,84,100,16,200,200,74,74,0,135,185,84,90,6,0.008747744987916539,0.01330882603219987,67,72,5,2,2,2,12,8,6,57,26
935,72,688,56,100,44,142,142,78,78,0,72,142,56,81,25,0.006024711528642908,0.01592974573675074,57,75,18,2,2,2,8,6,27,70,33
936,1,1,26,26,0,5,5,26,26,0,1,1,26,26,0,0.0,0.0,1,1,0,-1,6,6,5,1,70,78,36
937,24,640,51,100,49,22,32,42,57,15,22,32,46,58,12,0.0026549576227917903,0.014261887742945642,50,78,28,2,3,3,2,3,68,54,14
938,430,1046,97,100,3,320,320,92,92,0,320,320,95,95,0,0.032029681064706085,0.0368971033731577,92,95,3,2,2,2,14,27,16,10,38
939,16,632,39,100,61,66,76,49,53,4,16,76,39,65,26,0.002586881786309949,0.01494264610776405,49,78,29,2,3,3,6,2,32,94,39
940,358,958,95,100,5,176,176,87,87,0,176,176,89,89,0,0.0348888661969434,0.04053916062493618,89,96,7,2,2,2,8,30,57,7,38
941,56,672,53,100,47,138,148,71,77,6,56,80,53,61,8,0.004629156880765172,0.00622893903808843,52,56,4,2,2,2,9,2,54,52,64
942,0,206,1,89,88,0,18,1,29,28,0,6,1,28,27,0.0,0.00034037918240920387,1,32,31,3,-1,4,10,0,12,59,88
943,200,406,88,98,10,180,180,93,93,0,200,180,93,93,0,0.015725518227305217,0.01858470335954253,78,81,3,3,2,2,8,8,30,8,73
944,220,836,91,100,9,192,192,94,94,0,192,192,94,94,0,0.019844106334456584,0.03437829742332959,83,93,10,2,2,2,9,18,29,5,18
945,0,616,1,100,99,0,38,1,36,35,0,38,1,47,46,0.0,0.00888389666088022,1,64,63,2,-1,3,6,0,71,98,33
946,100,100,62,62,0,100,100,43,43,0,100,100,62,62,0,0.0480955784744205,0.0480955784744205,96,96,0,-1,1,1,12,22,14,9,81
947,100,100,76,76,0,100,100,96,96,0,100,100,96,96,0,0.05589026175159127,0.06096191156948841,98,99,1,3,1,1,3,6,58,35,62
948,0,1640,1,100,99,0,56,1,83,82,0,56,1,84,83,0.0,0.06916504986555022,1,98,97,1,-1,2,2,0,98,36,23
949,112,112,76,76,0,262,262,84,84,0,112,112,76,76,0,0.008101024541339052,0.008101024541339052,63,63,0,-1,2,2,14,4,8,72,97
950,56,672,56,100,44,94,104,68,81,13,56,104,56,82,26,0.006262976956329351,0.0212056230640934,56,83,27,2,2,2,5,3,50,29,12
951,22,124,47,84,37,28,28,45,45,0,22,24,47,47,0,0.002484768031587188,0.0027911092957554717,47,48,1,4,3,3,3,2,60,52,42
952,20,20,49,49,0,28,28,44,44,0,20,20,49,49,0,0.0018040096667687805,0.0018040096667687805,44,44,0,-1,3,3,3,3,76,43,91
953,0,0,1,1,0,0,0,1,1,0,0,0,1,1,0,0.0,0.0,1,1,0,-1,-1,-1,2,1,91,50,36
954,2,618,26,100,74,10,64,27,38,11,2,60,26,55,29,0.0,0.009122162088566664,1,67,66,2,5,3,8,1,10,68,27
955,6,212,32,93,61,8,12,32,35,3,6,12,32,36,4,0.00030634126416828345,0.00704584907587052,33,60,27,3,4,4,2,1,68,4,44
956,116,322,79,95,16,114,114,67,67,0,114,114,79,79,0,0.00891793457912114,0.009598692943939549,68,70,2,3,3,3,9,13,35,24,63
957,2,618,27,100,73,9,56,28,43,15,2,56,27,57,30,3.4037918240920386e-05,0.013683243132849994,28,74,46,2,5,3,6,1,34,68,37
958,50,50,63,63,0,12,12,37,37,0,12,12,42,42,0,0.007011811157629599,0.007011811157629599,63,63,0,-1,4,4,2,9,99,31,93
959,122,224,81,93,12,110,110,86,86,0,110,110,86,86,0,0.01606589740971442,0.016542428265087308,78,79,1,4,2,2,6,9,69,39,74
960,0,0,1,1,0,0,0,1,1,0,0,0,1,1,0,0.0,0.0,1,1,0,-1,-1,-1,11,0,5,85,66
961,0,1640,1,100,99,0,128,1,71,70,0,128,1,82,81,0.0,0.03727152047380782,1,96,95,1,-1,2,9,0,35,89,11
962,104,704,80,100,20,50,50,45,45,0,50,50,56,56,0,0.010960209673576363,0.019980258007420267,74,83,9,2,3,3,5,14,45,32,33
963,100,100,77,77,0,72,72,77,77,0,72,72,77,77,0,0.009564655025698629,0.009564655025698629,72,72,0,-1,2,2,3,6,82,13,36
964,0,616,1,100,99,0,50,1,34,33,0,17,1,40,39,0.0,0.0016678579938050988,1,42,41,2,-1,3,10,1,1,45,61
965,112,112,75,75,0,102,102,68,68,0,112,112,78,78,0,0.013104598522754349,0.013104598522754349,75,75,0,-1,3,3,7,8,43,20,87
966,2,208,28,91,63,12,22,30,33,3,2,8,28,34,6,0.00017018959120460194,0.0021784267674189047,31,44,13,3,5,4,7,1,62,55,46
967,122,328,79,94,15,176,176,74,74,0,122,129,79,81,2,0.009190237925048503,0.009496579189216788,64,67,3,3,2,2,12,8,2,44,56
968,12,628,36,100,64,32,56,34,44,10,12,56,36,57,21,0.0012934408931549745,0.01865277919602437,40,81,41,2,4,3,6,3,44,51,18
969,2,618,26,100,74,6,36,26,40,14,2,36,26,51,25,6.807583648184077e-05,0.006433166547533953,28,61,33,2,5,3,5,1,80,78,21
970,146,352,81,100,19,134,134,90,90,0,134,134,90,90,0,0.01412573606998196,0.020014295925661188,75,84,9,3,2,2,6,9,56,27,24
971,0,0,1,1,0,0,0,1,1,0,0,0,1,1,0,0.0,0.0,1,1,0,-1,-1,-1,5,0,45,59,76
972,414,1030,99,100,1,320,320,99,99,0,320,320,99,99,0,0.032914666938970015,0.03642057251778481,91,94,3,2,2,2,11,22,38,9,29
973,40,40,52,52,0,68,68,66,66,0,40,40,52,52,0,0.007318152421797883,0.007318152421797883,62,62,0,-1,2,2,4,1,53,90,96
974,180,796,89,100,11,158,158,83,83,0,158,158,87,87,0,0.017972020831205963,0.02375846693216243,81,85,4,2,2,2,9,17,31,6,38
975,331,531,99,100,1,96,96,93,93,0,96,96,93,93,0,0.04571292419755608,0.05156744613499439,96,96,0,3,2,2,3,40,66,3,27
976,8,624,35,100,65,42,64,35,41,6,8,47,35,54,19,0.0005105687736138058,0.006092787365124749,35,56,21,2,4,3,9,2,35,56,57
977,76,76,67,67,0,70,70,62,62,0,70,70,69,69,0,0.006603356138738555,0.006603356138738555,57,57,0,-1,3,3,5,6,45,13,59
978,16,616,39,100,61,68,68,43,43,0,16,68,39,62,23,0.002144388849177984,0.015112835698968652,46,78,32,2,3,3,8,2,57,94,23
979,32,648,47,100,53,80,94,45,47,2,32,72,47,57,10,0.0019741992579733825,0.006433166547533953,45,58,13,2,3,3,9,3,28,51,26
980,315,915,96,100,4,350,350,98,98,0,315,350,96,98,2,0.027264372510977228,0.03315293236665646,89,92,3,2,2,2,15,20,7,23,31
981,228,428,96,100,4,32,32,58,58,0,32,32,60,60,0,0.030566050580346504,0.0340719561591613,93,93,0,3,3,3,2,29,91,1,57
982,6,622,30,100,70,19,50,30,36,6,6,46,30,54,24,0.00017018959120460194,0.005514142755029102,30,55,25,2,4,3,8,1,21,60,26
983,12,12,34,34,0,34,34,34,34,0,12,12,34,34,0,0.0002382654276864427,0.0002382654276864427,32,32,0,-1,4,4,7,2,24,63,36
984,160,776,83,100,17,150,150,86,86,0,150,150,86,86,0,0.01851662752306069,0.03100854351747847,82,88,6,2,2,2,7,12,43,37,18
985,16,16,37,37,0,66,66,48,48,0,16,16,37,37,0,0.0037441710065012424,0.0037441710065012424,50,50,0,-1,3,3,6,1,48,90,59
986,102,1742,75,100,25,176,200,74,79,5,102,200,75,91,16,0.012253650566731339,0.033833690731474866,73,92,19,1,3,2,11,8,19,20,30
987,0,1640,1,100,99,0,80,1,61,60,0,80,1,64,63,0.0,0.03533135913407536,1,95,94,1,-1,2,6,1,71,45,7
988,6,6,33,33,0,8,8,33,33,0,6,6,33,33,0,0.00037441710065012424,0.00037441710065012424,35,35,0,-1,4,4,2,1,90,49,81
989,0,616,1,100,99,0,146,1,66,65,0,120,1,77,76,0.0,0.01415977398822288,1,74,73,2,-1,3,16,0,9,40,30
990,0,0,1,1,0,0,0,1,1,0,0,0,1,1,0,0.0,0.0,1,1,0,-1,-1,-1,3,0,60,91,84
991,0,206,1,94,93,0,12,1,31,30,0,6,1,29,28,0.0,0.002757071377514551,1,47,46,3,-1,4,2,0,91,96,90
992,0,206,1,91,90,0,36,1,35,34,0,16,1,38,37,0.0,0.00622893903808843,1,58,57,3,-1,4,6,0,44,85,62
993,1,207,26,92,66,8,20,26,32,6,1,10,26,36,10,3.4037918240920386e-05,0.0007488342013002485,26,38,12,3,6,4,8,2,21,58,64
994,52,258,65,99,34,22,22,54,54,0,22,22,54,54,0,0.005820484019197386,0.009122162088566664,60,67,7,3,3,3,2,6,99,13,54
995,0,616,1,100,99,0,54,1,35,34,0,32,1,47,46,0.0,0.003812246842983083,1,52,51,2,-1,3,10,0,1,79,28
996,493,1093,99,100,1,272,272,100,100,0,272,272,100,100,0,0.03897341638585384,0.05463085877667722,95,98,3,2,2,2,8,30,42,7,0
997,6,6,32,32,0,36,36,36,36,0,6,6,32,32,0,0.0009870996289866913,0.0009870996289866913,37,37,0,-1,4,4,6,1,44,71,93
998,162,264,85,94,9,194,194,78,78,0,162,164,85,85,0,0.010960209673576363,0.011130399264780965,69,69,0,4,2,2,11,9,19,31,4
999,100,100,61,61,0,100,100,44,44,0,100,100,61,61,0,0.023690391095680587,0.025290173253003846,86,88,2,3,1,1,12,13,6,24,94
