,FreeNet_pre_score,FreeNet_post_score,FreeNet_pre_rank,FreeNet_post_rank,FreeNet_delta_ranks,Reversed_pre_score,Reversed_post_score,Reversed_pre_rank,Reversed_post_rank,Reversed_delta_ranks,Independent_pre_score,Independent_post_score,Independent_pre_rank,Independent_post_rank,Independent_delta_ranks,Random_pre_score,Random_post_score,Random_pre_rank,Random_post_rank,Random_delta_ranks,dist_victim_relayer,dist_victim_vilain_pre,dist_victim_vilain_post,out_deg_victim,in_deg_villain,victim,villain,relayer
0,40,40,49,49,0,118,118,64,64,0,40,40,49,49,0,0.005446066918547262,0.005446066918547262,54,54,0,-1,2,2,9,1,54,90,86
1,53,155,54,85,31,70,70,56,56,0,70,70,63,63,0,0.005037611899656217,0.005173763572619898,53,53,0,4,3,3,5,6,37,35,65
2,22,228,46,96,50,38,38,47,47,0,22,38,46,52,6,0.0020422750944552232,0.003710133088260322,45,51,6,3,3,3,3,2,75,61,54
3,98,698,68,100,32,86,86,56,56,0,86,86,62,62,0,0.01405766023350012,0.030463936825623743,76,92,16,2,3,3,6,9,51,39,16
4,16,222,36,93,57,40,40,40,40,0,16,22,36,42,6,0.0004084550188910446,0.0027911092957554717,34,48,14,3,3,3,5,1,52,49,90
5,74,175,67,92,25,56,56,76,76,0,56,56,77,77,0,0.009734844616903231,0.00980292045338507,66,66,0,5,2,2,2,6,68,26,60
6,0,616,1,100,99,0,22,1,51,50,0,22,1,53,52,0.0,0.01844855168657885,1,82,81,2,-1,3,2,0,86,59,15
7,0,616,1,100,99,0,80,1,40,39,0,80,1,58,57,0.0,0.011777119711358454,1,70,69,2,-1,3,10,1,22,69,5
8,0,101,1,76,75,0,6,1,25,24,0,1,1,25,24,0.0,0.0002042275094455223,1,28,27,5,-1,6,6,0,71,79,55
9,100,100,78,78,0,100,100,97,97,0,100,100,97,97,0,0.09397869226318119,0.11480989822662446,100,100,0,2,1,1,3,30,96,7,11
10,0,101,1,74,73,0,11,1,25,24,0,1,1,25,24,0.0,0.00017018959120460194,1,30,29,5,-1,6,11,0,19,86,65
11,32,238,41,90,49,76,76,55,55,0,32,44,41,51,10,0.0028591851322373124,0.005446066918547262,42,53,11,3,3,3,6,2,51,52,29
12,156,362,85,97,12,162,162,80,80,0,156,162,86,86,0,0.013751318969331836,0.0158616699002689,77,78,1,3,2,2,9,8,28,8,41
13,100,100,67,67,0,100,100,74,74,0,100,100,75,75,0,0.08019333537560842,0.08019333537560842,100,100,0,-1,1,1,5,40,63,3,85
14,2,208,26,90,64,10,16,27,28,1,2,8,26,34,8,3.4037918240920386e-05,0.00034037918240920387,26,33,7,3,5,4,8,1,30,68,4
15,58,674,57,100,43,74,104,64,87,23,58,104,57,87,30,0.005105687736138058,0.03427618366860683,54,90,36,2,2,2,5,3,88,54,11
16,0,616,1,99,98,0,126,1,62,61,0,126,1,79,78,0.0,0.023418087749753225,1,87,86,2,-1,3,11,0,33,92,11
17,491,1091,98,100,2,248,248,99,99,0,248,248,99,99,0,0.03604615541713469,0.041390108580959185,91,95,4,2,2,2,8,29,42,1,25
18,110,726,74,100,26,154,154,72,72,0,110,154,74,84,10,0.010517716736444398,0.01776779332176044,66,78,12,2,2,2,10,7,11,21,77
19,100,100,63,63,0,100,100,39,39,0,100,100,63,63,0,0.02661765206439974,0.02661765206439974,88,88,0,-1,1,1,14,13,17,33,67
20,62,678,55,100,45,134,134,63,63,0,62,106,55,75,20,0.003982436434187685,0.008679669151434699,53,67,14,2,2,2,10,3,18,54,48
21,176,776,90,100,10,232,232,95,95,0,176,232,90,96,6,0.01763164164879676,0.03209775690118792,83,90,7,2,2,2,10,9,36,39,16
22,104,720,82,100,18,112,112,95,95,0,112,112,95,95,0,0.021035433472888797,0.027604751693386432,84,90,6,2,2,2,4,5,73,25,72
23,120,326,82,97,15,70,70,67,67,0,70,70,71,71,0,0.01756356581231492,0.01923142380612002,79,80,1,3,3,3,5,17,70,6,94
24,22,228,45,91,46,42,42,40,40,0,22,42,45,53,8,0.0018040096667687805,0.006773545729943157,45,61,16,3,3,3,6,2,74,83,44
25,18,18,47,47,0,44,44,48,48,0,18,18,47,47,0,0.0018380475850097008,0.0018380475850097008,44,44,0,-1,3,3,4,2,83,61,76
26,0,206,1,92,91,0,40,1,33,32,0,6,1,28,27,0.0,0.0017018959120460194,1,42,41,3,-1,4,12,0,6,92,94
27,16,632,44,100,56,22,32,47,63,16,16,32,47,63,16,0.0030974505599237552,0.012662105585622384,50,74,24,2,3,3,2,2,89,94,72
28,56,672,52,100,48,76,86,54,62,8,56,86,52,66,14,0.004595118962524252,0.011130399264780965,50,71,21,2,2,2,6,2,56,74,44
29,1,207,26,94,68,3,14,26,33,7,1,14,26,40,14,0.0,0.019095272133156337,1,85,84,3,6,4,3,2,60,58,10
30,0,0,1,1,0,0,0,1,1,0,0,0,1,1,0,0.0,0.0,1,1,0,-1,-1,-1,3,0,82,80,67
31,0,616,1,100,99,0,102,1,54,53,0,78,1,53,52,0.0,0.008747744987916539,1,64,63,2,-1,3,16,0,4,96,8
32,96,302,74,98,24,88,88,81,81,0,88,88,81,81,0,0.01606589740971442,0.021341774737057083,77,85,8,3,2,2,4,8,73,20,44
33,393,593,98,100,2,192,192,93,93,0,192,192,94,94,0,0.03716940671908506,0.04149222233568195,94,96,2,3,2,2,9,30,35,7,44
34,100,100,64,64,0,100,100,57,57,0,100,100,65,65,0,0.020695054290479593,0.020695054290479593,83,83,0,-1,1,1,8,1,10,90,91
35,0,206,1,92,91,0,18,1,29,28,0,6,1,29,28,0.0,0.0005105687736138058,1,35,34,3,-1,4,8,0,21,86,49
36,0,206,1,89,88,0,38,1,33,32,0,24,1,44,43,0.0,0.005990673610401988,1,56,55,3,-1,4,9,0,26,82,34
37,505,1121,100,100,0,192,192,98,98,0,192,192,98,98,0,0.049184791858129955,0.055379692977977464,97,98,1,2,2,2,6,40,44,3,31
38,160,160,87,87,0,104,104,80,80,0,104,104,81,81,0,0.022124646856598252,0.022124646856598252,86,86,0,-1,2,2,5,16,63,18,99
39,16,632,35,100,65,108,118,58,60,2,16,118,35,82,47,0.002723033459273631,0.01494264610776405,47,75,28,2,3,3,13,2,13,94,30
40,22,1662,40,100,60,110,144,60,70,10,22,80,40,59,19,0.0020082371762143027,0.018142210422410564,44,80,36,1,3,2,10,2,11,61,72
41,56,56,53,53,0,100,100,66,66,0,56,56,53,53,0,0.006331052792811192,0.006331052792811192,60,60,0,-1,2,2,6,3,59,29,97
42,192,293,88,97,9,210,210,81,81,0,210,210,91,91,0,0.011913271384322134,0.011981347220803976,69,69,0,6,2,2,12,14,14,32,78
43,76,282,62,96,34,90,90,63,63,0,76,90,62,68,6,0.0088498587426393,0.012083460975526737,66,71,5,3,2,2,6,6,65,34,47
44,0,0,1,1,0,0,0,1,1,0,0,0,1,1,0,0.0,0.0,1,1,0,-1,-1,-1,6,0,51,93,84
45,0,102,1,76,75,0,19,1,25,24,0,2,1,25,24,0.0,6.807583648184077e-05,1,28,27,4,-1,5,17,0,20,76,95
46,68,1708,65,100,35,56,80,76,94,18,56,80,77,94,17,0.011845195547840293,0.07886585656421254,74,98,24,1,2,2,2,7,68,62,7
47,0,616,1,100,99,0,110,1,58,57,0,110,1,75,74,0.0,0.022635215630212056,1,85,84,2,-1,3,10,1,18,45,10
48,6,6,29,29,0,29,29,33,33,0,6,6,29,29,0,0.00017018959120460194,0.00017018959120460194,33,33,0,-1,4,4,9,1,28,55,36
49,0,206,1,93,92,0,14,1,33,32,0,14,1,40,39,0.0,0.003437829742332959,1,49,48,3,-1,4,3,0,60,91,35
50,2,1642,27,100,73,5,44,30,72,42,2,42,27,74,47,6.807583648184077e-05,0.034820790360461554,27,93,66,1,5,2,3,1,92,95,45
51,100,100,58,58,0,100,100,35,35,0,100,100,59,59,0,0.056434868443446,0.056434868443446,99,99,0,-1,1,1,17,36,20,2,80
52,225,431,94,99,5,152,152,94,94,0,152,152,94,94,0,0.021137547227611558,0.023520201504475986,86,89,3,3,2,2,5,15,52,19,73
53,0,206,1,88,87,0,18,1,30,29,0,9,1,33,32,0.0,0.0006807583648184077,1,36,35,3,-1,4,7,0,24,80,64
54,119,119,84,84,0,78,78,75,75,0,78,78,77,77,0,0.011709043874876613,0.011709043874876613,73,73,0,-1,2,2,4,13,77,24,84
55,88,189,59,86,27,164,164,73,73,0,88,89,59,60,1,0.007113924912352361,0.007182000748834201,59,59,0,5,2,2,10,7,18,62,58
56,270,270,98,98,0,96,96,94,94,0,96,96,94,94,0,0.041185881071513664,0.041185881071513664,95,95,0,-1,2,2,3,27,85,10,36
57,64,165,58,82,24,140,140,70,70,0,64,65,58,60,2,0.00622893903808843,0.00622893903808843,59,59,0,5,3,3,10,7,12,62,58
58,242,858,93,100,7,184,184,94,94,0,184,184,94,94,0,0.02467749072466728,0.028489737567650362,87,88,1,2,2,2,7,17,43,6,47
59,22,228,40,91,51,96,96,44,44,0,22,96,40,62,22,0.0016678579938050988,0.01327478811395895,42,75,33,3,3,3,11,2,38,74,6
60,0,0,1,1,0,0,0,1,1,0,0,0,1,1,0,0.0,0.0,1,1,0,-1,-1,-1,9,0,31,89,86
61,236,338,93,96,3,168,168,96,96,0,168,168,96,96,0,0.02569862827189489,0.02569862827189489,88,88,0,4,2,2,6,18,48,30,95
62,0,0,1,1,0,0,0,1,1,0,0,0,1,1,0,0.0,0.0,1,1,0,-1,-1,-1,8,0,15,84,82
63,132,748,84,100,16,88,88,77,77,0,88,88,77,77,0,0.017087034956942034,0.035705776234725484,82,93,11,2,2,2,4,8,79,8,9
64,100,100,67,67,0,100,100,70,70,0,100,100,71,71,0,0.0348888661969434,0.0348888661969434,93,93,0,-1,1,1,6,7,74,48,45
65,16,632,42,100,58,24,38,42,51,9,16,38,42,54,12,0.001157289220191293,0.015351101126655093,39,81,42,2,3,3,3,1,66,88,37
66,6,1646,29,100,71,15,102,29,65,36,6,98,29,67,38,3.4037918240920386e-05,0.020354675108070392,26,82,56,1,4,2,8,1,39,68,27
67,56,56,56,56,0,150,150,70,70,0,56,56,56,56,0,0.0053439531638245,0.0053439531638245,59,59,0,-1,2,2,11,3,38,29,50
68,16,222,40,97,57,20,28,44,44,0,16,28,40,51,11,0.0009530617107457708,0.015487252799618776,35,77,42,3,3,3,3,1,94,4,9
69,0,616,1,100,99,0,40,1,44,43,0,40,1,51,50,0.0,0.014670342761836687,1,78,77,2,-1,3,5,0,37,76,18
70,0,1640,1,100,99,0,58,1,46,45,0,47,1,52,51,0.0,0.01783586915824228,1,81,80,1,-1,2,6,0,41,96,54
71,0,0,1,1,0,0,0,1,1,0,0,0,1,1,0,0.0,0.0,1,1,0,-1,-1,-1,5,0,50,97,66
72,104,206,80,90,10,80,80,60,60,0,80,80,65,65,0,0.014772456516559448,0.014840532353041287,78,78,0,4,3,3,5,9,50,39,55
73,230,230,92,92,0,208,208,85,85,0,208,208,91,91,0,0.016270124919159943,0.016270124919159943,78,78,0,-1,2,2,10,14,18,14,89
74,102,302,87,100,13,46,46,87,87,0,46,46,88,88,0,0.019844106334456584,0.029715102624323496,84,90,6,3,2,2,2,14,97,32,39
75,100,100,69,69,0,100,100,66,66,0,100,100,75,75,0,0.03512713162462984,0.035603662480002726,93,94,1,3,1,1,6,9,51,27,49
76,0,616,1,100,99,0,42,1,35,34,0,42,1,49,48,0.0,0.012185574730249497,1,71,70,2,-1,3,6,0,56,67,18
77,14,14,42,42,0,24,24,40,40,0,14,14,42,42,0,0.0012934408931549745,0.0012934408931549745,41,41,0,-1,4,4,4,4,47,64,98
78,100,100,67,67,0,100,100,57,57,0,100,100,67,67,0,0.04309200449300521,0.06392321045644848,97,99,2,2,1,1,8,16,21,18,11
79,70,171,67,91,24,62,62,80,80,0,62,62,80,80,0,0.00789679703189353,0.007998910786616291,61,61,0,5,2,2,3,6,55,26,60
80,110,316,74,96,22,126,126,77,77,0,110,126,76,83,7,0.007420266176520644,0.016712617856291908,57,82,25,3,2,2,7,6,46,13,32
81,0,0,1,1,0,0,0,1,1,0,0,0,1,1,0,0.0,0.0,1,1,0,-1,-1,-1,2,0,91,59,92
82,0,102,1,76,75,0,6,1,28,27,0,2,1,28,27,0.0,6.807583648184077e-05,1,27,26,4,-1,5,5,0,49,92,4
83,166,366,89,96,7,84,84,66,66,0,84,84,70,70,0,0.014636304843595765,0.021239660982334322,80,84,4,3,2,2,5,14,61,14,8
84,14,14,42,42,0,24,24,40,40,0,14,14,42,42,0,0.0012934408931549745,0.0012934408931549745,41,41,0,-1,4,4,4,4,47,64,89
85,16,16,50,50,0,22,22,52,52,0,16,16,51,51,0,0.0031314884781646754,0.0031314884781646754,53,53,0,-1,3,3,2,3,86,46,91
86,237,237,95,95,0,72,72,80,80,0,72,72,80,80,0,0.03332312195786106,0.03332312195786106,93,93,0,-1,2,2,3,29,66,11,93
87,1,617,25,100,75,2,22,25,48,23,1,22,25,49,24,0.0,0.021954457265393648,1,88,87,2,6,3,2,1,93,78,7
88,297,399,97,100,3,88,88,81,81,0,88,88,81,81,0,0.03628442084482113,0.0370672929643623,94,94,0,4,2,2,4,29,73,1,71
89,24,24,47,47,0,44,44,49,49,0,24,24,47,47,0,0.0015317063208414173,0.0015317063208414173,43,43,0,-1,3,3,4,4,53,64,59
90,0,616,1,100,99,0,44,1,48,47,0,44,1,51,50,0.0,0.010007147962830594,1,69,68,2,-1,3,4,1,53,69,77
91,100,100,60,60,0,100,100,52,52,0,100,100,60,60,0,0.05051227066952585,0.050784574015453214,98,98,0,3,1,1,9,29,29,11,63
92,0,616,1,99,98,0,142,1,62,61,0,114,1,76,75,0.0,0.014806494434800367,1,77,76,2,-1,3,17,0,20,36,30
93,46,662,49,100,51,98,142,42,67,25,46,142,49,83,34,0.002552843868069029,0.022465026039007456,46,85,39,2,2,2,12,3,2,51,1
94,112,1712,78,100,22,252,252,85,85,0,112,252,78,90,12,0.008441403723748256,0.03686306545491678,64,95,31,1,2,2,14,4,25,38,7
95,100,100,68,68,0,100,100,63,63,0,100,100,68,68,0,0.04785731304673406,0.05898771231151503,98,100,2,2,1,1,6,16,41,18,12
96,16,16,32,32,0,46,46,31,31,0,16,16,32,32,0,0.0002723033459273631,0.0002723033459273631,31,31,0,-1,3,3,14,1,8,60,76
97,0,616,1,100,99,0,86,1,34,33,0,44,1,51,50,0.0,0.006024711528642908,1,56,55,2,-1,3,14,0,16,67,48
98,54,670,58,100,42,86,96,62,69,7,54,96,58,74,16,0.006569318220497634,0.020729092208720514,59,86,27,2,3,3,6,4,32,38,18
99,40,40,47,47,0,130,130,61,61,0,40,40,47,47,0,0.0014636304843595766,0.0014636304843595766,41,41,0,-1,2,2,16,2,9,42,81
100,39,655,53,100,47,38,48,59,72,13,38,48,62,74,12,0.005514142755029102,0.015725518227305217,56,81,25,2,3,3,3,4,92,22,17
101,88,704,68,100,32,78,88,73,76,3,88,88,77,77,0,0.010143299635794275,0.024439225296980838,73,86,13,2,2,2,4,4,79,38,12
102,46,1686,53,100,47,100,184,45,76,31,46,184,53,89,36,0.0026549576227917903,0.03465060076925695,47,93,46,1,2,2,11,2,19,74,11
103,86,292,62,95,33,216,216,82,82,0,86,92,62,63,1,0.004561081044283332,0.0053439531638245,53,54,1,3,2,2,13,6,13,70,42
104,0,206,1,95,94,0,8,1,32,31,0,6,1,32,31,0.0,0.003199564314646516,1,51,50,3,-1,4,2,0,89,67,90
105,77,178,63,90,27,86,86,56,56,0,86,86,65,65,0,0.00789679703189353,0.00803294870485721,64,64,0,5,3,3,6,8,48,44,60
106,274,274,96,96,0,144,144,88,88,0,144,144,89,89,0,0.03090642976275571,0.03090642976275571,91,91,0,-1,2,2,6,22,34,9,96
107,22,124,41,80,39,52,52,43,43,0,22,24,41,45,4,0.003710133088260322,0.0038462847612240037,53,53,0,4,3,3,6,2,34,75,88
108,0,616,1,100,99,0,80,1,37,36,0,32,1,47,46,0.0,0.006671431975220395,1,61,60,2,-1,3,13,0,13,82,25
109,0,616,1,100,99,0,46,1,47,46,0,46,1,53,52,0.0,0.017325300384628477,1,81,80,2,-1,3,5,0,49,66,16
110,10,10,41,41,0,18,18,38,38,0,10,10,41,41,0,0.0013274788113958951,0.0013274788113958951,41,41,0,-1,4,4,3,3,85,43,97
111,42,248,48,93,45,130,134,61,61,0,42,58,48,55,7,0.0013955546478777359,0.003778208924742163,41,53,12,3,2,2,14,2,8,56,41
112,0,206,1,94,93,0,14,1,31,30,0,14,1,40,39,0.0,0.005446066918547262,1,55,54,3,-1,4,3,0,96,99,24
113,0,206,1,91,90,0,21,1,28,27,0,6,1,28,27,0.0,0.0004765308553728854,1,34,33,3,-1,4,10,0,0,98,42
114,0,0,1,1,0,0,0,1,1,0,0,0,1,1,0,0.0,0.0,1,1,0,-1,-1,-1,6,1,65,50,79
115,419,419,98,98,0,168,168,93,93,0,168,168,94,94,0,0.038428809693999116,0.038428809693999116,92,92,0,-1,2,2,6,29,44,1,99
116,2,104,28,78,50,8,8,30,30,0,2,7,28,37,9,6.807583648184077e-05,0.002314578440382586,28,47,19,4,5,5,4,1,84,65,73
117,42,248,59,97,38,22,22,49,49,0,22,22,53,53,0,0.005718370264474625,0.012866333095067906,59,75,16,3,3,3,2,6,90,26,27
118,12,12,41,41,0,8,8,32,32,0,12,12,41,41,0,0.0013274788113958951,0.0013274788113958951,41,41,0,-1,4,4,2,2,95,61,45
119,8,214,35,91,56,36,40,35,35,0,8,18,35,41,6,0.00037441710065012424,0.0014295925661186562,34,41,7,3,4,4,8,2,30,63,43
120,432,638,100,100,0,176,176,99,99,0,176,176,99,99,0,0.05211205282684911,0.060417304877633686,97,97,0,3,2,2,5,36,63,2,14
121,100,100,71,71,0,100,100,76,76,0,100,100,77,77,0,0.059838660267538035,0.059838660267538035,98,98,0,-1,1,1,5,22,50,9,80
122,46,147,61,91,30,22,22,52,52,0,22,22,54,54,0,0.006024711528642908,0.006024711528642908,61,61,0,5,3,3,2,6,86,13,95
123,22,22,43,43,0,68,68,40,40,0,22,22,43,43,0,0.0020082371762143027,0.0020082371762143027,43,43,0,-1,3,3,8,2,15,83,93
124,20,122,48,87,39,18,18,48,48,0,18,18,49,49,0,0.0017359338302869397,0.004493005207801491,42,54,12,4,3,3,2,3,93,43,73
125,0,206,1,91,90,0,16,1,31,30,0,9,1,35,34,0.0,0.00088498587426393,1,37,36,3,-1,4,6,0,44,66,43
126,49,255,56,94,38,70,70,63,63,0,49,55,55,59,4,0.005037611899656217,0.006399128629293032,56,60,4,3,3,3,5,4,49,22,94
127,6,212,32,92,60,16,28,32,33,1,6,14,32,38,6,3.4037918240920386e-05,0.0013615167296368155,28,40,12,3,4,4,6,1,44,95,52
128,16,118,39,81,42,88,88,51,51,0,16,18,39,43,4,0.004322815616596889,0.004493005207801491,53,54,1,4,3,3,8,1,57,90,49
129,16,632,36,100,64,46,56,39,43,4,16,50,36,49,13,0.002723033459273631,0.008169100377820893,45,62,17,2,3,3,6,3,56,46,62
130,54,260,65,97,32,22,22,52,52,0,22,22,55,55,0,0.010449640899962559,0.027162258756254467,70,91,21,3,3,3,2,8,98,8,9
131,54,54,52,52,0,86,86,56,56,0,54,54,52,52,0,0.006569318220497634,0.006569318220497634,61,61,0,-1,3,3,6,4,59,38,87
132,22,638,43,100,57,54,68,37,39,2,22,46,43,52,9,0.0011232513019503727,0.003982436434187685,38,52,14,2,3,3,8,3,15,51,70
133,0,616,1,100,99,0,28,1,44,43,0,28,1,51,50,0.0,0.014023622315259198,1,76,75,2,-1,3,3,0,94,67,15
134,0,102,1,84,83,0,4,1,29,28,0,2,1,27,26,0.0,0.0014295925661186562,1,41,40,4,-1,5,2,0,93,96,94
135,2,618,29,100,71,9,36,30,40,10,2,36,29,50,21,0.00017018959120460194,0.008237176214302734,31,64,33,2,5,3,5,1,88,65,17
136,25,126,54,83,29,44,44,53,53,0,25,44,54,57,3,0.005071649817897137,0.005241839409101739,58,59,1,5,3,3,4,6,78,73,4
137,16,16,33,33,0,54,54,33,33,0,16,16,33,33,0,0.00034037918240920387,0.00034037918240920387,34,34,0,-1,3,3,10,1,0,4,99
138,16,16,36,36,0,38,38,35,35,0,16,16,36,36,0,0.0005786446100956465,0.0005786446100956465,37,37,0,-1,3,3,8,1,39,60,98
139,42,248,51,93,42,108,108,58,58,0,40,48,50,52,2,0.003437829742332959,0.006705469893461316,48,60,12,3,3,3,13,6,13,41,29
140,16,16,32,32,0,114,114,65,65,0,16,16,32,32,0,0.0026889955410327104,0.0026889955410327104,45,45,0,-1,3,3,9,3,29,46,45
141,94,94,76,76,0,38,38,57,57,0,38,38,59,59,0,0.01579359406378706,0.01579359406378706,79,79,0,-1,3,3,3,9,55,39,80
142,56,157,58,85,27,46,46,43,43,0,56,46,58,54,-4,0.005718370264474625,0.005854521937438306,53,54,1,5,3,3,6,6,69,13,60
143,304,404,98,100,2,158,158,95,95,0,158,158,95,95,0,0.03213179481942884,0.03274447734776541,92,92,0,4,2,2,6,22,59,9,43
144,0,206,1,94,93,0,28,1,33,32,0,28,1,50,49,0.0,0.006501242384015794,1,58,57,3,-1,4,6,0,32,91,48
145,16,118,43,82,39,28,28,46,46,0,16,18,43,46,3,0.0019741992579733825,0.002110350930937064,45,46,1,4,3,3,3,1,81,53,88
146,6,6,28,28,0,26,26,31,31,0,6,6,28,28,0,0.00037441710065012424,0.00037441710065012424,32,32,0,-1,4,4,9,1,31,4,40
147,145,761,87,100,13,80,80,71,71,0,80,80,72,72,0,0.02100139555464788,0.03921168181354028,83,96,13,2,3,3,5,16,49,18,7
148,66,272,64,98,34,32,32,58,58,0,32,32,60,60,0,0.006501242384015794,0.009632730862180468,58,66,8,3,3,3,2,6,91,28,73
149,100,100,69,69,0,100,100,57,57,0,100,100,69,69,0,0.03863303720344464,0.03863303720344464,95,95,0,-1,1,1,8,18,57,30,91
150,18,18,43,43,0,42,42,39,39,0,18,18,43,43,0,0.0013955546478777359,0.0013955546478777359,39,39,0,-1,3,3,6,2,59,74,85
151,0,0,1,1,0,0,0,1,1,0,0,0,1,1,0,0.0,0.0,1,1,0,-1,-1,-1,14,0,16,85,66
152,29,131,52,87,35,28,28,46,46,0,28,28,51,51,0,0.003642057251778481,0.004356853534837809,51,53,2,4,3,3,3,4,85,22,61
153,32,648,51,100,49,38,38,51,51,0,32,38,53,53,0,0.0053439531638245,0.020048333843902106,57,85,28,2,3,3,3,3,82,29,23
154,0,616,1,100,99,0,36,1,35,34,0,36,1,48,47,0.0,0.004833384390210695,1,52,51,2,-1,3,5,0,50,67,13
155,0,102,1,84,83,0,4,1,28,27,0,2,1,26,25,0.0,0.001157289220191293,1,38,37,4,-1,5,2,1,98,50,53
156,126,332,81,96,15,120,120,80,80,0,120,120,81,81,0,0.015112835698968652,0.016338200755641786,76,77,1,3,2,2,6,8,34,20,53
157,22,228,45,92,47,40,40,44,44,0,22,40,45,50,5,0.0014636304843595766,0.006535280302256714,44,56,12,3,3,3,5,2,88,61,34
158,16,222,36,93,57,44,48,36,38,2,16,34,36,47,11,0.0005446066918547262,0.0035739814152966403,36,50,14,3,3,3,9,1,23,49,35
159,0,616,1,100,99,0,22,1,47,46,0,22,1,50,49,0.0,0.024983831988835564,1,88,87,2,-1,3,2,0,95,93,3
160,46,662,53,100,47,64,74,57,63,6,46,74,52,69,17,0.004935498144933456,0.0195377650702883,52,83,31,2,2,2,5,2,88,52,18
161,2,2,28,28,0,8,8,28,28,0,2,2,28,28,0,0.00013615167296368154,0.00013615167296368154,30,30,0,-1,5,5,5,1,45,65,67
162,0,206,1,92,91,0,36,1,35,34,0,36,1,50,49,0.0,0.020899281799925118,1,85,84,3,-1,4,6,1,65,45,0
163,0,0,1,1,0,0,0,1,1,0,0,0,1,1,0,0.0,0.0,1,1,0,-1,-1,-1,2,0,89,93,81
164,108,1748,79,100,21,60,84,55,74,19,60,84,60,75,15,0.013376901868681712,0.045644848361074235,74,97,23,1,3,2,5,13,70,33,5
165,53,155,61,89,28,38,38,56,56,0,38,38,57,57,0,0.006943735321147759,0.007794683277170768,60,65,5,4,3,3,3,8,60,57,64
166,182,782,88,100,12,242,242,80,80,0,182,204,88,90,2,0.010790020082371761,0.012764219340345145,68,72,4,2,2,2,14,9,8,31,70
167,86,86,59,59,0,126,126,69,69,0,86,86,59,59,0,0.009632730862180468,0.009632730862180468,66,66,0,-1,2,2,7,6,24,34,98
168,90,296,64,95,31,94,94,68,68,0,94,94,71,71,0,0.00891793457912114,0.013921508560536438,68,77,9,3,2,2,5,6,50,34,38
169,0,616,1,100,99,0,42,1,39,38,0,23,1,48,47,0.0,0.002825147213996392,1,49,48,2,-1,3,6,0,44,82,70
170,40,40,47,47,0,186,186,66,66,0,40,40,47,47,0,0.0025188059498281084,0.0025188059498281084,45,45,0,-1,2,2,16,1,4,53,76
171,0,616,1,100,99,0,86,1,34,33,0,44,1,51,50,0.0,0.006058749446883829,1,56,55,2,-1,3,14,0,16,40,48
172,32,648,46,100,54,116,136,60,63,3,32,136,46,78,32,0.002757071377514551,0.015146873617209572,49,74,25,2,3,3,11,2,5,52,30
173,0,1640,1,100,99,0,90,1,64,63,0,90,1,68,67,0.0,0.04493005207801491,1,96,95,1,-1,2,6,0,34,86,2
174,12,114,37,80,43,22,22,33,33,0,12,15,37,39,2,0.0011232513019503727,0.0014636304843595766,40,42,2,4,4,4,5,2,45,74,56
175,77,283,65,93,28,124,124,68,68,0,77,124,65,81,16,0.00789679703189353,0.009496579189216788,65,68,3,3,3,3,9,8,31,44,54
176,0,0,1,1,0,0,0,1,1,0,0,0,1,1,0,0.0,0.0,1,1,0,-1,-1,-1,4,0,78,98,40
177,0,1640,1,100,99,0,52,1,73,72,0,52,1,74,73,0.0,0.05163552197147622,1,97,96,1,-1,2,3,0,64,91,11
178,19,635,49,100,51,18,28,38,45,7,18,28,47,52,5,0.00439089145307873,0.017223186629905716,56,80,24,2,4,3,3,4,81,22,32
179,0,616,1,100,99,0,38,1,46,45,0,38,1,51,50,0.0,0.018822968787228972,1,85,84,2,-1,3,3,0,75,84,23
180,49,49,54,54,0,62,62,46,46,0,49,49,54,54,0,0.003914360597705844,0.003914360597705844,50,50,0,-1,3,3,7,4,62,22,59
181,84,700,66,100,34,64,74,61,70,9,64,74,64,71,7,0.009564655025698629,0.01678069369277375,66,79,13,2,2,2,5,9,49,31,77
182,14,116,45,85,40,12,12,35,35,0,12,12,42,42,0,0.002825147213996392,0.00445896728956057,50,54,4,4,4,4,2,6,98,70,83
183,6,622,31,100,69,17,44,31,38,7,6,44,31,52,21,6.807583648184077e-05,0.014398039415909322,30,76,46,2,4,3,7,1,62,65,15
184,6,108,30,78,48,24,25,32,33,1,6,8,30,34,4,0.00010211375472276115,0.0002382654276864427,30,31,1,4,4,4,9,1,35,65,88
185,45,147,61,88,27,32,32,64,64,0,32,32,64,64,0,0.004833384390210695,0.005616256509751864,56,60,4,4,3,3,2,6,89,28,71
186,122,738,80,100,20,66,76,51,58,7,66,76,62,65,3,0.0123557643214541,0.03066816433506927,74,89,15,2,3,3,6,14,34,14,9
187,0,206,1,89,88,0,24,1,30,29,0,24,1,43,42,0.0,0.005820484019197386,1,53,52,3,-1,4,6,0,71,67,48
188,24,230,47,95,48,34,34,39,39,0,24,34,47,50,3,0.0013274788113958951,0.0024507301133462676,41,47,6,3,3,3,4,3,53,43,61
189,6,212,29,87,58,49,54,33,33,0,6,18,29,40,11,0.00037441710065012424,0.0006467204465774873,34,36,2,3,4,4,11,1,5,88,56
190,2,208,28,92,64,11,16,29,31,2,2,12,28,35,7,0.00017018959120460194,0.002757071377514551,31,48,17,3,5,4,6,1,44,55,73
191,16,117,43,81,38,30,30,45,45,0,16,17,44,49,5,0.0007488342013002485,0.0010211375472276116,38,38,0,5,3,3,4,2,77,42,65
192,94,94,62,62,0,120,120,77,77,0,94,94,63,63,0,0.006739507811702236,0.006739507811702236,57,57,0,-1,2,2,6,5,40,47,81
193,77,693,65,100,35,124,124,68,68,0,77,124,65,81,16,0.00789679703189353,0.01773375540351952,65,80,15,2,3,3,9,8,31,44,8
194,423,423,98,98,0,184,184,96,96,0,184,184,96,96,0,0.03516116954287076,0.03516116954287076,91,91,0,-1,2,2,7,29,46,1,96
195,16,222,36,91,55,88,96,42,43,1,16,52,36,55,19,0.0012253650566731338,0.004731270635487933,38,56,18,3,3,3,11,1,38,71,13
196,48,1648,55,100,45,90,90,58,58,0,48,90,55,67,12,0.0045270431260424114,0.0335613873855475,51,93,42,1,2,2,6,6,48,70,9
197,38,654,52,100,48,38,48,51,62,11,38,48,54,63,9,0.004799346471969774,0.018278362095374246,56,84,28,2,3,3,3,6,82,41,37
198,6,212,28,89,61,42,46,33,33,0,6,26,28,40,12,0.0002382654276864427,0.005037611899656217,30,52,22,3,4,4,9,1,29,88,62
199,0,616,1,100,99,0,18,1,47,46,0,18,1,49,48,0.0,0.008713707069675619,1,70,69,2,-1,3,2,0,90,99,44
200,0,616,1,100,99,0,56,1,45,44,0,56,1,57,56,0.0,0.027979168794036557,1,88,87,2,-1,3,6,0,74,86,3
201,0,102,1,79,78,0,9,1,30,29,0,3,1,31,30,0.0,0.00037441710065012424,1,33,32,4,-1,5,5,0,45,80,56
202,0,616,1,100,99,0,46,1,36,35,0,46,1,51,50,0.0,0.008679669151434699,1,63,62,2,-1,3,6,0,40,84,32
203,396,602,100,100,0,144,144,91,91,0,144,144,91,91,0,0.04394295244902822,0.04860614724803431,97,98,1,3,2,2,6,40,74,3,24
204,139,241,90,97,7,56,56,84,84,0,56,56,84,84,0,0.02467749072466728,0.02501786990707648,87,87,0,4,2,2,2,17,86,6,63
205,0,0,1,1,0,0,0,1,1,0,0,0,1,1,0,0.0,0.0,1,1,0,-1,-1,-1,10,0,22,99,69
206,6,622,32,100,68,12,22,35,51,16,6,22,32,54,22,0.0005105687736138058,0.008509479560230097,37,66,29,2,4,3,2,1,98,49,72
207,0,102,1,77,76,0,9,1,27,26,0,2,1,27,26,0.0,0.00017018959120460194,1,32,31,4,-1,5,8,0,57,92,60
208,405,1021,98,100,2,190,200,91,92,1,190,200,91,92,1,0.036590762108989414,0.055992375506314036,96,99,3,2,2,2,8,29,27,1,7
209,100,100,65,65,0,100,100,45,45,0,100,100,65,65,0,0.026209197045508698,0.026209197045508698,88,88,0,-1,1,1,10,8,12,17,97
210,379,579,100,100,0,80,80,95,95,0,80,80,95,95,0,0.05146533238027162,0.05960039483985159,98,98,0,3,2,2,2,40,68,3,39
211,12,628,37,100,63,12,22,32,41,9,12,22,37,44,7,0.0018380475850097008,0.009360427516253106,44,65,21,2,4,3,2,2,91,83,21
212,6,6,33,33,0,22,22,35,35,0,6,6,33,33,0,0.0006126825283365669,0.0006126825283365669,37,37,0,-1,4,4,5,2,49,42,91
213,6,6,27,27,0,52,52,35,35,0,6,6,27,27,0,0.0008169100377820892,0.0008169100377820892,38,38,0,-1,4,4,12,2,2,42,82
214,100,100,69,69,0,100,100,87,87,0,100,100,87,87,0,0.057013513053541645,0.057013513053541645,99,99,0,-1,1,1,4,18,83,30,36
215,72,278,71,100,29,56,56,88,88,0,56,56,88,88,0,0.018006058749446885,0.02719629667449539,82,88,6,3,2,2,2,6,93,34,17
216,236,436,94,100,6,120,120,86,86,0,120,120,86,86,0,0.027536675856904592,0.02808128254875932,89,89,0,3,2,2,6,22,65,9,61
217,87,188,65,87,22,66,66,47,47,0,66,66,55,55,0,0.006433166547533953,0.006467204465774873,55,55,0,6,3,3,6,8,71,57,58
218,40,656,49,100,51,80,90,62,66,4,40,63,49,53,4,0.003165526396405596,0.007011811157629599,42,58,16,2,2,2,6,1,71,53,64
219,116,732,80,100,20,250,250,79,79,0,116,149,80,85,5,0.009462541270975866,0.01507879778072773,66,78,12,2,2,2,16,7,4,48,34
220,2,1642,27,100,73,12,148,27,77,50,2,148,27,85,58,0.0,0.04394295244902822,1,97,96,1,5,2,9,1,23,68,2
221,244,860,94,100,6,144,144,92,92,0,144,144,92,92,0,0.026753803737363423,0.030634126416828347,89,89,0,2,2,2,6,15,48,16,22
222,12,628,40,100,60,20,44,35,47,12,12,44,40,57,17,0.002110350930937064,0.02413288403281255,47,87,40,2,4,3,4,2,47,83,0
223,214,830,92,100,8,102,112,93,96,3,102,112,93,96,3,0.02644746247319514,0.04523639334218319,88,96,8,2,2,2,4,16,84,12,9
224,32,238,46,91,45,86,86,42,42,0,32,40,46,49,3,0.002586881786309949,0.0036760951700194017,47,51,4,3,3,3,11,2,5,75,83
225,0,1640,1,100,99,0,76,1,45,44,0,64,1,55,54,0.0,0.015521290717859695,1,77,76,1,-1,2,9,0,35,91,26
226,134,750,81,100,19,150,150,84,84,0,134,150,82,86,4,0.011062323428299126,0.016542428265087308,70,80,10,2,2,2,7,7,24,21,57
227,100,100,69,69,0,100,100,76,76,0,100,100,76,76,0,0.055413730896218386,0.06521665134960346,100,100,0,2,1,1,5,20,80,23,39
228,0,0,1,1,0,0,0,1,1,0,0,0,1,1,0,0.0,0.0,1,1,0,-1,-1,-1,16,0,9,79,85
229,406,1006,100,100,0,192,192,99,99,0,192,192,99,99,0,0.046563872153579086,0.053439531638245004,96,98,2,2,2,2,6,30,65,7,24
230,49,255,50,92,42,108,108,63,63,0,49,55,50,51,1,0.005003573981415297,0.005377991082065421,53,55,2,3,3,3,8,4,27,22,56
231,224,224,88,88,0,238,238,82,82,0,224,224,88,88,0,0.023486163586235065,0.023486163586235065,85,85,0,-1,2,2,14,20,25,23,89
232,94,94,74,74,0,62,62,80,80,0,62,62,81,81,0,0.016712617856291908,0.016712617856291908,78,78,0,-1,2,2,3,15,94,19,84
233,0,206,1,96,95,0,8,1,33,32,0,8,1,39,38,0.0,0.007522379931243405,1,64,63,3,-1,4,2,0,93,86,21
234,100,100,73,73,0,100,100,94,94,0,100,100,94,94,0,0.0851628714387828,0.0851628714387828,100,100,0,-1,1,1,4,40,67,3,59
235,94,1734,62,100,38,152,176,78,84,6,94,176,62,88,26,0.006773545729943157,0.045644848361074235,59,97,38,1,2,2,8,6,42,26,2
236,0,616,1,100,99,0,34,1,34,33,0,18,1,40,39,0.0,0.003369753905851118,1,49,48,2,-1,3,6,0,65,79,29
237,2,618,26,100,74,6,28,26,36,10,2,18,26,42,16,6.807583648184077e-05,0.0034037918240920387,28,50,22,2,5,3,5,1,80,78,94
238,1,207,25,92,67,3,18,25,37,12,1,18,25,46,21,0.0,0.008305252050784574,1,64,63,3,6,4,3,2,85,58,77
239,128,334,80,96,16,120,120,79,79,0,120,120,81,81,0,0.015317063208414174,0.022499063957248374,80,86,6,3,2,2,6,9,44,39,27
240,6,212,29,88,59,28,44,31,33,2,6,13,29,34,5,0.00013615167296368154,0.0015317063208414173,28,41,13,3,4,4,10,1,22,60,61
241,112,728,74,100,26,198,208,83,88,5,112,128,74,76,2,0.008475441641989176,0.011402702610708328,63,74,11,2,2,2,10,4,0,72,94
242,0,0,1,1,0,0,0,1,1,0,0,0,1,1,0,0.0,0.0,1,1,0,-1,-1,-1,4,1,84,50,45
243,230,846,91,100,9,196,196,72,72,0,196,196,88,88,0,0.017427414139351238,0.022737329384934817,80,85,5,2,2,2,12,16,14,12,72
244,230,436,95,100,5,168,168,97,97,0,168,168,97,97,0,0.026004969536063176,0.028693965077095884,89,91,2,3,2,2,6,18,59,30,22
245,288,488,95,97,2,320,320,92,92,0,320,320,95,95,0,0.021614078082984444,0.02209060893835733,81,81,0,3,2,2,14,18,16,5,42
246,146,352,83,98,15,110,110,77,77,0,110,110,81,81,0,0.015589366554341537,0.01589570781850982,79,79,0,3,2,2,6,14,74,14,4
247,0,206,1,91,90,0,50,1,35,34,0,26,1,43,42,0.0,0.0048674223084516155,1,56,55,3,-1,4,9,1,31,45,25
248,100,100,63,63,0,100,100,45,45,0,100,100,63,63,0,0.0597705844310562,0.060689608223561044,100,100,0,4,1,1,11,40,19,3,71
249,120,736,77,100,23,132,132,72,72,0,120,132,78,78,0,0.008271214132543654,0.013921508560536438,63,73,10,2,2,2,8,6,27,13,62
250,40,246,51,95,44,80,80,56,56,0,40,80,51,64,13,0.0045270431260424114,0.00970080669866231,52,67,15,3,2,2,6,2,65,94,21
251,1,207,25,94,69,3,14,25,31,6,1,14,25,40,15,3.4037918240920386e-05,0.004663194799006093,29,52,23,3,6,4,3,1,96,78,31
252,114,314,78,95,17,100,100,49,49,0,114,100,78,66,-12,0.00803294870485721,0.01232172640321318,66,71,5,3,3,3,9,9,54,31,38
253,34,240,53,92,39,54,54,55,55,0,34,54,53,59,6,0.007488342013002485,0.013683243132849994,62,73,11,3,3,3,4,7,84,62,25
254,6,1646,29,100,71,29,156,31,71,40,6,156,29,85,56,0.0002042275094455223,0.030225671397937304,31,90,59,1,4,2,12,1,3,65,11
255,110,726,72,100,28,154,174,66,71,5,110,174,72,86,14,0.010313489226998877,0.01933353756084278,72,84,12,2,2,2,10,6,0,34,17
256,62,164,54,85,31,102,102,64,64,0,62,65,54,57,3,0.0024507301133462676,0.002723033459273631,46,49,3,4,2,2,8,4,30,64,63
257,34,34,55,55,0,44,44,53,53,0,34,34,55,55,0,0.003880322679464924,0.003880322679464924,54,54,0,-1,3,3,4,6,78,70,76
258,262,262,92,92,0,216,216,95,95,0,216,216,95,95,0,0.026243234963749616,0.026243234963749616,86,86,0,-1,2,2,9,17,54,6,50
259,85,85,56,56,0,198,198,69,69,0,85,85,56,56,0,0.00616086320160659,0.00616086320160659,57,57,0,-1,2,2,14,6,16,35,81
260,91,297,65,94,29,122,122,74,74,0,91,122,65,80,15,0.008237176214302734,0.009428503352734947,65,67,2,3,2,2,8,8,57,44,54
261,62,164,64,89,25,44,44,53,53,0,44,44,58,58,0,0.010994247591817285,0.01157289220191293,74,74,0,4,3,3,4,8,78,20,51
262,68,268,57,94,37,110,110,78,78,0,68,110,58,81,23,0.008679669151434699,0.011845195547840293,66,71,5,3,2,2,6,4,51,72,62
263,22,22,47,47,0,28,28,45,45,0,22,22,47,47,0,0.002484768031587188,0.002484768031587188,47,47,0,-1,3,3,3,2,60,52,40
264,168,374,90,99,9,72,72,80,80,0,72,72,80,80,0,0.020082371762143027,0.02808128254875932,84,91,7,3,2,2,3,18,66,5,27
265,8,208,35,92,57,28,28,34,34,0,8,26,35,44,9,0.0005105687736138058,0.005854521937438306,33,54,21,3,4,4,6,2,56,63,22
266,63,269,71,100,29,32,32,69,69,0,32,32,69,69,0,0.006773545729943157,0.009530617107457708,64,70,6,3,3,3,2,8,90,57,41
267,264,880,96,100,4,112,112,93,93,0,112,112,93,93,0,0.03264236359304265,0.03621634500833929,92,93,1,2,2,2,4,22,47,9,41
268,275,377,94,99,5,246,246,95,95,0,246,246,96,96,0,0.018857006705469893,0.019095272133156337,79,80,1,4,2,2,10,15,22,19,55
269,54,156,58,89,31,76,76,54,54,0,54,58,58,59,1,0.006841621566424997,0.007726607440688927,61,64,3,4,3,3,6,7,32,62,51
270,22,124,38,76,38,62,62,35,35,0,22,24,38,42,4,0.0004765308553728854,0.0005105687736138058,35,35,0,4,3,3,10,2,0,63,65
271,37,243,56,94,38,34,34,44,44,0,34,34,52,52,0,0.003982436434187685,0.009598692943939549,53,68,15,3,3,3,4,6,47,35,34
272,6,108,29,77,48,26,26,30,30,0,6,8,29,34,5,0.0002382654276864427,0.00037441710065012424,32,32,0,4,4,4,9,1,23,4,78
273,265,1905,98,100,2,72,96,85,93,8,72,96,85,93,8,0.03948398515946765,0.09591885360291365,95,100,5,1,2,2,3,30,94,7,2
274,44,44,60,60,0,12,12,37,37,0,12,12,41,41,0,0.009156200006807584,0.009156200006807584,69,69,0,-1,4,4,2,8,89,8,98
275,100,100,79,79,0,100,100,98,98,0,100,100,98,98,0,0.09074509003029375,0.09074509003029375,99,99,0,-1,1,1,2,15,68,19,91
276,0,101,1,84,83,0,2,1,24,23,0,1,1,24,23,0.0,0.0004084550188910446,1,35,34,5,-1,6,2,0,93,59,42
277,377,1977,98,100,2,152,152,94,94,0,152,152,94,94,0,0.03832669593927635,0.061472480343102216,94,98,4,1,2,2,5,29,52,11,14
278,52,258,50,94,44,62,66,48,49,1,50,66,50,60,10,0.003880322679464924,0.017052997038701112,49,78,29,3,3,3,6,6,56,41,12
279,12,218,44,97,53,12,12,35,35,0,12,12,42,42,0,0.002552843868069029,0.010143299635794275,47,70,23,3,4,4,2,2,98,75,20
280,0,616,1,100,99,0,88,1,50,49,0,88,1,64,63,0.0,0.02474556656114912,1,86,85,2,-1,3,8,0,57,87,10
281,48,254,58,93,35,58,58,69,69,0,48,58,59,69,10,0.007658531604207087,0.008237176214302734,64,65,1,3,2,2,4,4,84,64,43
282,314,314,95,95,0,264,264,93,93,0,264,264,93,93,0,0.02314578440382586,0.02314578440382586,85,85,0,-1,2,2,12,19,3,15,80
283,100,100,65,65,0,100,100,47,47,0,100,100,65,65,0,0.023179822322066782,0.024200959869294394,84,84,0,3,1,1,11,9,38,31,51
284,40,40,47,47,0,100,100,66,66,0,40,40,47,47,0,0.003608019333537561,0.003608019333537561,47,47,0,-1,2,2,6,1,51,53,99
285,101,307,81,98,17,54,54,55,55,0,54,54,60,60,0,0.016202049082678104,0.016882807447496512,79,81,2,3,3,3,4,12,73,37,42
286,22,228,45,94,49,40,40,43,43,0,22,28,45,51,6,0.0030293747234419145,0.004356853534837809,49,51,2,3,3,3,5,2,49,83,94
287,0,616,1,100,99,0,50,1,44,43,0,50,1,55,54,0.0,0.02913645801422785,1,89,88,2,-1,3,5,0,45,76,2
288,0,206,1,91,90,0,19,1,30,29,0,7,1,34,33,0.0,0.0010892133837094523,1,36,35,3,-1,4,6,0,56,79,61
289,44,660,59,100,41,38,48,51,62,11,38,48,54,63,9,0.006399128629293032,0.017427414139351238,61,81,20,2,3,3,3,4,82,38,14
290,6,212,29,94,65,15,32,29,34,5,6,32,29,49,20,0.00017018959120460194,0.008543517478471017,31,66,35,3,4,4,6,1,59,55,33
291,2,2,29,29,0,6,6,29,29,0,2,2,29,29,0,3.4037918240920386e-05,3.4037918240920386e-05,27,27,0,-1,5,5,3,1,75,95,93
292,267,473,98,100,2,88,88,82,82,0,88,88,82,82,0,0.03362946322202934,0.036454610436025735,93,93,0,3,2,2,4,29,72,11,90
293,97,1737,57,100,43,250,324,76,88,12,97,324,57,97,40,0.006909697402906838,0.03400388032267947,57,92,35,1,2,2,17,4,20,22,10
294,0,206,1,88,87,0,26,1,29,28,0,6,1,28,27,0.0,0.0008509479560230097,1,37,36,3,-1,4,10,0,11,40,71
295,219,219,93,93,0,112,112,96,96,0,112,112,96,96,0,0.02556247659893121,0.02556247659893121,87,87,0,-1,2,2,4,16,77,12,85
296,0,616,1,100,99,0,22,1,51,50,0,22,1,54,53,0.0,0.021682153919466287,1,88,87,2,-1,3,2,0,98,87,10
297,176,382,87,96,9,182,182,88,88,0,176,182,91,91,0,0.01507879778072773,0.02648150039143606,75,89,14,3,2,2,9,9,29,27,37
298,0,0,1,1,0,0,0,1,1,0,0,0,1,1,0,0.0,0.0,1,1,0,-1,-1,-1,5,0,45,40,81
299,22,228,43,94,51,40,40,40,40,0,22,40,43,49,6,0.0012934408931549745,0.007488342013002485,41,59,18,3,3,3,5,2,52,74,48
300,100,100,59,59,0,100,100,46,46,0,100,100,59,59,0,0.01940161339732462,0.026175159127267776,82,85,3,2,1,1,11,6,5,28,24
301,0,616,1,100,99,0,44,1,38,37,0,39,1,50,49,0.0,0.005616256509751864,1,55,54,2,-1,3,7,0,62,84,44
302,0,0,1,1,0,0,0,1,1,0,0,0,1,1,0,0.0,0.0,1,1,0,-1,-1,-1,6,0,32,97,87
303,16,222,40,97,57,28,28,45,45,0,16,28,40,51,11,0.002314578440382586,0.012696143503863304,46,75,29,3,3,3,3,1,94,53,5
304,362,962,95,100,5,224,224,99,99,0,224,224,99,99,0,0.03104258143571939,0.04894652643044351,90,99,9,2,2,2,8,22,27,9,0
305,298,400,98,100,2,112,112,95,95,0,112,112,95,95,0,0.03437829742332959,0.03495694203342523,93,93,0,4,2,2,4,22,73,9,74
306,44,44,55,55,0,48,48,54,54,0,48,48,56,56,0,0.006841621566424997,0.006841621566424997,57,57,0,-1,3,3,3,7,87,62,93
307,0,102,1,82,81,0,5,1,29,28,0,2,1,28,27,0.0,0.0007828721195411688,1,36,35,4,-1,5,3,1,60,69,71
308,180,282,93,98,5,80,80,94,94,0,80,80,94,94,0,0.028421661731168522,0.02913645801422785,91,91,0,4,2,2,2,16,91,12,74
309,2,618,29,100,71,14,40,29,37,8,2,18,29,44,15,3.4037918240920386e-05,0.002825147213996392,27,45,18,2,5,3,9,1,26,95,46
310,100,100,63,63,0,100,100,47,47,0,100,100,63,63,0,0.06630586473331292,0.06848429150073182,100,100,0,3,1,1,10,36,36,2,73
311,434,434,99,99,0,280,280,99,99,0,280,280,99,99,0,0.036080193335375606,0.036080193335375606,92,92,0,-1,2,2,10,27,1,10,67
312,118,118,87,87,0,46,46,82,82,0,46,46,82,82,0,0.018891044623710815,0.018891044623710815,81,81,0,-1,2,2,2,15,95,19,66
313,16,16,35,35,0,34,34,39,39,0,16,16,35,35,0,0.002144388849177984,0.002144388849177984,40,40,0,-1,3,3,4,2,67,94,89
314,22,22,40,40,0,122,122,55,55,0,22,22,40,40,0,0.002212464685659825,0.002212464685659825,42,42,0,-1,3,3,16,2,4,83,69
315,16,118,45,87,42,22,22,49,49,0,16,18,48,50,2,0.003948398515946765,0.004186663943633207,53,53,0,4,3,3,2,3,90,46,49
316,74,1714,68,100,32,72,96,77,91,14,72,96,79,91,12,0.008475441641989176,0.0629361108274618,65,98,33,1,2,2,3,6,96,26,10
317,414,1030,97,100,3,192,192,94,94,0,192,192,94,94,0,0.034684638687497875,0.04350045951189625,93,95,2,2,2,2,9,29,29,1,27
318,0,616,1,100,99,0,37,1,33,32,0,22,1,42,41,0.0,0.0024166921951053475,1,46,45,2,-1,3,10,0,1,97,75
319,100,100,61,61,0,100,100,43,43,0,100,100,61,61,0,0.016882807447496512,0.016882807447496512,75,75,0,-1,1,1,12,3,2,29,99
320,80,286,59,95,36,186,186,72,72,0,80,86,59,61,2,0.005922597773920147,0.008339289969025495,57,64,7,3,2,2,13,2,13,75,46
321,0,1640,1,100,99,0,122,1,58,57,0,76,1,55,54,0.0,0.01232172640321318,1,71,70,1,-1,2,15,0,7,59,21
322,0,206,1,93,92,0,20,1,34,33,0,14,1,41,40,0.0,0.0028591851322373124,1,49,48,3,-1,4,4,0,73,82,41
323,12,1652,38,100,62,50,84,40,45,5,12,68,38,59,21,0.001940161339732462,0.01674665577453283,42,80,38,1,4,2,9,2,26,75,28
324,126,126,79,79,0,238,238,78,78,0,126,126,79,79,0,0.010075223799312433,0.010075223799312433,66,66,0,-1,2,2,14,7,8,48,69
325,0,0,1,1,0,0,0,1,1,0,0,0,1,1,0,0.0,0.0,1,1,0,-1,-1,-1,12,1,2,45,87
326,66,66,61,61,0,80,80,68,68,0,66,66,66,66,0,0.010041185881071514,0.010041185881071514,69,69,0,-1,3,3,5,5,88,25,97
327,0,206,1,96,95,0,12,1,38,37,0,12,1,44,43,0.0,0.009632730862180468,1,67,66,3,-1,4,2,0,93,91,19
328,38,244,48,92,44,98,98,42,42,0,38,46,48,53,5,0.001497668402600497,0.002927260968719153,42,48,6,3,3,3,12,3,14,43,52
329,6,622,28,100,72,32,46,33,35,2,6,22,28,41,13,0.0007828721195411688,0.0025188059498281084,36,44,8,2,4,3,8,2,27,42,65
330,334,540,96,100,4,246,246,95,95,0,246,246,96,96,0,0.025290173253003846,0.02569862827189489,88,88,0,3,2,2,10,19,22,15,88
331,196,402,87,96,9,222,222,91,91,0,196,202,89,90,1,0.01330882603219987,0.014023622315259198,73,74,1,3,2,2,10,9,18,31,71
332,150,356,83,96,13,152,152,78,78,0,152,152,85,85,0,0.016372238673882704,0.01858470335954253,79,81,2,3,2,2,8,12,42,37,73
333,319,319,96,96,0,144,144,92,92,0,144,144,92,92,0,0.03264236359304265,0.03264236359304265,90,90,0,-1,2,2,6,29,48,11,80
334,22,638,41,100,59,70,92,37,40,3,22,77,41,58,17,0.0005446066918547262,0.011811157629599374,35,71,36,2,3,3,11,2,33,63,37
335,100,100,57,57,0,100,100,38,38,0,100,100,57,57,0,0.024064808196330712,0.025256135334762925,84,85,1,3,1,1,16,9,4,39,83
336,0,206,1,90,89,0,18,1,32,31,0,13,1,38,37,0.0,0.0012934408931549745,1,39,38,3,-1,4,5,0,80,79,64
337,0,0,1,1,0,0,0,1,1,0,0,0,1,1,0,0.0,0.0,1,1,0,-1,-1,-1,5,0,45,79,85
338,199,199,91,91,0,136,136,86,86,0,136,136,87,87,0,0.024507301133462677,0.024507301133462677,87,87,0,-1,2,2,7,15,62,16,40
339,39,245,55,97,42,22,22,42,42,0,22,22,45,45,0,0.003948398515946765,0.01589570781850982,51,80,29,3,3,3,2,4,91,22,6
340,154,360,91,100,9,48,48,73,73,0,48,48,75,75,0,0.021341774737057083,0.02205657102011641,84,86,2,3,3,3,3,19,92,15,61
341,0,616,1,100,99,0,100,1,44,43,0,100,1,63,62,0.0,0.022124646856598252,1,84,83,2,-1,3,10,0,18,80,11
342,158,758,86,100,14,84,84,71,71,0,84,84,72,72,0,0.012900371013308825,0.014568229007113924,74,75,1,2,2,2,5,14,80,32,43
343,16,632,39,100,61,76,86,54,61,7,16,86,39,67,28,0.002212464685659825,0.008169100377820893,48,64,16,2,3,3,6,1,32,53,57
344,146,1786,82,100,18,116,140,76,87,11,116,140,80,88,8,0.015283025290173252,0.03989244017835869,77,97,20,1,2,2,7,13,62,33,32
345,16,222,34,90,56,108,108,60,60,0,16,22,34,39,5,0.0019741992579733825,0.004186663943633207,43,53,10,3,3,3,8,1,42,53,46
346,0,206,1,92,91,0,54,1,34,33,0,8,1,35,34,0.0,0.0033016780693692774,1,50,49,3,-1,4,11,1,19,69,29
347,0,616,1,100,99,0,40,1,48,47,0,40,1,56,55,0.0,0.00980292045338507,1,67,66,2,-1,3,4,0,84,99,38
348,339,339,95,95,0,152,152,96,96,0,152,152,96,96,0,0.03720344463732598,0.03720344463732598,92,92,0,-1,2,2,5,29,80,11,86
349,0,0,1,1,0,0,0,1,1,0,0,0,1,1,0,0.0,0.0,1,1,0,-1,-1,-1,10,0,0,82,69
350,8,624,35,100,65,20,46,32,42,10,8,46,35,53,18,0.0008169100377820892,0.01834643793185609,38,79,41,2,4,3,6,2,69,74,15
351,0,101,1,84,83,0,2,1,24,23,0,1,1,24,23,0.0,0.0,1,1,0,6,-1,7,2,0,93,76,78
352,16,16,34,34,0,102,102,57,57,0,16,16,34,34,0,0.001497668402600497,0.001497668402600497,40,40,0,-1,3,3,12,1,6,71,59
353,100,100,61,61,0,100,100,44,44,0,100,100,61,61,0,0.023690391095680587,0.023690391095680587,86,86,0,-1,1,1,12,13,6,24,76
354,0,0,1,1,0,0,0,1,1,0,0,0,1,1,0,0.0,0.0,1,1,0,-1,-1,-1,9,0,26,40,96
355,166,782,86,100,14,148,158,78,81,3,148,158,85,86,1,0.015827631982027978,0.0228734810578985,76,84,8,2,2,2,9,14,35,14,17
356,0,616,1,99,98,0,68,1,35,34,0,47,1,51,50,0.0,0.004765308553728854,1,51,50,2,-1,3,11,0,33,59,57
357,100,100,63,63,0,100,100,47,47,0,100,100,63,63,0,0.016610504101569147,0.03876918887640832,81,94,13,2,1,1,10,2,36,58,10
358,0,1640,1,100,99,0,126,1,62,61,0,126,1,79,78,0.0,0.022533101875489295,1,85,84,1,-1,2,12,0,6,86,16
359,372,988,97,100,3,208,208,88,88,0,208,208,89,89,0,0.0340719561591613,0.04217298070050036,94,96,2,2,2,2,10,27,22,10,17
360,0,616,1,100,99,0,26,1,37,36,0,29,1,50,49,0.0,0.004322815616596889,1,52,51,2,-1,3,4,0,53,80,22
361,264,366,93,98,5,110,110,78,78,0,110,110,82,82,0,0.03104258143571939,0.03134892269988768,91,91,0,4,2,2,6,29,51,0,42
362,134,340,82,95,13,230,230,89,89,0,134,142,82,84,2,0.00980292045338507,0.010892133837094524,70,71,1,3,2,2,12,7,3,21,74
363,2,104,29,87,58,4,4,30,30,0,2,4,29,32,3,0.0002723033459273631,0.0010892133837094523,34,40,6,4,5,5,2,1,97,88,51
364,40,40,60,60,0,22,22,52,52,0,22,22,55,55,0,0.005616256509751864,0.005616256509751864,59,59,0,-1,3,3,2,5,98,47,87
365,24,126,50,88,38,22,22,49,49,0,22,22,53,53,0,0.002110350930937064,0.006773545729943157,46,65,19,4,3,3,2,3,90,54,34
366,224,430,88,96,8,300,300,91,91,0,224,230,88,89,1,0.01674665577453283,0.019469689233806462,74,78,4,3,2,2,14,8,25,8,90
367,121,1761,80,100,20,160,214,73,88,15,121,214,80,91,11,0.00793083495013445,0.033425235712583816,64,92,28,1,2,2,11,8,38,44,23
368,0,0,1,1,0,0,0,1,1,0,0,0,1,1,0,0.0,0.0,1,1,0,-1,-1,-1,5,0,63,96,97
369,6,622,29,100,71,14,40,30,39,9,6,40,29,49,20,0.00010211375472276115,0.00704584907587052,29,57,28,2,4,3,5,1,52,65,25
370,16,222,35,87,52,64,68,40,42,2,16,37,35,46,11,0.002314578440382586,0.00527587732734266,42,55,13,3,3,3,8,2,27,94,28
371,6,622,28,100,72,18,66,28,42,14,6,73,28,56,28,0.0002042275094455223,0.007794683277170768,29,61,32,2,4,3,8,1,27,95,44
372,0,206,1,92,91,0,38,1,32,31,0,13,1,36,35,0.0,0.0008169100377820892,1,37,36,3,-1,4,11,0,19,81,64
373,0,616,1,100,99,0,40,1,42,41,0,40,1,52,51,0.0,0.007590455767725246,1,63,62,2,-1,3,5,0,49,89,77
374,0,616,1,100,99,0,34,1,38,37,0,34,1,50,49,0.0,0.006467204465774873,1,57,56,2,-1,3,4,0,53,36,48
375,18,18,43,43,0,36,36,38,38,0,18,18,43,43,0,0.0018040096667687805,0.0018040096667687805,44,44,0,-1,3,3,5,2,61,83,99
376,40,40,47,47,0,64,64,40,40,0,40,40,47,47,0,0.004050512270669526,0.004050512270669526,49,49,0,-1,3,3,8,6,27,73,79
377,420,1020,98,100,2,320,320,95,95,0,320,320,96,96,0,0.03465060076925695,0.04646175839885633,93,97,4,2,2,2,14,27,17,10,30
378,0,616,1,100,99,0,32,1,34,33,0,32,1,48,47,0.0,0.004322815616596889,1,50,49,2,-1,3,5,0,50,84,28
379,0,206,1,92,91,0,42,1,36,35,0,42,1,49,48,0.0,0.008407365805507334,1,61,60,3,-1,4,7,0,46,99,32
380,2,1642,27,100,73,15,148,27,62,35,2,148,27,85,58,3.4037918240920386e-05,0.022430988120766535,27,82,55,1,5,2,13,1,13,68,15
381,150,350,90,100,10,72,72,87,87,0,72,72,87,87,0,0.027706865448109193,0.030804316008032948,89,90,1,3,2,2,3,17,55,6,13
382,6,212,29,90,61,32,36,34,35,1,6,12,29,35,6,0.0007488342013002485,0.0029612988869600733,38,47,9,3,4,4,8,2,10,42,46
383,0,206,1,91,90,0,14,1,29,28,0,6,1,28,27,0.0,0.00017018959120460194,1,32,31,3,-1,4,5,0,52,80,49
384,34,1674,46,100,54,78,132,44,71,27,34,132,46,78,32,0.0016678579938050988,0.029817216379046257,39,91,52,1,3,2,8,4,27,64,15
385,42,658,48,100,52,130,144,61,64,3,42,95,48,58,10,0.0013955546478777359,0.006637394056979475,41,59,18,2,2,2,14,2,8,56,57
386,329,929,96,100,4,128,128,92,92,0,128,128,92,92,0,0.035910003744171005,0.03992647809659961,93,94,1,2,2,2,5,29,50,11,77
387,129,335,83,98,15,96,96,74,74,0,96,96,74,74,0,0.016304162837400864,0.01746145205759216,79,79,0,3,3,3,6,15,69,19,53
388,74,274,60,94,34,100,100,66,66,0,74,100,60,71,11,0.006671431975220395,0.011334626774226489,59,72,13,3,2,2,6,6,44,26,34
389,0,0,1,1,0,0,0,1,1,0,0,0,1,1,0,0.0,0.0,1,1,0,-1,-1,-1,16,0,9,86,50
390,0,0,1,1,0,0,0,1,1,0,0,0,1,1,0,0.0,0.0,1,1,0,-1,-1,-1,14,0,8,67,96
391,236,336,98,100,2,56,56,88,88,0,56,56,88,88,0,0.037509785901494265,0.03795227883862623,94,95,1,4,2,2,2,30,93,7,71
392,0,0,1,1,0,0,0,1,1,0,0,0,1,1,0,0.0,0.0,1,1,0,-1,-1,-1,10,0,36,91,92
393,101,717,76,100,24,164,164,77,77,0,101,164,76,86,10,0.008271214132543654,0.01592974573675074,64,80,16,2,2,2,10,8,36,57,20
394,126,726,78,100,22,206,206,75,75,0,126,142,78,85,7,0.009292351679771264,0.015248987371932332,64,75,11,2,2,2,12,7,14,48,25
395,0,206,1,87,86,0,30,1,28,27,0,6,1,27,26,0.0,0.0004084550188910446,1,34,33,3,-1,4,16,0,9,92,49
396,145,761,86,100,14,102,112,93,93,0,102,112,93,93,0,0.023554239422716908,0.029749140542564417,85,89,4,2,2,2,4,12,78,37,22
397,100,100,62,62,0,100,100,48,48,0,100,100,62,62,0,0.06429762755709861,0.0763130126961435,100,100,0,2,1,1,10,36,11,2,15
398,28,28,50,50,0,34,34,43,43,0,28,28,50,50,0,0.001497668402600497,0.001497668402600497,42,42,0,-1,3,3,4,4,79,64,81
399,0,616,1,100,99,0,34,1,42,41,0,34,1,51,50,0.0,0.006875659484665918,1,61,60,2,-1,3,4,0,79,66,48
400,0,1640,1,100,99,0,144,1,60,59,0,144,1,78,77,0.0,0.031451036454610434,1,91,90,1,-1,2,10,0,0,99,7
401,342,542,96,100,4,176,176,99,99,0,176,176,99,99,0,0.039994553933081455,0.04094761564382722,93,93,0,3,2,2,5,27,80,10,75
402,83,283,71,98,27,64,64,68,68,0,64,64,70,70,0,0.01507879778072773,0.01834643793185609,79,80,1,3,3,3,4,9,78,39,34
403,28,234,44,91,47,88,88,47,47,0,28,88,44,60,16,0.0023486163586235067,0.010211375472276116,46,70,24,3,3,3,8,3,10,54,8
404,66,682,59,100,41,54,54,55,55,0,54,54,58,58,0,0.005718370264474625,0.010858095918853602,57,71,14,2,3,3,4,6,53,28,90
405,0,0,1,1,0,0,0,1,1,0,0,0,1,1,0,0.0,0.0,1,1,0,-1,-1,-1,9,0,35,87,76
406,76,692,62,100,38,76,76,57,57,0,76,76,61,61,0,0.005956635692161067,0.012117498893767658,58,68,10,2,3,3,6,6,74,13,72
407,2,1642,28,100,72,10,80,30,64,34,2,80,28,67,39,6.807583648184077e-05,0.0460873412982062,30,98,68,1,5,2,6,1,69,65,3
408,0,206,1,94,93,0,10,1,30,29,0,6,1,30,29,0.0,0.0012594029749140542,1,39,38,3,-1,4,3,0,66,79,53
409,22,228,45,91,46,38,42,39,39,0,22,30,45,49,4,0.0013615167296368155,0.002757071377514551,40,48,8,3,3,3,6,3,74,51,52
410,182,798,91,100,9,118,118,93,93,0,118,118,93,93,0,0.023996732359848873,0.030566050580346504,85,89,4,2,2,2,5,18,49,30,73
411,6,6,31,31,0,8,8,33,33,0,6,6,31,31,0,0.0025188059498281084,0.0025188059498281084,46,46,0,-1,4,4,2,3,99,46,36
412,6,212,29,93,64,37,42,34,35,1,6,14,29,35,6,0.0004084550188910446,0.0024507301133462676,34,44,10,3,4,4,9,1,23,88,83
413,62,164,56,86,30,132,132,64,64,0,62,64,56,56,0,0.0042547397801150485,0.00442492937131965,55,55,0,4,3,3,12,6,14,35,65
414,14,630,40,100,60,12,22,32,41,9,12,22,37,44,7,0.0012253650566731338,0.00888389666088022,39,66,27,2,4,3,2,4,91,64,72
415,160,261,88,92,4,94,94,72,72,0,94,94,73,73,0,0.019163347969638176,0.01923142380612002,83,83,0,6,2,2,5,16,80,12,68
416,100,100,64,64,0,100,100,44,44,0,100,100,64,64,0,0.02757071377514551,0.04448755914088294,89,96,7,1,1,1,13,13,13,33,31
417,100,100,77,77,0,100,100,97,97,0,100,100,97,97,0,0.08169100377820893,0.10279451308757956,100,100,0,2,1,1,3,30,55,7,10
418,2,2,26,26,0,18,18,28,28,0,2,2,26,26,0,0.0,0.0,1,1,0,-1,5,5,14,1,16,68,86
419,0,206,1,92,91,0,26,1,28,27,0,8,1,33,32,0.0,0.001055175465468532,1,37,36,3,-1,4,12,0,6,86,51
420,0,1640,1,100,99,0,112,1,61,60,0,112,1,77,76,0.0,0.028421661731168522,1,86,85,1,-1,2,8,0,42,93,9
421,152,768,84,100,16,88,88,73,73,0,88,88,74,74,0,0.01596378365499166,0.021137547227611558,80,86,6,2,2,2,4,13,83,33,47
422,73,279,59,94,35,154,154,72,72,0,73,79,59,59,0,0.006092787365124749,0.006501242384015794,60,60,0,3,2,2,10,4,11,22,49
423,0,102,1,82,81,0,5,1,29,28,0,3,1,31,30,0.0,0.0005786446100956465,1,33,32,4,-1,5,3,0,60,86,63
424,100,100,58,58,0,100,100,38,38,0,100,100,58,58,0,0.011334626774226489,0.021682153919466287,64,85,21,1,1,1,16,2,9,61,47
425,24,640,45,100,55,64,84,39,47,8,24,84,45,63,18,0.0017018959120460194,0.024098846114571634,44,85,41,2,3,3,9,3,23,43,11
426,63,63,61,61,0,60,60,48,48,0,60,60,61,61,0,0.006943735321147759,0.006943735321147759,62,62,0,-1,3,3,5,8,63,57,36
427,0,206,1,90,89,0,24,1,30,29,0,9,1,35,34,0.0,0.0009190237925048504,1,38,37,3,-1,4,8,1,39,45,64
428,196,812,90,100,10,136,136,98,98,0,136,136,98,98,0,0.02828551005820484,0.0402328193607679,87,93,6,2,2,2,4,18,79,30,14
429,190,190,88,88,0,204,204,86,86,0,190,190,88,88,0,0.013989584397018279,0.013989584397018279,75,75,0,-1,2,2,11,13,38,33,91
430,0,102,1,84,83,0,4,1,29,28,0,2,1,27,26,0.0,0.0002723033459273631,1,32,31,4,-1,5,2,1,93,50,4
431,16,16,34,34,0,112,112,58,58,0,16,16,34,34,0,0.002995336805200994,0.002995336805200994,49,49,0,-1,3,3,12,2,14,94,82
432,6,212,32,91,59,20,20,34,34,0,6,16,32,41,9,0.0012253650566731338,0.002144388849177984,41,44,3,3,4,4,4,1,79,71,64
433,8,624,35,100,65,32,52,37,46,9,8,52,35,57,22,0.00034037918240920387,0.007658531604207087,34,65,31,2,4,3,6,2,32,56,25
434,0,206,1,92,91,0,10,1,31,30,0,8,1,36,35,0.0,0.002280540522141666,1,43,42,3,-1,4,3,0,85,59,75
435,0,0,1,1,0,0,0,1,1,0,0,0,1,1,0,0.0,0.0,1,1,0,-1,-1,-1,3,0,75,66,81
436,190,390,94,100,6,56,56,84,84,0,56,56,85,85,0,0.03475271452397971,0.05020592940535757,94,97,3,3,2,2,2,27,98,10,7
437,100,100,69,69,0,100,100,55,55,0,100,100,69,69,0,0.04806154055617958,0.04806154055617958,96,96,0,-1,1,1,8,27,30,10,67
438,0,206,1,92,91,0,10,1,31,30,0,6,1,31,30,0.0,0.0009530617107457708,1,38,37,3,-1,4,3,0,64,93,71
439,0,616,1,100,99,0,80,1,44,43,0,64,1,57,56,0.0,0.010211375472276116,1,70,69,2,-1,3,9,0,31,97,20
440,0,616,1,100,99,0,56,1,46,45,0,56,1,59,58,0.0,0.015351101126655093,1,80,79,2,-1,3,6,0,32,84,16
441,6,212,32,92,60,18,18,35,35,0,6,18,32,47,15,0.0006467204465774873,0.012764219340345145,35,75,40,3,4,4,3,1,87,49,18
442,110,726,77,100,23,76,76,51,51,0,76,76,63,63,0,0.007488342013002485,0.011130399264780965,64,70,6,2,3,3,6,13,59,24,41
443,300,300,95,95,0,112,112,92,92,0,112,112,92,92,0,0.03192756730998332,0.03192756730998332,90,90,0,-1,2,2,4,22,83,9,93
444,46,46,49,49,0,128,128,59,59,0,46,46,50,50,0,0.0028932230504782326,0.0028932230504782326,49,49,0,-1,2,2,14,2,8,83,99
445,74,674,66,100,34,60,60,52,52,0,60,60,62,62,0,0.009870996289866912,0.035739814152966405,70,93,23,2,3,3,5,9,45,27,2
446,0,1640,1,100,99,0,102,1,65,64,0,102,1,75,74,0.0,0.03900745430409476,1,95,94,1,-1,2,8,0,10,98,23
447,8,8,38,38,0,24,24,38,38,0,8,8,38,38,0,0.0010211375472276116,0.0010211375472276116,39,39,0,-1,4,4,4,2,72,74,99
448,119,319,89,100,11,56,56,92,92,0,56,56,92,92,0,0.03277851526600633,0.04578100003403792,95,95,0,3,2,2,2,15,97,16,23
449,100,100,69,69,0,100,100,55,55,0,100,100,69,69,0,0.02375846693216243,0.03301678069369277,85,93,8,2,1,1,9,5,26,47,19
450,22,228,41,94,53,44,44,44,44,0,22,44,41,49,8,0.0024166921951053475,0.0068075836481840775,42,57,15,3,3,3,4,2,67,61,34
451,54,654,54,100,46,94,94,45,45,0,54,94,54,59,5,0.006467204465774873,0.015180911535450491,57,77,20,2,3,3,9,7,29,62,19
452,276,377,93,95,2,248,248,89,89,0,248,248,92,92,0,0.019707954661492902,0.019707954661492902,83,83,0,5,2,2,11,17,5,6,58
453,18,224,48,93,45,38,38,55,55,0,18,38,47,57,10,0.0017359338302869397,0.004322815616596889,41,54,13,3,3,3,3,2,76,61,22
454,6,6,31,31,0,18,18,36,36,0,6,6,31,31,0,0.0012253650566731338,0.0012253650566731338,40,40,0,-1,4,4,3,1,66,71,50
455,6,6,28,28,0,43,43,30,30,0,6,6,28,28,0,0.00017018959120460194,0.00017018959120460194,29,29,0,-1,4,4,16,1,4,65,89
456,0,616,1,100,99,0,52,1,40,39,0,52,1,50,49,0.0,0.011913271384322134,1,75,74,2,-1,3,7,0,46,87,12
457,0,616,1,100,99,0,44,1,48,47,0,44,1,54,53,0.0,0.032199870655910685,1,91,90,2,-1,3,4,0,79,40,2
458,0,616,1,100,99,0,26,1,45,44,0,16,1,44,43,0.0,0.0034037918240920387,1,52,51,2,-1,3,4,0,78,93,42
459,108,724,75,100,25,134,144,89,91,2,108,144,75,91,16,0.0088498587426393,0.022533101875489295,67,85,18,2,2,2,6,6,41,26,12
460,1,617,26,99,73,12,84,26,40,14,1,51,26,54,28,0.00010211375472276115,0.004288777698355968,27,54,27,2,6,3,12,1,14,78,47
461,0,206,1,91,90,0,45,1,31,30,0,12,1,31,30,0.0,0.0009530617107457708,1,37,36,3,-1,4,16,0,4,40,74
462,22,22,40,40,0,74,74,36,36,0,22,22,40,40,0,0.0013955546478777359,0.0013955546478777359,40,40,0,-1,3,3,12,2,3,74,97
463,184,390,90,100,10,88,88,71,71,0,88,88,71,71,0,0.021648116001225366,0.02818339630348208,87,92,5,3,2,2,4,16,53,18,24
464,14,14,43,43,0,18,18,38,38,0,14,14,43,43,0,0.002552843868069029,0.002552843868069029,47,47,0,-1,4,4,3,6,85,70,96
465,100,100,66,66,0,100,100,49,49,0,100,100,66,66,0,0.061268252833656695,0.061268252833656695,100,100,0,3,1,1,9,40,54,3,95
466,236,236,95,95,0,184,184,96,96,0,184,184,96,96,0,0.02644746247319514,0.02644746247319514,90,90,0,-1,2,2,7,20,46,23,36
467,0,0,1,1,0,0,0,1,1,0,0,0,1,1,0,0.0,0.0,1,1,0,-1,-1,-1,9,1,35,50,92
468,0,206,1,88,87,0,52,1,33,32,0,23,1,41,40,0.0,0.002927260968719153,1,48,47,3,-1,4,14,0,17,91,35
469,100,100,73,73,0,100,100,94,94,0,100,100,94,94,0,0.0851628714387828,0.08632016065897409,100,100,0,3,1,1,4,40,67,3,53
470,307,513,99,100,1,64,64,70,70,0,64,64,70,70,0,0.042070866945777594,0.04819769222914327,96,96,0,3,3,3,4,40,84,3,32
471,231,437,94,100,6,72,72,86,86,0,72,72,86,86,0,0.03761189965621702,0.04162837400864563,92,92,0,3,2,2,3,29,92,0,13
472,0,102,1,83,82,0,4,1,28,27,0,4,1,32,31,0.0,0.0013274788113958951,1,42,41,4,-1,5,2,1,86,69,75
473,33,33,54,54,0,12,12,39,39,0,12,12,45,45,0,0.00616086320160659,0.00616086320160659,59,59,0,-1,4,4,2,8,93,57,80
474,68,170,76,95,19,32,32,67,67,0,32,32,68,68,0,0.014534191088873005,0.014840532353041287,78,79,1,4,3,3,2,8,97,20,63
475,24,24,48,48,0,74,74,46,46,0,24,24,48,48,0,0.0020422750944552232,0.0020422750944552232,45,45,0,-1,3,3,8,3,57,54,59
476,100,100,62,62,0,100,100,45,45,0,100,100,62,62,0,0.025970931617822254,0.03077027808979203,86,88,2,2,1,1,12,8,3,17,35
477,60,676,65,100,35,44,54,59,61,2,44,54,63,67,4,0.004901460226692535,0.031280846863405834,53,92,39,2,3,3,4,5,72,47,1
478,16,222,36,90,54,52,52,40,40,0,16,52,36,51,15,0.0032336022328874367,0.010007147962830594,43,64,21,3,3,3,6,1,71,90,77
479,46,662,53,100,47,64,74,57,63,6,46,64,52,64,12,0.008577555396711936,0.012015385139044895,65,72,7,2,2,2,5,2,88,83,52
480,25,641,51,100,49,46,56,40,44,4,25,56,51,57,6,0.003880322679464924,0.011130399264780965,53,71,18,2,3,3,6,6,44,73,25
481,114,714,78,100,22,100,100,49,49,0,114,100,78,66,-12,0.00803294870485721,0.026992069165049867,66,88,22,2,3,3,9,9,54,31,1
482,66,272,66,96,30,54,54,55,55,0,54,54,60,60,0,0.009905034208107831,0.017427414139351238,67,81,14,3,3,3,4,6,84,77,17
483,0,0,1,1,0,0,0,1,1,0,0,0,1,1,0,0.0,0.0,1,1,0,-1,-1,-1,3,0,76,85,84
484,100,100,69,69,0,100,100,87,87,0,100,100,87,87,0,0.04649579631709724,0.055992375506314036,96,98,2,2,1,1,4,5,83,25,33
485,0,0,1,1,0,0,0,1,1,0,0,0,1,1,0,0.0,0.0,1,1,0,-1,-1,-1,6,0,51,99,97
486,100,100,71,71,0,100,100,76,76,0,100,100,77,77,0,0.06419551380237584,0.06569318220497634,99,99,0,3,1,1,5,29,50,0,94
487,26,232,50,93,43,40,40,44,44,0,26,32,50,51,1,0.00353994349705572,0.0053439531638245,50,57,7,3,3,3,5,6,70,73,83
488,210,416,97,100,3,22,22,54,54,0,22,22,54,54,0,0.02828551005820484,0.029612988869600735,92,94,2,3,3,3,2,29,99,1,64
489,82,698,69,100,31,64,64,70,70,0,64,64,70,70,0,0.011368664692467409,0.02028659927158855,69,82,13,2,3,3,4,8,84,20,31
490,16,222,37,94,57,46,46,41,41,0,16,46,37,50,13,0.0014636304843595766,0.008475441641989176,41,65,24,3,3,3,6,1,59,71,32
491,0,206,1,89,88,0,44,1,35,34,0,19,1,44,43,0.0,0.003710133088260322,1,51,50,3,-1,4,8,0,57,87,22
492,0,0,1,1,0,0,0,1,1,0,0,0,1,1,0,0.0,0.0,1,1,0,-1,-1,-1,11,0,38,76,81
493,340,956,97,100,3,182,182,87,87,0,182,182,92,92,0,0.033084856530174615,0.05480104836788182,91,99,8,2,2,2,9,29,23,11,0
494,0,206,1,88,87,0,30,1,33,32,0,14,1,34,33,0.0,0.002144388849177984,1,45,44,3,-1,4,7,0,24,97,70
495,100,100,63,63,0,100,100,47,47,0,100,100,63,63,0,0.04516831750570135,0.048878450593961675,95,96,1,2,1,1,10,20,36,23,29
496,0,0,1,1,0,0,0,1,1,0,0,0,1,1,0,0.0,0.0,1,1,0,-1,-1,-1,7,0,43,87,85
497,0,616,1,100,99,0,46,1,41,40,0,46,1,53,52,0.0,0.01415977398822288,1,80,79,2,-1,3,6,0,48,84,6
498,88,704,62,100,38,142,152,71,75,4,88,152,62,84,22,0.008135062459579971,0.01415977398822288,64,77,13,2,2,2,8,7,15,62,13
499,52,52,53,53,0,92,92,51,51,0,52,52,53,53,0,0.0026889955410327104,0.0026889955410327104,48,48,0,-1,2,2,8,3,15,43,79
500,16,16,34,34,0,90,90,46,46,0,16,16,34,34,0,0.003369753905851118,0.003369753905851118,52,52,0,-1,3,3,10,1,11,90,79
501,0,0,1,1,0,0,0,1,1,0,0,0,1,1,0,0.0,0.0,1,1,0,-1,-1,-1,12,0,2,91,50
502,167,267,92,98,6,56,56,86,86,0,56,56,86,86,0,0.025392287007726607,0.02552843868069029,87,87,0,5,2,2,2,19,95,15,4
503,0,206,1,94,93,0,14,1,36,35,0,14,1,42,41,0.0,0.007726607440688927,1,67,66,3,-1,4,3,0,81,93,8
504,0,0,1,1,0,0,0,1,1,0,0,0,1,1,0,0.0,0.0,1,1,0,-1,-1,-1,3,0,58,36,93
505,0,102,1,83,82,0,3,1,26,25,0,3,1,30,29,0.0,0.0016338200755641784,1,40,39,4,-1,5,2,0,99,79,75
506,157,157,91,91,0,72,72,77,77,0,72,72,79,79,0,0.023724429013921508,0.023724429013921508,89,89,0,-1,2,2,3,15,96,16,36
507,0,616,1,100,99,0,76,1,36,35,0,50,1,50,49,0.0,0.0045270431260424114,1,55,54,2,-1,3,12,0,3,87,47
508,48,664,51,100,49,184,194,72,73,1,48,92,52,60,8,0.0035739814152966403,0.008645631233193778,49,64,15,2,3,3,14,6,17,70,72
509,0,0,1,1,0,0,0,1,1,0,0,0,1,1,0,0.0,0.0,1,1,0,-1,-1,-1,5,0,63,82,89
510,6,622,30,100,70,19,58,30,42,12,6,58,30,56,26,0.00017018959120460194,0.012185574730249497,30,73,43,2,4,3,8,1,21,65,5
511,2,1642,26,100,74,10,118,27,70,43,2,118,26,79,53,0.0,0.039620136832431326,1,96,95,1,5,2,8,1,10,68,2
512,246,846,92,100,8,112,112,92,92,0,112,112,92,92,0,0.028455699649409444,0.0337315769767521,88,91,3,2,2,2,4,19,83,15,21
513,185,801,91,100,9,88,88,80,80,0,88,88,80,80,0,0.02491575615235372,0.032336022328874364,86,90,4,2,2,2,4,15,84,16,21
514,14,220,39,93,54,18,18,36,36,0,14,18,39,46,7,0.001940161339732462,0.004016474352428605,46,54,8,3,4,4,3,3,64,54,46
515,84,185,70,91,21,38,38,53,53,0,38,38,55,55,0,0.011300588855985567,0.011300588855985567,72,72,0,5,3,3,3,8,64,8,68
516,0,0,1,1,0,0,0,1,1,0,0,0,1,1,0,0.0,0.0,1,1,0,-1,-1,-1,4,0,79,36,86
517,162,162,86,86,0,192,192,86,86,0,162,162,87,87,0,0.01841451376833793,0.01841451376833793,81,81,0,-1,2,2,9,9,28,39,81
518,16,1656,33,100,67,56,90,41,54,13,16,90,33,61,28,0.00176997174852786,0.024166921951053473,41,87,46,1,3,2,6,1,40,71,20
519,6,622,32,100,68,36,46,36,39,3,6,46,32,56,24,0.0009870996289866913,0.015385139044896015,37,80,43,2,4,3,6,1,44,71,23
520,88,88,73,73,0,64,64,68,68,0,64,64,71,71,0,0.01245787807617686,0.01245787807617686,74,74,0,-1,3,3,4,13,72,33,99
521,0,206,1,90,89,0,21,1,32,31,0,10,1,35,34,0.0,0.0026549576227917903,1,46,45,3,-1,4,7,0,43,89,73
522,16,632,41,100,59,34,54,43,51,8,16,54,41,54,13,0.0008509479560230097,0.011606930120153852,38,73,35,2,3,3,4,1,83,71,17
523,6,622,27,100,73,18,45,28,34,6,6,24,27,42,15,0.0,0.0018040096667687805,1,40,39,2,4,3,12,1,2,68,74
524,282,282,96,96,0,288,288,97,97,0,288,288,97,97,0,0.026209197045508698,0.026209197045508698,88,88,0,-1,2,2,12,20,14,23,40
525,0,0,1,1,0,0,0,1,1,0,0,0,1,1,0,0.0,0.0,1,1,0,-1,-1,-1,16,0,4,85,69
526,72,72,67,67,0,38,38,46,46,0,38,38,51,51,0,0.008407365805507334,0.008407365805507334,63,63,0,-1,3,3,3,13,96,24,67
527,46,252,54,93,39,56,56,46,46,0,46,56,54,57,3,0.0045270431260424114,0.005582218591510943,54,56,2,3,3,3,6,6,74,28,64
528,190,292,89,95,6,318,318,91,91,0,190,192,89,89,0,0.01330882603219987,0.013547091459886314,74,75,1,4,2,2,16,9,4,27,55
529,0,206,1,91,90,0,20,1,29,28,0,20,1,40,39,0.0,0.008101024541339052,1,62,61,3,-1,4,4,0,67,76,33
530,8,214,38,94,56,8,8,33,33,0,8,8,38,38,0,0.0007828721195411688,0.004118588107151367,40,52,12,3,4,4,2,2,90,74,73
531,184,800,87,100,13,248,248,90,90,0,184,248,88,91,3,0.01330882603219987,0.030736240171551108,72,91,19,2,2,2,11,8,33,17,23
532,2,618,26,99,73,19,60,26,32,6,2,24,26,42,16,3.4037918240920386e-05,0.002110350930937064,26,43,17,2,5,3,17,1,20,68,52
533,86,187,62,88,26,216,216,82,82,0,86,86,62,62,0,0.004561081044283332,0.004595118962524252,53,53,0,5,2,2,13,6,13,70,68
534,2,103,27,74,47,7,7,29,29,0,2,3,27,29,2,0.0002382654276864427,0.0002382654276864427,32,32,0,5,5,5,4,1,83,55,68
535,0,1640,1,100,99,0,108,1,66,65,0,108,1,77,76,0.0,0.024983831988835564,1,86,85,1,-1,2,9,0,23,36,30
536,76,692,69,100,31,32,32,58,58,0,32,32,60,60,0,0.011062323428299126,0.037475747983253344,71,94,23,2,3,3,2,6,91,77,10
537,160,776,87,100,13,104,104,80,80,0,104,104,81,81,0,0.022124646856598252,0.02736648626569999,86,89,3,2,2,2,5,16,63,18,90
538,300,300,95,95,0,112,112,92,92,0,112,112,92,92,0,0.03192756730998332,0.03192756730998332,90,90,0,-1,2,2,4,22,83,9,45
539,0,616,1,100,99,0,64,1,62,61,0,64,1,63,62,0.0,0.027808979202831954,1,90,89,2,-1,3,4,0,79,84,1
540,0,101,1,75,74,0,5,1,24,23,0,1,1,24,23,0.0,0.00017018959120460194,1,30,29,5,-1,6,5,0,80,99,65
541,24,24,42,42,0,116,116,55,55,0,24,24,42,42,0,0.0020763130126961434,0.0020763130126961434,44,44,0,-1,3,3,14,3,17,54,67
542,122,328,79,94,15,176,176,74,74,0,122,176,79,84,5,0.009190237925048503,0.013649205214609075,64,70,6,3,2,2,12,8,2,44,57
543,108,108,79,79,0,60,60,55,55,0,60,60,60,60,0,0.012832295176826986,0.012832295176826986,73,73,0,-1,3,3,5,8,70,8,67
544,6,622,29,100,71,24,70,30,46,16,6,70,29,58,29,6.807583648184077e-05,0.00970080669866231,29,70,41,2,4,3,8,1,30,95,8
545,396,996,96,100,4,358,358,97,97,0,358,358,97,97,0,0.023520201504475986,0.0247115286429082,86,88,2,2,2,2,14,19,25,15,43
546,0,0,1,1,0,0,0,1,1,0,0,0,1,1,0,0.0,0.0,1,1,0,-1,-1,-1,4,0,53,85,79
547,464,670,100,100,0,400,400,100,100,0,400,400,100,100,0,0.03352734946730658,0.034310221586847746,94,94,0,3,2,2,16,29,9,0,51
548,100,100,79,79,0,100,100,97,97,0,100,100,97,97,0,0.05269069743694476,0.05269069743694476,98,98,0,-1,1,1,3,6,60,73,80
549,174,1814,83,100,17,298,332,85,91,6,174,332,83,99,16,0.012287688484972258,0.038530923448721874,68,94,26,1,2,2,16,7,9,48,10
550,0,1640,1,100,99,0,156,1,59,58,0,156,1,85,84,0.0,0.021375812655298,1,82,81,1,-1,2,16,0,4,80,15
551,46,662,48,100,52,134,144,60,62,2,46,70,48,53,5,0.0020422750944552232,0.003267640151128357,43,51,8,2,2,2,17,2,20,74,64
552,0,1640,1,100,99,0,128,1,69,68,0,128,1,79,78,0.0,0.03349331154906566,1,94,93,1,-1,2,9,0,29,85,7
553,22,124,53,84,31,32,32,63,63,0,22,32,54,63,9,0.004833384390210695,0.005888559855679227,57,60,3,4,3,3,2,3,86,29,53
554,0,102,1,74,73,0,25,1,27,26,0,2,1,25,24,0.0,0.0002382654276864427,1,31,30,4,-1,5,16,0,4,36,88
555,0,616,1,100,99,0,22,1,53,52,0,22,1,53,52,0.0,0.01409169815174104,1,75,74,2,-1,3,2,0,99,36,39
556,0,0,1,1,0,0,0,1,1,0,0,0,1,1,0,0.0,0.0,1,1,0,-1,-1,-1,6,0,44,86,59
557,0,616,1,100,99,0,28,1,42,41,0,28,1,49,48,0.0,0.013819394805813677,1,80,79,2,-1,3,3,0,75,85,12
558,423,1039,98,100,2,184,184,96,96,0,184,184,96,96,0,0.03516116954287076,0.0480955784744205,91,95,4,2,2,2,7,29,46,1,6
559,0,206,1,89,88,0,48,1,34,33,0,24,1,42,41,0.0,0.005650294427992784,1,57,56,3,-1,4,10,0,12,97,34
560,24,126,48,87,39,38,38,47,47,0,24,38,48,52,4,0.0027911092957554717,0.003369753905851118,49,50,1,4,3,3,3,3,75,54,74
561,100,100,58,58,0,100,100,35,35,0,100,100,59,59,0,0.022635215630212056,0.04588311378876068,86,98,12,1,1,1,17,8,20,17,9
562,0,616,1,100,99,0,22,1,46,45,0,22,1,51,50,0.0,0.010381565063480718,1,70,69,2,-1,3,2,0,89,59,77
563,22,638,40,100,60,96,106,44,58,14,22,44,40,54,14,0.0016678579938050988,0.004765308553728854,42,56,14,2,3,3,11,2,38,74,75
564,0,616,1,100,99,0,82,1,47,46,0,82,1,58,57,0.0,0.018754892950747133,1,81,80,2,-1,3,7,0,24,76,9
565,16,632,35,100,65,21,40,34,43,9,16,40,35,48,13,0.0005105687736138058,0.00789679703189353,33,62,29,2,3,3,4,1,67,65,48
566,0,102,1,79,78,0,9,1,30,29,0,2,1,27,26,0.0,0.00017018959120460194,1,30,29,4,-1,5,5,0,45,89,49
567,198,814,91,100,9,158,158,80,80,0,158,158,86,86,0,0.019707954661492902,0.03478675244222063,83,93,10,2,2,2,9,18,23,5,15
568,80,286,73,100,27,32,32,69,69,0,32,32,69,69,0,0.011811157629599374,0.015351101126655093,73,80,7,3,3,3,2,13,90,33,47
569,6,1646,29,100,71,37,108,34,66,32,6,108,29,77,48,0.0009190237925048504,0.02491575615235372,37,87,50,1,4,2,9,2,23,42,30
570,0,0,1,1,0,0,0,1,1,0,0,0,1,1,0,0.0,0.0,1,1,0,-1,-1,-1,2,0,98,86,89
571,16,632,34,100,66,112,122,59,59,0,16,58,34,51,17,0.0037441710065012424,0.00796487286837537,52,63,11,2,3,3,12,1,3,90,26
572,100,100,67,67,0,100,100,54,54,0,100,100,67,67,0,0.01940161339732462,0.02117158514585248,79,82,3,3,1,1,8,2,27,83,52
573,6,622,28,100,72,56,132,34,61,27,6,116,28,76,48,0.00034037918240920387,0.016916845365737433,34,79,45,2,4,3,16,1,9,88,23
574,1,103,26,79,53,6,12,26,28,2,1,2,26,26,0,3.4037918240920386e-05,0.00088498587426393,27,38,11,4,6,5,6,1,48,68,71
575,170,376,84,96,12,120,120,77,77,0,120,120,84,84,0,0.018244324177133328,0.020967357636406957,81,84,3,3,2,2,6,12,40,37,90
576,287,493,99,100,1,72,72,85,85,0,72,72,85,85,0,0.04431736954967834,0.054698934613159056,96,98,2,3,2,2,3,40,60,3,6
577,80,80,59,59,0,140,140,69,69,0,80,80,59,59,0,0.006569318220497634,0.006569318220497634,59,59,0,-1,3,3,10,6,22,26,50
578,167,767,92,100,8,56,56,86,86,0,56,56,86,86,0,0.025392287007726607,0.033084856530174615,87,93,6,2,2,2,2,19,95,15,20
579,0,101,1,80,79,0,3,1,24,23,0,1,1,24,23,0.0,0.00010211375472276115,1,29,28,5,-1,6,3,0,76,98,55
580,162,368,88,96,8,64,64,60,60,0,64,64,63,63,0,0.021409850573538922,0.022124646856598252,86,86,0,3,3,3,4,15,83,16,43
581,237,437,96,100,4,88,88,82,82,0,88,88,82,82,0,0.03114469519044215,0.03243813608359713,90,90,0,3,2,2,4,30,72,7,51
582,40,246,60,97,37,56,56,84,84,0,40,42,82,82,0,0.009632730862180468,0.012083460975526737,68,76,8,3,2,2,2,2,98,94,51
583,73,279,70,98,28,22,22,48,48,0,22,22,51,51,0,0.011675005956635693,0.01334286395044079,72,75,3,3,3,3,2,13,95,33,63
584,12,12,40,40,0,24,24,37,37,0,12,12,40,40,0,0.00037441710065012424,0.00037441710065012424,35,35,0,-1,4,4,4,2,77,63,79
585,104,310,75,97,22,104,104,80,80,0,104,104,81,81,0,0.00803294870485721,0.009088124170325743,66,67,1,3,2,2,5,5,63,47,43
586,158,774,81,100,19,278,288,80,83,3,158,288,81,95,14,0.010347527145239796,0.026141121209026855,60,90,30,2,2,2,16,6,9,34,23
587,40,246,50,95,45,102,102,66,66,0,40,102,50,76,26,0.004016474352428605,0.012049423057285817,52,71,19,3,2,2,8,2,39,94,14
588,218,218,91,91,0,156,156,84,84,0,156,156,88,88,0,0.021818305592429966,0.021818305592429966,85,85,0,-1,2,2,8,16,10,18,82
589,54,156,58,85,27,80,80,66,66,0,54,56,59,60,1,0.007454304094761564,0.007454304094761564,64,64,0,4,3,3,5,7,63,62,95
590,16,222,36,93,57,64,64,39,39,0,16,64,36,58,22,0.0016678579938050988,0.006943735321147759,43,64,21,3,3,3,9,1,23,53,24
591,24,230,45,91,46,46,46,42,42,0,24,46,45,53,8,0.001599782157323258,0.006058749446883829,40,57,17,3,3,3,6,3,48,43,26
592,16,632,37,100,63,42,52,38,47,9,16,52,37,54,17,0.0011232513019503727,0.010755982164130842,38,68,30,2,3,3,6,1,65,71,32
593,38,654,49,100,51,90,100,50,54,4,38,100,49,66,17,0.003199564314646516,0.01320671227747711,49,73,24,2,3,3,9,6,23,70,32
594,0,616,1,100,99,0,58,1,42,41,0,58,1,51,50,0.0,0.010109261717553355,1,69,68,2,-1,3,7,0,46,99,20
595,100,100,63,63,0,100,100,47,47,0,100,100,63,63,0,0.06630586473331292,0.0741345859287246,100,100,0,2,1,1,10,36,36,2,32
596,6,622,31,99,68,46,72,34,39,5,6,40,31,50,19,0.0002042275094455223,0.00442492937131965,32,53,21,2,4,3,11,1,19,88,28
597,66,66,71,71,0,56,56,84,84,0,56,56,84,84,0,0.01763164164879676,0.01763164164879676,81,81,0,-1,2,2,2,5,86,25,69
598,0,206,1,91,90,0,18,1,31,30,0,14,1,35,34,0.0,0.002757071377514551,1,48,47,3,-1,4,5,0,52,66,73
599,0,0,1,1,0,0,0,1,1,0,0,0,1,1,0,0.0,0.0,1,1,0,-1,-1,-1,3,1,87,45,99
600,100,100,62,62,0,100,100,48,48,0,100,100,62,62,0,0.021784267674189048,0.03100854351747847,82,90,8,2,1,1,10,8,11,57,14
601,183,183,89,89,0,94,94,72,72,0,94,94,73,73,0,0.02277136730317574,0.02277136730317574,85,85,0,-1,2,2,5,16,80,18,87
602,108,210,78,94,16,144,144,88,88,0,108,110,80,80,0,0.011879233466081215,0.012015385139044895,73,73,0,4,2,2,6,5,34,25,60
603,49,255,52,92,40,156,156,67,67,0,49,55,52,52,0,0.004833384390210695,0.005105687736138058,54,54,0,3,3,3,11,4,5,22,49
604,91,707,77,100,23,56,56,84,84,0,56,56,84,84,0,0.015351101126655093,0.031485074372851356,77,93,16,2,2,2,2,8,86,44,16
605,22,228,42,89,47,46,46,37,37,0,22,34,42,48,6,0.0007828721195411688,0.0029612988869600733,35,46,11,3,3,3,6,2,40,56,75
606,145,145,86,86,0,102,102,93,93,0,102,102,93,93,0,0.023554239422716908,0.023554239422716908,85,85,0,-1,2,2,4,12,78,37,40
607,0,0,1,1,0,0,0,1,1,0,0,0,1,1,0,0.0,0.0,1,1,0,-1,-1,-1,9,1,23,45,76
608,132,338,86,100,14,32,32,63,63,0,32,32,64,64,0,0.018959120460192654,0.021137547227611558,84,86,2,3,3,3,2,18,86,30,46
609,70,686,55,100,45,108,118,63,68,5,54,118,51,77,26,0.005003573981415297,0.014432077334150244,53,74,21,2,3,3,8,6,27,41,32
610,0,206,1,92,91,0,14,1,28,27,0,6,1,28,27,0.0,0.000442492937131965,1,33,32,3,-1,4,6,0,59,81,4
611,6,6,29,29,0,18,18,30,30,0,6,6,29,29,0,0.00010211375472276115,0.00010211375472276115,29,29,0,-1,4,4,7,1,43,65,69
612,100,100,57,57,0,100,100,38,38,0,100,100,57,57,0,0.04663194799006093,0.04663194799006093,98,98,0,-1,1,1,16,29,4,11,97
613,0,206,1,88,87,0,17,1,27,26,0,6,1,28,27,0.0,0.00010211375472276115,1,27,26,3,-1,4,11,0,33,66,4
614,100,100,73,73,0,100,100,87,87,0,100,100,87,87,0,0.0547670104496409,0.0722965383437149,97,100,3,2,1,1,4,18,79,5,9
615,263,469,95,100,5,64,64,70,70,0,64,64,70,70,0,0.030702202253310187,0.03788420300214439,89,93,4,3,3,3,4,29,84,1,27
616,0,0,1,1,0,0,0,1,1,0,0,0,1,1,0,0.0,0.0,1,1,0,-1,-1,-1,2,0,99,82,69
617,76,76,70,70,0,48,48,59,59,0,48,48,63,63,0,0.00970080669866231,0.00970080669866231,72,72,0,-1,3,3,3,6,75,77,50
618,56,672,51,100,49,98,108,53,62,9,56,78,52,57,5,0.0048674223084516155,0.007998910786616291,52,62,10,2,3,3,8,6,27,28,75
619,16,1656,35,100,65,70,112,43,62,19,16,112,35,77,42,0.0011232513019503727,0.03281255318424725,38,90,52,1,3,2,8,2,15,42,11
620,136,342,83,96,13,120,120,85,85,0,120,120,85,85,0,0.014704380680077607,0.015283025290173252,80,80,0,3,2,2,6,13,48,33,88
621,0,1640,1,100,99,0,92,1,54,53,0,92,1,64,63,0.0,0.03400388032267947,1,94,93,1,-1,2,8,0,21,76,1
622,41,247,57,97,40,38,38,47,47,0,38,38,53,53,0,0.004322815616596889,0.0061949011198475104,53,58,5,3,3,3,3,6,75,35,70
623,136,136,84,84,0,286,286,91,91,0,136,136,84,84,0,0.010858095918853602,0.010858095918853602,69,69,0,-1,2,2,14,4,8,38,80
624,190,190,91,91,0,88,88,71,71,0,88,88,71,71,0,0.019061234214915415,0.019061234214915415,81,81,0,-1,2,2,4,16,53,12,59
625,12,628,39,100,61,18,28,35,44,9,12,28,39,49,10,0.0012594029749140542,0.022703291466693896,40,86,46,2,4,3,3,2,58,61,0
626,1,1,25,25,0,3,3,25,25,0,1,1,25,25,0,0.00010211375472276115,0.00010211375472276115,29,29,0,-1,6,6,3,1,66,68,87
627,0,102,1,81,80,0,5,1,27,26,0,2,1,27,26,0.0,0.0006467204465774873,1,36,35,4,-1,5,3,0,96,85,71
628,184,800,85,100,15,252,252,85,85,0,184,252,85,90,5,0.016882807447496512,0.024507301133462677,75,88,13,2,2,2,14,12,25,37,20
629,0,616,1,100,99,0,52,1,37,36,0,39,1,47,46,0.0,0.006433166547533953,1,57,56,2,-1,3,9,0,54,93,44
630,190,190,89,89,0,318,318,91,91,0,190,190,89,89,0,0.01330882603219987,0.01330882603219987,74,74,0,-1,2,2,16,9,4,27,66
631,92,298,69,95,26,80,80,65,65,0,80,80,68,68,0,0.00888389666088022,0.016372238673882704,66,79,13,3,2,2,6,7,69,48,20
632,0,616,1,100,99,0,74,1,44,43,0,74,1,59,58,0.0,0.017937982912965042,1,79,78,2,-1,3,9,0,26,82,9
633,42,658,52,100,48,118,128,62,63,1,42,58,53,54,1,0.0014636304843595766,0.0036760951700194017,41,53,12,2,2,2,12,2,14,56,46
634,0,102,1,79,78,0,9,1,30,29,0,3,1,31,30,0.0,0.00037441710065012424,1,33,32,4,-1,5,5,0,45,79,56
635,361,561,99,100,1,112,112,95,95,0,112,112,95,95,0,0.04418121787671466,0.04537254501514688,96,96,0,3,2,2,4,40,73,3,43
636,120,222,82,93,11,70,70,67,67,0,70,70,71,71,0,0.01756356581231492,0.018925082541951733,79,79,0,4,3,3,5,17,70,6,61
637,140,756,88,100,12,144,144,91,91,0,144,144,91,91,0,0.018108172504169646,0.022805405221416657,83,86,3,2,2,2,6,8,32,20,90
638,16,222,39,91,52,68,68,43,43,0,16,25,39,50,11,0.002144388849177984,0.003165526396405596,46,50,4,3,3,3,8,2,57,94,43
639,100,100,71,71,0,100,100,80,80,0,100,100,81,81,0,0.031621226045815035,0.05769427141836005,90,98,8,2,1,1,5,2,49,61,10
640,60,60,64,64,0,38,38,59,59,0,38,38,62,62,0,0.006058749446883829,0.006058749446883829,57,57,0,-1,3,3,3,6,92,28,87
641,76,692,62,100,38,76,86,57,61,4,76,86,61,64,3,0.005956635692161067,0.01834643793185609,58,79,21,2,3,3,6,6,74,13,19
642,0,0,1,1,0,0,0,1,1,0,0,0,1,1,0,0.0,0.0,1,1,0,-1,-1,-1,6,0,56,92,81
643,100,100,60,60,0,100,100,52,52,0,100,100,60,60,0,0.01773375540351952,0.01851662752306069,79,80,1,3,1,1,9,3,29,51,78
644,0,206,1,88,87,0,23,1,29,28,0,6,1,28,27,0.0,0.00037441710065012424,1,33,32,3,-1,4,10,0,11,99,49
645,6,212,30,90,60,14,28,30,35,5,6,26,30,47,17,0.0002042275094455223,0.004969536063174376,32,56,24,3,4,4,6,1,74,55,38
646,22,22,49,49,0,30,30,43,43,0,22,22,49,49,0,0.002144388849177984,0.002144388849177984,47,47,0,-1,3,3,4,2,73,52,89
647,16,118,33,80,47,94,94,37,37,0,16,18,33,39,6,0.0007147962830593281,0.0008509479560230097,36,36,0,4,3,3,16,2,4,42,65
648,60,161,57,85,28,100,100,55,55,0,60,100,57,68,11,0.0088498587426393,0.00888389666088022,65,65,0,6,3,3,9,9,26,31,68
649,40,246,55,96,41,28,28,46,46,0,28,28,51,51,0,0.005582218591510943,0.010517716736444398,57,67,10,3,3,3,3,5,85,47,44
650,0,616,1,100,99,0,32,1,36,35,0,25,1,46,45,0.0,0.004629156880765172,1,53,52,2,-1,3,5,0,52,85,22
651,58,160,55,86,31,126,126,63,63,0,58,60,55,55,0,0.00353994349705572,0.003608019333537561,53,53,0,4,2,2,12,4,14,64,60
652,100,100,80,80,0,100,100,98,98,0,100,100,98,98,0,0.09547636066578168,0.10078627591136526,100,100,0,3,1,1,2,16,93,18,25
653,0,0,1,1,0,0,0,1,1,0,0,0,1,1,0,0.0,0.0,1,1,0,-1,-1,-1,8,0,21,93,69
654,0,206,1,94,93,0,24,1,33,32,0,14,1,38,37,0.0,0.0021784267674189047,1,47,46,3,-1,4,6,0,32,81,70
655,100,100,70,70,0,100,100,53,53,0,100,100,70,70,0,0.05371183498417237,0.056673133871132444,99,100,1,3,1,1,9,29,31,1,28
656,0,616,1,100,99,0,74,1,41,40,0,74,1,57,56,0.0,0.010858095918853602,1,71,70,2,-1,3,9,0,28,76,5
657,188,290,94,98,4,72,72,80,80,0,72,72,80,80,0,0.02481364239763096,0.024881718234112803,88,88,0,4,2,2,3,19,66,15,56
658,24,230,47,94,47,40,40,39,39,0,24,40,47,52,5,0.0013274788113958951,0.009939072126348753,40,69,29,3,3,3,5,4,63,64,14
659,266,266,93,93,0,272,272,96,96,0,272,272,96,96,0,0.02651553830967698,0.02651553830967698,88,88,0,-1,2,2,11,16,38,18,45
660,282,282,96,96,0,288,288,97,97,0,288,288,97,97,0,0.026209197045508698,0.026209197045508698,88,88,0,-1,2,2,12,20,14,23,79
661,40,656,49,100,51,146,156,66,67,1,40,63,49,56,7,0.003369753905851118,0.005956635692161067,52,58,6,2,2,2,12,3,14,46,64
662,56,158,56,87,31,54,54,56,56,0,54,54,57,57,0,0.005071649817897137,0.0057524081827155455,51,53,2,4,3,3,4,6,67,28,74
663,0,616,1,100,99,0,144,1,62,61,0,144,1,83,82,0.0,0.022396950202525613,1,88,87,2,-1,3,14,0,25,89,10
664,16,16,34,34,0,72,72,40,40,0,16,16,34,34,0,0.0010892133837094523,0.0010892133837094523,38,38,0,-1,3,3,10,1,11,71,96
665,2,2,28,28,0,7,7,29,29,0,2,2,28,28,0,0.00010211375472276115,0.00010211375472276115,30,30,0,-1,5,5,4,1,78,65,89
666,154,754,91,100,9,48,48,73,73,0,48,48,75,75,0,0.021341774737057083,0.04772116137377038,84,97,13,2,3,3,3,19,92,15,2
667,16,632,44,100,56,18,32,47,70,23,16,32,47,70,23,0.00353994349705572,0.020524864699274992,50,85,35,2,3,3,2,1,99,55,9
668,56,256,61,97,36,48,48,59,59,0,48,48,63,63,0,0.006399128629293032,0.01334286395044079,59,79,20,3,3,3,3,6,75,13,17
669,119,119,84,84,0,48,48,60,60,0,48,48,63,63,0,0.017393376221110316,0.017393376221110316,82,82,0,-1,3,3,3,18,58,5,91
670,280,486,96,98,2,160,160,94,94,0,160,160,95,95,0,0.024064808196330712,0.035910003744171005,88,91,3,3,2,2,7,19,46,15,18
671,16,632,42,100,58,38,48,56,59,3,16,48,42,62,20,0.0042547397801150485,0.012628067667381462,52,73,21,2,3,3,3,1,58,90,31
672,130,130,89,89,0,32,32,71,71,0,32,32,71,71,0,0.019878144252697506,0.019878144252697506,83,83,0,-1,3,3,2,19,99,15,92
673,139,241,85,93,8,96,96,61,61,0,96,96,69,69,0,0.014602266925354846,0.014840532353041287,79,80,1,4,3,3,6,15,48,19,55
674,16,16,42,42,0,24,24,42,42,0,16,16,42,42,0,0.001157289220191293,0.001157289220191293,39,39,0,-1,3,3,3,1,66,88,98
675,0,616,1,100,99,0,34,1,34,33,0,24,1,44,43,0.0,0.0038462847612240037,1,50,49,2,-1,3,6,1,65,45,54
676,24,24,46,46,0,98,98,41,41,0,24,24,46,46,0,0.002314578440382586,0.002314578440382586,44,44,0,-1,3,3,13,3,13,54,50
677,0,616,1,100,99,0,96,1,37,36,0,44,1,50,49,0.0,0.005207801490860819,1,55,54,2,-1,3,14,0,17,87,72
678,136,136,86,86,0,70,70,62,62,0,70,70,69,69,0,0.01589570781850982,0.01589570781850982,78,78,0,-1,3,3,5,16,45,12,84
679,54,156,57,84,27,66,66,51,51,0,54,57,57,59,2,0.006739507811702236,0.006909697402906838,62,62,0,4,3,3,6,4,34,38,56
680,100,100,66,66,0,100,100,66,66,0,100,100,69,69,0,0.03672691378195309,0.06181285952551142,92,100,8,1,1,1,7,14,62,32,5
681,136,752,83,100,17,80,80,60,60,0,80,80,65,65,0,0.010143299635794275,0.014261887742945642,71,77,6,2,3,3,5,13,50,24,46
682,396,498,98,100,2,192,192,99,99,0,192,192,99,99,0,0.04571292419755608,0.04581503795227884,95,95,0,4,2,2,6,30,32,7,60
683,0,616,1,100,99,0,40,1,42,41,0,40,1,51,50,0.0,0.01681473161101467,1,79,78,2,-1,3,5,0,45,89,15
684,50,50,65,65,0,22,22,47,47,0,22,22,52,52,0,0.004493005207801491,0.004493005207801491,53,53,0,-1,3,3,2,5,89,47,96
685,0,101,1,75,74,0,8,1,25,24,0,1,1,25,24,0.0,3.4037918240920386e-05,1,25,24,5,-1,6,8,0,15,79,78
686,434,1050,99,100,1,280,280,99,99,0,280,280,99,99,0,0.036080193335375606,0.04053916062493618,92,95,3,2,2,2,10,27,1,10,72
687,0,101,1,70,69,0,11,1,25,24,0,1,1,25,24,0.0,0.0,1,1,0,5,-1,6,11,0,5,85,58
688,90,296,63,95,32,100,100,66,66,0,90,100,69,74,5,0.007147962830593281,0.011266550937744648,57,68,11,3,2,2,6,6,51,28,62
689,0,0,1,1,0,0,0,1,1,0,0,0,1,1,0,0.0,0.0,1,1,0,-1,-1,-1,15,1,7,69,81
690,96,712,76,100,24,62,72,79,79,0,62,72,79,79,0,0.01575955614554614,0.03638653459954389,78,94,16,2,2,2,3,8,76,17,0
691,0,102,1,80,79,0,6,1,29,28,0,6,1,31,30,0.0,0.0025188059498281084,1,49,48,4,-1,5,3,0,76,40,73
692,70,70,59,59,0,128,128,69,69,0,70,70,59,59,0,0.005786446100956465,0.005786446100956465,58,58,0,-1,3,3,8,5,30,47,69
693,80,696,74,100,26,48,48,59,59,0,48,48,63,63,0,0.008475441641989176,0.01320671227747711,67,79,12,2,3,3,3,9,75,31,46
694,16,222,35,89,54,80,80,41,41,0,16,80,35,58,23,0.003710133088260322,0.016474352428605468,50,76,26,3,3,3,10,1,22,90,6
695,0,0,1,1,0,0,0,1,1,0,0,0,1,1,0,0.0,0.0,1,1,0,-1,-1,-1,5,0,80,86,36
696,111,727,77,100,23,180,200,76,80,4,111,200,77,91,14,0.008645631233193778,0.023009632730862182,63,87,24,2,2,2,11,8,19,44,12
697,0,616,1,100,99,0,30,1,41,40,0,30,1,50,49,0.0,0.005105687736138058,1,55,54,2,-1,3,4,0,83,96,47
698,66,266,63,96,33,48,48,62,62,0,48,48,64,64,0,0.008373327887266415,0.01504475986248681,66,79,13,3,3,3,3,7,64,21,14
699,0,0,1,1,0,0,0,1,1,0,0,0,1,1,0,0.0,0.0,1,1,0,-1,-1,-1,3,1,66,45,91
700,6,107,29,76,47,15,15,29,29,0,6,7,29,33,4,3.4037918240920386e-05,6.807583648184077e-05,26,27,1,5,4,4,8,1,39,68,95
701,14,14,40,40,0,12,12,32,32,0,12,12,37,37,0,0.0012253650566731338,0.0012253650566731338,39,39,0,-1,4,4,2,4,91,64,86
702,1,1,26,26,0,8,8,26,26,0,1,1,26,26,0,3.4037918240920386e-05,3.4037918240920386e-05,27,27,0,-1,6,6,8,1,57,78,96
703,100,100,68,68,0,100,100,57,57,0,100,100,68,68,0,0.038258620102794516,0.045508696688110556,94,96,2,2,1,1,8,16,39,12,21
704,54,654,56,100,44,118,118,68,68,0,54,118,56,79,23,0.00622893903808843,0.02743456210218183,59,87,28,2,3,3,8,4,21,72,7
705,142,142,88,88,0,88,88,80,80,0,88,88,80,80,0,0.014329963579427483,0.014329963579427483,76,76,0,-1,2,2,4,14,84,14,76
706,146,248,85,93,8,128,128,93,93,0,128,128,93,93,0,0.01664454201981007,0.016882807447496512,77,78,1,4,2,2,5,8,70,17,56
707,454,1054,100,100,0,144,144,89,89,0,144,144,90,90,0,0.04496408999625583,0.06092787365124749,97,99,2,2,2,2,6,40,40,3,9
708,100,100,59,59,0,100,100,45,45,0,100,100,59,59,0,0.027945130875795636,0.03345927363082474,89,90,1,2,1,1,10,8,0,20,72
709,110,316,79,98,19,88,88,76,76,0,88,88,79,79,0,0.010619830491167161,0.013376901868681712,71,77,6,3,2,2,4,7,47,21,73
710,72,72,69,69,0,56,56,86,86,0,56,56,86,86,0,0.02658361414615882,0.02658361414615882,89,89,0,-1,2,2,2,6,95,35,59
711,112,318,76,95,19,164,164,77,77,0,112,118,76,76,0,0.008747744987916539,0.008951972497362062,66,66,0,3,2,2,10,7,12,48,65
712,142,758,80,100,20,144,144,95,95,0,144,144,95,95,0,0.018788930868988054,0.026141121209026855,81,88,7,2,2,2,6,9,56,39,48
713,64,1704,58,100,42,104,128,66,77,11,64,128,58,81,23,0.006773545729943157,0.03094046768099663,59,93,34,1,3,2,9,7,26,62,30
714,0,616,1,99,98,0,48,1,31,30,0,18,1,39,38,0.0,0.0012934408931549745,1,39,38,2,-1,3,17,0,20,92,51
715,42,42,52,52,0,118,118,62,62,0,42,42,53,53,0,0.0014636304843595766,0.0014636304843595766,41,41,0,-1,2,2,12,2,14,56,97
716,234,850,93,100,7,298,308,87,88,1,234,308,93,96,3,0.014227849824704722,0.02723033459273631,77,88,11,2,2,2,16,14,4,14,18
717,91,297,76,99,23,22,22,48,48,0,22,22,51,51,0,0.016236087000919025,0.01923142380612002,80,81,1,3,3,3,2,12,95,37,73
718,204,820,90,100,10,136,136,81,81,0,136,136,82,82,0,0.021818305592429966,0.025188059498281085,84,87,3,2,2,2,7,16,43,18,70
719,331,1971,99,100,1,96,120,93,99,6,96,120,93,99,6,0.04571292419755608,0.09145988631335307,96,100,4,1,2,2,3,40,66,3,23
720,0,0,1,1,0,0,0,1,1,0,0,0,1,1,0,0.0,0.0,1,1,0,-1,-1,-1,3,0,82,76,36
721,100,100,70,70,0,100,100,73,73,0,100,100,74,74,0,0.028489737567650362,0.030395860989141904,91,91,0,3,1,1,6,6,71,70,94
722,0,0,1,1,0,0,0,1,1,0,0,0,1,1,0,0.0,0.0,1,1,0,-1,-1,-1,7,0,43,36,84
723,12,113,39,84,45,10,10,32,32,0,12,13,39,40,1,0.0009530617107457708,0.0009530617107457708,39,39,0,6,4,4,3,3,60,51,58
724,146,762,83,100,17,176,176,87,87,0,146,176,83,90,7,0.013853432724054596,0.016440314510364547,77,79,2,2,2,2,8,9,15,27,46
725,16,632,32,99,67,138,152,61,63,2,16,76,32,54,22,0.002586881786309949,0.008169100377820893,47,59,12,2,3,3,17,2,20,94,31
726,221,427,93,100,7,72,72,80,80,0,72,72,80,80,0,0.03359542530378842,0.03631845876306205,91,92,1,3,2,2,3,29,76,0,41
727,94,94,63,63,0,104,104,73,73,0,94,94,69,69,0,0.007794683277170768,0.007794683277170768,59,59,0,-1,2,2,5,6,52,26,98
728,0,616,1,100,99,0,33,1,34,33,0,36,1,44,43,0.0,0.005173763572619898,1,53,52,2,-1,3,6,0,51,80,35
729,2,2,27,27,0,6,6,29,29,0,2,2,27,27,0,0.0005786446100956465,0.0005786446100956465,34,34,0,-1,5,5,3,2,94,42,87
730,100,100,69,69,0,100,100,55,55,0,100,100,69,69,0,0.058068688519010175,0.058068688519010175,99,99,0,-1,1,1,9,29,26,11,86
731,214,814,92,100,8,102,102,93,93,0,102,102,93,93,0,0.02644746247319514,0.03090642976275571,88,88,0,2,2,2,4,16,84,12,35
732,1,103,25,79,54,5,9,25,30,5,1,3,25,31,6,3.4037918240920386e-05,0.0006467204465774873,26,36,10,4,6,5,5,1,45,68,42
733,6,212,30,94,64,12,24,30,35,5,6,24,30,46,16,0.00034037918240920387,0.005241839409101739,33,54,21,3,4,4,4,1,53,88,21
734,0,0,1,1,0,0,0,1,1,0,0,0,1,1,0,0.0,0.0,1,1,0,-1,-1,-1,6,0,74,81,96
735,36,242,53,95,42,54,54,55,55,0,35,54,54,59,5,0.00445896728956057,0.009870996289866912,54,69,15,3,3,3,4,6,73,41,21
736,0,616,1,100,99,0,64,1,41,40,0,46,1,52,51,0.0,0.00704584907587052,1,65,64,2,-1,3,8,0,39,67,48
737,0,616,1,100,99,0,28,1,39,38,0,28,1,48,47,0.0,0.009428503352734947,1,71,70,2,-1,3,3,0,82,86,20
738,0,206,1,92,91,0,15,1,29,28,0,10,1,35,34,0.0,0.0011232513019503727,1,37,36,3,-1,4,6,1,65,69,64
739,217,1857,97,100,3,32,56,63,82,19,32,56,64,82,18,0.03100854351747847,0.08509479560230096,94,98,4,1,3,2,2,30,86,7,21
740,87,293,76,98,22,32,32,63,63,0,32,32,64,64,0,0.014908608189523128,0.01664454201981007,76,79,3,3,3,3,2,13,86,33,46
741,40,246,53,95,42,74,74,64,64,0,40,46,53,56,3,0.006875659484665918,0.007692569522448007,61,64,3,3,2,2,5,1,63,90,49
742,49,255,56,96,40,48,48,69,69,0,48,48,70,70,0,0.005718370264474625,0.00789679703189353,57,61,4,3,3,3,3,4,55,22,70
743,0,102,1,79,78,0,6,1,28,27,0,6,1,31,30,0.0,0.0010892133837094523,1,38,37,4,-1,5,3,0,58,96,54
744,72,688,70,100,30,32,32,64,64,0,32,32,64,64,0,0.01242384015793594,0.02484768031587188,73,88,15,2,3,3,2,8,89,20,39
745,0,102,1,75,74,0,9,1,26,25,0,2,1,25,24,0.0,0.0005105687736138058,1,30,29,4,-1,5,6,0,51,91,42
746,39,245,46,93,47,94,94,45,45,0,39,54,46,53,7,0.003778208924742163,0.006501242384015794,50,56,6,3,3,3,9,4,29,22,41
747,46,252,53,93,40,64,64,66,66,0,46,64,54,70,16,0.005480104836788182,0.010415602981721638,58,70,12,3,2,2,5,2,70,75,72
748,182,182,86,86,0,320,320,92,92,0,182,182,86,86,0,0.012594029749140543,0.012594029749140543,72,72,0,-1,2,2,14,6,16,77,84
749,0,616,1,100,99,0,90,1,44,43,0,90,1,62,61,0.0,0.020865243881684196,1,82,81,2,-1,3,10,0,22,79,11
750,18,224,39,92,53,36,36,36,36,0,18,36,39,48,9,0.000442492937131965,0.005446066918547262,34,54,20,3,3,3,5,2,50,56,38
751,22,22,49,49,0,34,34,45,45,0,22,22,49,49,0,0.0028932230504782326,0.0028932230504782326,49,49,0,-1,3,3,4,2,84,75,66
752,0,616,1,100,99,0,46,1,47,46,0,46,1,54,53,0.0,0.006262976956329351,1,57,56,2,-1,3,5,0,61,96,47
753,46,662,68,100,32,32,32,67,67,0,32,32,68,68,0,0.00966676878042139,0.028966268423023248,69,91,22,2,3,3,2,5,97,25,16
754,80,181,78,96,18,32,32,67,67,0,32,32,68,68,0,0.012662105585622384,0.012832295176826986,75,75,0,5,3,3,2,14,97,14,56
755,136,342,87,99,12,102,102,93,93,0,102,102,93,93,0,0.019639878825011062,0.025494400762449368,82,87,5,3,2,2,4,8,84,8,25
756,6,212,31,93,62,14,26,31,36,5,6,26,31,49,18,0.0002723033459273631,0.004969536063174376,32,55,23,3,4,4,5,1,70,60,72
757,136,752,82,100,18,276,276,87,87,0,136,198,82,87,5,0.008543517478471017,0.014636304843595765,63,76,13,2,2,2,14,7,16,62,31
758,72,72,67,67,0,38,38,55,55,0,38,38,58,58,0,0.012594029749140543,0.012594029749140543,76,76,0,-1,3,3,3,8,76,20,50
759,108,314,80,95,15,80,80,68,68,0,80,80,72,72,0,0.01409169815174104,0.0158616699002689,76,77,1,3,3,3,5,13,88,33,53
760,76,282,58,94,36,126,126,63,63,0,76,98,58,64,6,0.007794683277170768,0.013036522686272508,63,71,8,3,3,3,11,6,33,34,25
761,56,672,52,100,48,80,90,61,66,5,56,90,52,68,16,0.005650294427992784,0.017495489975833077,54,80,26,2,2,2,6,3,56,29,5
762,91,691,76,100,24,22,22,48,48,0,22,22,51,51,0,0.016236087000919025,0.03859899928520372,80,96,16,2,3,3,2,12,95,37,3
763,50,152,65,90,25,22,22,47,47,0,22,22,52,52,0,0.004493005207801491,0.005412029000306341,53,58,5,4,3,3,2,5,89,47,51
764,60,60,62,62,0,62,62,76,76,0,62,62,77,77,0,0.008066986623098132,0.008066986623098132,62,62,0,-1,2,2,3,6,87,28,91
765,0,616,1,100,99,0,80,1,41,40,0,80,1,57,56,0.0,0.014023622315259198,1,79,78,2,-1,3,10,0,36,85,15
766,126,742,78,100,22,100,100,59,59,0,100,100,64,64,0,0.00881582082439838,0.01861874127778345,64,82,18,2,2,2,6,8,40,44,39
767,56,672,54,100,46,66,66,44,44,0,56,66,54,56,2,0.008203138296061813,0.012798257258586064,65,74,9,2,3,3,6,5,51,25,41
768,80,696,64,100,36,106,116,71,76,5,80,116,64,79,15,0.006569318220497634,0.021546002246502605,60,84,24,2,2,2,7,6,43,28,6
769,16,16,40,40,0,94,94,51,51,0,16,16,40,40,0,0.0020422750944552232,0.0020422750944552232,43,43,0,-1,3,3,9,1,26,53,97
770,2,2,27,27,0,13,13,27,27,0,2,2,27,27,0,0.0,0.0,1,1,0,-1,5,5,10,2,12,58,67
771,46,46,53,53,0,84,84,48,48,0,46,46,53,53,0,0.002825147213996392,0.002825147213996392,47,47,0,-1,2,2,9,2,23,52,69
772,74,280,64,95,31,64,64,68,68,0,64,64,69,69,0,0.010143299635794275,0.026379386636713298,72,89,17,3,3,3,4,9,73,27,10
773,22,638,39,100,61,136,186,63,70,7,22,139,39,79,40,0.002110350930937064,0.018176248340651485,44,83,39,2,3,3,16,2,9,52,18
774,16,222,35,92,57,70,78,43,44,1,16,49,35,52,17,0.0011232513019503727,0.006875659484665918,38,60,22,3,3,3,8,2,15,42,44
775,100,100,64,64,0,100,100,44,44,0,100,100,64,64,0,0.03478675244222063,0.040334933115490655,92,94,2,3,1,1,13,19,13,15,34
776,9,9,38,38,0,18,18,38,38,0,9,9,38,38,0,0.0013274788113958951,0.0013274788113958951,40,40,0,-1,4,4,3,4,81,64,92
777,6,1646,29,100,71,23,74,29,41,12,6,46,29,49,20,0.0,0.012866333095067906,1,75,74,1,4,2,10,1,0,95,46
778,125,125,88,88,0,48,48,65,65,0,48,48,68,68,0,0.014364001497668403,0.014364001497668403,80,80,0,-1,3,3,3,15,66,19,79
779,0,1640,1,100,99,0,140,1,64,63,0,140,1,81,80,0.0,0.029817216379046257,1,91,90,1,-1,2,11,1,33,45,7
780,146,246,89,97,8,72,72,77,77,0,72,72,79,79,0,0.020763130126961436,0.020831205963443275,88,88,0,4,2,2,3,16,96,12,4
781,50,666,61,100,39,38,48,55,65,10,38,48,58,66,8,0.004731270635487933,0.03277851526600633,56,92,36,2,3,3,3,5,76,47,1
782,100,100,72,72,0,100,100,79,79,0,100,100,80,80,0,0.049218829776370876,0.06773545729943156,97,99,2,2,1,1,5,17,37,6,15
783,40,40,51,51,0,144,144,65,65,0,40,40,51,51,0,0.0026549576227917903,0.0026549576227917903,47,47,0,-1,2,2,10,1,18,53,50
784,2,618,27,100,73,7,23,27,32,5,2,18,27,41,14,0.0,0.0014636304843595766,1,41,40,2,5,3,6,2,41,58,4
785,70,70,59,59,0,82,82,56,56,0,70,70,60,60,0,0.005956635692161067,0.005956635692161067,56,56,0,-1,3,3,7,5,62,47,89
786,2,1642,26,100,74,10,88,27,47,20,2,88,26,61,35,3.4037918240920386e-05,0.020354675108070392,26,82,56,1,5,2,8,1,15,68,8
787,40,40,51,51,0,134,134,67,67,0,40,40,51,51,0,0.004016474352428605,0.004016474352428605,52,52,0,-1,2,2,10,3,36,46,67
788,100,100,58,58,0,100,100,35,35,0,100,100,59,59,0,0.056434868443446,0.056673133871132444,99,100,1,3,1,1,17,36,20,2,56
789,0,206,1,95,94,0,8,1,31,30,0,8,1,37,36,0.0,0.003267640151128357,1,50,49,3,-1,4,2,0,95,98,13
790,391,597,100,100,0,168,168,97,97,0,168,168,97,97,0,0.03403791824092039,0.036658837945471257,94,94,0,3,2,2,6,30,59,7,73
791,0,0,1,1,0,0,0,1,1,0,0,0,1,1,0,0.0,0.0,1,1,0,-1,-1,-1,3,1,60,50,76
792,0,0,1,1,0,0,0,1,1,0,0,0,1,1,0,0.0,0.0,1,1,0,-1,-1,-1,14,0,16,85,50
793,0,616,1,100,99,0,28,1,39,38,0,28,1,48,47,0.0,0.01157289220191293,1,75,74,2,-1,3,3,0,82,76,33
794,140,346,85,98,13,128,128,90,90,0,128,128,90,90,0,0.018754892950747133,0.020797168045202357,81,84,3,3,2,2,5,8,63,20,83
795,54,670,58,100,42,76,76,54,54,0,54,76,58,65,7,0.006841621566424997,0.016610504101569147,61,82,21,2,3,3,6,7,32,62,33
796,56,672,56,100,44,54,54,56,56,0,54,54,57,57,0,0.010381565063480718,0.026141121209026855,67,88,21,2,3,3,4,5,67,25,16
797,0,616,1,100,99,0,40,1,39,38,0,40,1,49,48,0.0,0.011300588855985567,1,75,74,2,-1,3,5,0,52,59,12
798,6,212,30,91,61,14,18,31,32,1,6,14,30,38,8,0.0004084550188910446,0.001497668402600497,35,39,4,3,4,4,5,1,80,88,74
799,0,102,1,77,76,0,10,1,29,28,0,6,1,30,29,0.0,0.001497668402600497,1,42,41,4,-1,5,5,0,37,36,54
800,0,102,1,75,74,0,6,1,25,24,0,2,1,25,24,0.0,0.0002382654276864427,1,30,29,4,-1,5,5,0,80,87,88
801,0,0,1,1,0,0,0,1,1,0,0,0,1,1,0,0.0,0.0,1,1,0,-1,-1,-1,9,0,28,98,85
802,100,100,64,64,0,100,100,59,59,0,100,100,64,64,0,0.05813676435549202,0.06497838592191701,99,99,0,2,1,1,6,29,40,11,72
803,100,100,69,69,0,100,100,69,69,0,100,100,71,71,0,0.04625753088941081,0.05742196807243269,97,97,0,3,1,1,6,16,34,12,6
804,150,750,83,100,17,140,140,88,88,0,150,140,91,89,-2,0.017257224548146634,0.02382654276864427,79,86,7,2,2,2,7,8,62,20,27
805,16,222,41,93,52,27,36,40,41,1,16,36,41,52,11,0.0004765308553728854,0.008611593314952858,35,68,33,3,3,3,5,1,70,4,77
806,132,233,89,96,7,96,96,90,90,0,96,96,90,90,0,0.02032063718982947,0.02032063718982947,84,84,0,6,2,2,3,13,75,33,78
807,176,792,86,100,14,120,120,78,78,0,120,120,78,78,0,0.015351101126655093,0.03887130263113108,77,94,17,2,2,2,6,14,41,14,10
808,0,206,1,89,88,0,24,1,30,29,0,21,1,39,38,0.0,0.005037611899656217,1,51,50,3,-1,4,6,0,71,79,25
809,64,664,63,100,37,32,32,58,58,0,32,32,60,60,0,0.0068075836481840775,0.023724429013921508,61,88,27,2,3,3,2,8,91,57,9
810,62,62,56,56,0,128,128,67,67,0,62,62,56,56,0,0.004016474352428605,0.004016474352428605,52,52,0,-1,2,2,9,6,28,70,59
811,28,234,50,94,44,28,28,43,43,0,28,28,50,50,0,0.0020422750944552232,0.010449640899962559,46,71,25,3,3,3,3,3,66,54,77
812,0,101,1,77,76,0,4,1,24,23,0,1,1,24,23,0.0,0.0,1,1,0,6,-1,7,4,1,84,50,78
813,0,206,1,93,92,0,18,1,39,38,0,6,1,30,29,0.0,0.0034718676605738795,1,48,47,3,-1,4,3,0,92,85,90
814,168,168,87,87,0,318,318,91,91,0,168,168,87,87,0,0.012662105585622384,0.012662105585622384,73,73,0,-1,2,2,16,6,4,77,50
815,68,274,63,96,33,88,88,76,76,0,68,88,73,78,5,0.009292351679771264,0.015725518227305217,68,79,11,3,2,2,4,4,47,72,77
816,24,24,45,45,0,64,64,39,39,0,24,24,45,45,0,0.0017018959120460194,0.0017018959120460194,44,44,0,-1,3,3,9,3,23,43,96
817,0,1640,1,100,99,0,176,1,68,67,0,176,1,87,86,0.0,0.029681064706082574,1,91,90,1,-1,2,12,0,14,79,11
818,6,622,29,100,71,23,90,30,44,14,6,90,29,62,33,0.00017018959120460194,0.01667857993805099,32,77,45,2,4,3,10,1,22,95,23
819,16,222,35,91,56,68,68,37,37,0,16,22,35,42,7,0.0009190237925048504,0.002552843868069029,39,46,7,3,3,3,10,2,1,42,53
820,6,212,29,93,64,15,54,28,38,10,6,42,29,52,23,0.00017018959120460194,0.005071649817897137,29,53,24,3,4,4,9,1,23,78,21
821,42,248,53,91,38,70,70,54,54,0,40,70,53,59,6,0.004288777698355968,0.013444977705163553,55,77,22,3,3,3,5,6,61,41,19
822,0,616,1,99,98,0,104,1,54,53,0,34,1,44,43,0.0,0.005480104836788182,1,54,53,2,-1,3,17,1,20,50,38
823,132,132,82,82,0,150,150,71,71,0,150,150,85,85,0,0.013002484768031588,0.013002484768031588,75,75,0,-1,3,3,10,13,36,33,59
824,176,278,86,95,9,142,142,78,78,0,142,142,84,84,0,0.01596378365499166,0.016099935327955343,76,76,0,4,2,2,8,14,21,14,55
825,6,212,30,89,59,23,24,30,30,0,6,14,30,35,5,0.0002382654276864427,0.0017018959120460194,31,37,6,3,4,4,6,1,71,88,52
826,90,706,68,100,32,60,70,51,55,4,60,70,57,62,5,0.00803294870485721,0.026923993328568024,64,89,25,2,3,3,5,9,37,31,15
827,0,206,1,93,92,0,22,1,29,28,0,9,1,35,34,0.0,0.0012253650566731338,1,39,38,3,-1,4,9,0,23,97,43
828,8,624,40,100,60,8,22,34,48,14,8,22,40,49,9,0.0004084550188910446,0.020933319718166036,35,86,51,2,4,3,2,2,93,56,16
829,96,96,68,68,0,132,132,73,73,0,96,96,68,68,0,0.009190237925048503,0.009190237925048503,69,69,0,-1,2,2,8,6,30,34,99
830,101,203,77,92,15,148,148,78,78,0,101,103,77,77,0,0.008339289969025495,0.008441403723748256,64,66,2,4,2,2,9,8,35,57,65
831,22,1662,41,100,59,70,118,41,71,30,22,118,41,81,40,0.0009190237925048504,0.027843017121072875,37,87,50,1,3,2,9,2,23,74,30
832,2,618,26,100,74,7,66,26,47,21,2,66,26,58,32,0.0,0.016406276592123625,1,81,80,2,5,3,6,1,59,68,15
833,0,206,1,90,89,0,20,1,33,32,0,20,1,45,44,0.0,0.0030634126416828346,1,49,48,3,-1,4,4,0,79,87,35
834,22,22,50,50,0,22,22,55,55,0,22,22,57,57,0,0.005241839409101739,0.005241839409101739,57,57,0,-1,3,3,2,2,97,83,36
835,70,276,59,93,34,134,134,72,72,0,70,134,59,81,22,0.007862759113652609,0.010994247591817285,64,73,9,3,3,3,9,5,31,25,28
836,6,622,29,100,71,17,78,29,43,14,6,78,29,57,28,6.807583648184077e-05,0.014295925661186561,28,75,47,2,4,3,8,1,10,95,32
837,86,686,74,100,26,48,48,66,66,0,48,48,67,67,0,0.007250076585316042,0.020695054290479593,63,84,21,2,3,3,3,6,76,13,14
838,88,88,71,71,0,48,48,60,60,0,48,48,63,63,0,0.013002484768031588,0.013002484768031588,74,74,0,-1,3,3,3,9,58,27,87
839,61,1701,61,100,39,76,110,54,80,26,61,110,61,84,23,0.004935498144933456,0.0425814357193914,54,94,40,1,3,2,6,6,32,35,11
840,6,622,28,100,72,32,56,35,43,8,6,56,28,51,23,0.0005446066918547262,0.020967357636406957,34,84,50,2,4,3,6,1,56,49,7
841,135,751,88,100,12,38,48,46,66,20,38,48,51,69,18,0.019095272133156337,0.03866707512168556,83,95,12,2,3,3,3,16,96,18,9
842,16,16,42,42,0,28,28,43,43,0,16,16,42,42,0,0.0007147962830593281,0.0007147962830593281,37,37,0,-1,3,3,3,1,75,49,45
843,152,152,91,91,0,32,32,64,64,0,32,32,64,64,0,0.021341774737057083,0.021341774737057083,86,86,0,-1,3,3,2,17,89,6,69
844,80,80,72,72,0,48,48,66,66,0,48,48,67,67,0,0.009292351679771264,0.009292351679771264,69,69,0,-1,3,3,3,9,76,31,91
845,104,720,72,100,28,136,136,77,77,0,104,136,73,82,9,0.007794683277170768,0.026073045372545015,61,86,25,2,2,2,7,5,24,47,18
846,0,206,1,93,92,0,12,1,35,34,0,8,1,35,34,0.0,0.0012934408931549745,1,39,38,3,-1,4,2,0,68,82,61
847,100,100,67,67,0,100,100,70,70,0,100,100,71,71,0,0.0348888661969434,0.0348888661969434,93,93,0,-1,1,1,6,7,74,48,86
848,0,0,1,1,0,0,0,1,1,0,0,0,1,1,0,0.0,0.0,1,1,0,-1,-1,-1,4,1,47,45,82
849,172,1812,88,100,12,136,160,81,90,9,136,160,82,90,8,0.017087034956942034,0.03887130263113108,80,94,14,1,2,2,7,18,43,5,32
850,12,628,45,100,55,12,22,35,51,16,12,22,43,53,10,0.0022465026039007454,0.010483678818203479,48,67,19,2,4,3,2,2,86,75,57
851,6,622,29,100,71,30,106,29,54,25,6,73,29,54,25,6.807583648184077e-05,0.006875659484665918,28,57,29,2,4,3,14,1,16,95,44
852,0,0,1,1,0,0,0,1,1,0,0,0,1,1,0,0.0,0.0,1,1,0,-1,-1,-1,8,0,27,80,79
853,6,212,32,97,65,8,12,32,34,2,6,12,32,41,9,0.0004765308553728854,0.016610504101569147,36,82,46,3,4,4,2,1,98,55,9
854,183,799,87,100,13,222,222,92,92,0,183,222,86,93,7,0.02038871302631131,0.022703291466693896,82,82,0,2,2,2,10,12,12,37,70
855,0,102,1,84,83,0,4,1,26,25,0,2,1,26,25,0.0,0.0006126825283365669,1,35,34,4,-1,5,3,0,92,80,71
856,0,206,1,89,88,0,14,1,31,30,0,6,1,28,27,0.0,0.0008509479560230097,1,37,36,3,-1,4,5,1,61,50,42
857,54,654,59,100,41,38,38,53,53,0,38,38,55,55,0,0.006875659484665918,0.015657442390823378,62,79,17,2,3,3,3,7,64,62,20
858,0,616,1,100,99,0,90,1,41,40,0,63,1,55,54,0.0,0.007318152421797883,1,60,59,2,-1,3,12,0,3,81,57
859,150,766,84,100,16,176,176,85,85,0,150,176,87,88,1,0.014261887742945642,0.026753803737363423,77,87,10,2,2,2,8,8,30,20,19
860,6,212,29,90,61,27,36,30,31,1,6,12,29,32,3,0.00010211375472276115,0.0007488342013002485,27,36,9,3,4,4,12,1,14,60,42
861,80,696,71,100,29,32,32,58,58,0,32,32,59,59,0,0.009190237925048503,0.03883726471289016,65,96,31,2,3,3,2,9,68,31,2
862,0,206,1,90,89,0,46,1,34,33,0,28,1,43,42,0.0,0.005582218591510943,1,60,59,3,-1,4,9,0,31,36,34
863,12,12,35,35,0,50,50,36,36,0,12,12,35,35,0,0.0009530617107457708,0.0009530617107457708,37,37,0,-1,4,4,9,2,54,74,76
864,97,303,74,97,23,48,48,54,54,0,48,48,56,56,0,0.014227849824704722,0.020967357636406957,78,87,9,3,3,3,3,13,87,33,31
865,52,668,53,100,47,80,100,54,58,4,52,100,53,63,10,0.004322815616596889,0.01153885428367201,54,72,18,2,2,2,6,3,40,43,72
866,6,212,31,90,59,19,40,31,35,4,6,21,31,44,13,3.4037918240920386e-05,0.005071649817897137,27,55,28,3,4,4,8,1,57,65,34
867,196,812,92,100,8,144,144,88,88,0,144,144,89,89,0,0.02117158514585248,0.027162258756254467,85,88,3,2,2,2,6,18,34,30,62
868,38,38,51,51,0,56,56,46,46,0,38,38,51,51,0,0.0030293747234419145,0.0030293747234419145,49,49,0,-1,3,3,6,6,74,70,36
869,46,46,53,53,0,82,82,56,56,0,46,46,53,53,0,0.005412029000306341,0.005412029000306341,54,54,0,-1,2,2,7,2,62,75,82
870,0,0,1,1,0,0,0,1,1,0,0,0,1,1,0,0.0,0.0,1,1,0,-1,-1,-1,4,0,72,97,96
871,8,624,40,100,60,8,22,34,48,14,8,22,40,49,9,0.000442492937131965,0.015623404472582456,36,79,43,2,4,3,2,2,93,63,34
872,100,100,63,63,0,100,100,47,47,0,100,100,63,63,0,0.03774805132918071,0.04632560672589264,94,95,1,2,1,1,10,18,36,30,17
873,0,206,1,91,90,0,24,1,33,32,0,8,1,35,34,0.0,0.0013955546478777359,1,41,40,3,-1,4,6,0,44,96,61
874,66,66,59,59,0,80,80,61,61,0,66,66,61,61,0,0.00881582082439838,0.00881582082439838,65,65,0,-1,2,2,6,6,56,34,92
875,100,100,69,69,0,100,100,76,76,0,100,100,76,76,0,0.045134279587460434,0.05058034650600769,95,97,2,3,1,1,5,13,80,33,77
876,76,76,69,69,0,38,38,57,57,0,38,38,59,59,0,0.008101024541339052,0.008101024541339052,62,62,0,-1,3,3,3,13,55,24,67
877,88,88,73,73,0,64,64,68,68,0,64,64,71,71,0,0.01245787807617686,0.01245787807617686,74,74,0,-1,3,3,4,13,72,33,99
878,8,624,36,100,64,12,22,32,41,9,8,22,36,44,8,0.0004084550188910446,0.02215868477483917,34,88,54,2,4,3,2,2,91,56,0
879,260,362,97,99,2,88,88,82,82,0,88,88,82,82,0,0.033425235712583816,0.03366350114027026,92,92,0,4,2,2,4,22,78,9,49
880,0,206,1,93,92,0,26,1,35,34,0,26,1,51,50,0.0,0.003778208924742163,1,51,50,3,-1,4,5,0,49,82,13
881,495,495,98,98,0,304,304,98,98,0,304,304,98,98,0,0.036454610436025735,0.036454610436025735,92,92,0,-1,2,2,10,30,12,7,36
882,184,184,86,86,0,232,232,93,93,0,184,184,87,87,0,0.014227849824704722,0.014227849824704722,75,75,0,-1,2,2,10,8,18,17,93
883,0,616,1,100,99,0,58,1,42,41,0,58,1,56,55,0.0,0.012185574730249497,1,73,72,2,-1,3,8,0,21,80,5
884,104,1744,79,100,21,218,252,77,84,7,104,147,79,82,3,0.00622893903808843,0.015180911535450491,59,75,16,1,2,2,14,5,17,47,64
885,16,632,33,100,67,66,76,44,48,4,16,76,33,55,22,0.0018380475850097008,0.00796487286837537,42,62,20,2,3,3,6,1,40,53,57
886,0,1640,1,100,99,0,192,1,73,72,0,192,1,88,87,0.0,0.032948704857210936,1,91,90,1,-1,2,13,0,13,36,11
887,324,524,98,100,2,96,96,89,89,0,96,96,89,89,0,0.03699921712788046,0.03989244017835869,94,94,0,3,2,2,3,29,64,1,47
888,91,91,76,76,0,22,22,48,48,0,22,22,51,51,0,0.016236087000919025,0.016236087000919025,80,80,0,-1,3,3,2,12,95,37,79
889,100,100,64,64,0,100,100,59,59,0,100,100,64,64,0,0.03880322679464924,0.03883726471289016,94,94,0,4,1,1,6,8,40,20,65
890,47,47,55,55,0,86,86,63,63,0,47,47,55,55,0,0.004731270635487933,0.004731270635487933,55,55,0,-1,3,3,6,6,34,35,40
891,76,76,61,61,0,60,60,52,52,0,60,60,56,56,0,0.007556417849484326,0.007556417849484326,62,62,0,-1,3,3,5,6,61,34,69
892,100,202,80,96,16,46,46,84,84,0,46,46,84,84,0,0.014432077334150244,0.017087034956942034,75,81,6,4,2,2,2,13,93,24,73
893,0,1640,1,100,99,0,46,1,83,82,0,46,1,83,82,0.0,0.061098063242452094,1,98,97,1,-1,2,2,0,93,89,18
894,24,126,48,83,35,36,36,41,41,0,24,26,48,51,3,0.0019741992579733825,0.002825147213996392,44,47,3,4,3,3,5,3,49,54,71
895,22,228,45,91,46,50,50,46,46,0,22,34,45,50,5,0.0023486163586235067,0.004050512270669526,46,53,7,3,3,3,5,2,80,52,75
896,0,616,1,100,99,0,38,1,52,51,0,38,1,54,53,0.0,0.015725518227305217,1,80,79,2,-1,3,3,0,64,92,6
897,22,1662,45,100,55,50,94,48,74,26,22,94,45,74,29,0.0016678579938050988,0.04789135096497498,43,97,54,1,3,2,5,2,49,52,3
898,0,206,1,89,88,0,19,1,28,27,0,8,1,33,32,0.0,0.00088498587426393,1,38,37,3,-1,4,8,0,42,79,51
899,0,206,1,91,90,0,36,1,35,34,0,36,1,46,45,0.0,0.01147077844719017,1,71,70,3,-1,4,6,0,56,59,6
900,102,308,70,95,25,182,182,88,88,0,102,114,70,76,6,0.008713707069675619,0.010313489226998877,65,69,4,3,2,2,9,4,29,72,83
901,0,206,1,96,95,0,8,1,32,31,0,8,1,36,35,0.0,0.004561081044283332,1,52,51,3,-1,4,2,0,99,96,38
902,182,283,89,94,5,126,126,80,80,0,126,126,83,83,0,0.019367575479083698,0.019367575479083698,80,80,0,6,2,2,7,18,62,30,78
903,100,100,72,72,0,100,100,87,87,0,100,100,87,87,0,0.08461826474692807,0.08461826474692807,99,99,0,-1,1,1,4,40,53,3,66
904,32,32,47,47,0,94,94,51,51,0,32,32,47,47,0,0.004629156880765172,0.004629156880765172,52,52,0,-1,3,3,9,3,26,29,93
905,0,616,1,100,99,0,54,1,59,58,0,54,1,61,60,0.0,0.02049082678103407,1,83,82,2,-1,3,4,0,78,96,30
906,12,12,40,40,0,18,18,38,38,0,12,12,40,40,0,0.002212464685659825,0.002212464685659825,49,49,0,-1,4,4,3,2,76,75,79
907,0,0,1,1,0,0,0,1,1,0,0,0,1,1,0,0.0,0.0,1,1,0,-1,-1,-1,14,0,25,91,85
908,87,703,66,100,34,114,114,64,64,0,87,114,66,80,14,0.006705469893461316,0.019571802988529223,61,83,22,2,3,3,9,8,31,57,5
909,0,102,1,83,82,0,4,1,28,27,0,2,1,27,26,0.0,0.0011232513019503727,1,38,37,4,-1,5,2,0,86,66,53
910,54,260,60,93,33,98,98,53,53,0,54,98,60,68,8,0.007216038667075122,0.010177337554035196,61,69,8,3,3,3,8,4,57,72,28
911,44,660,54,100,46,28,38,45,55,10,28,38,49,56,7,0.006399128629293032,0.030463936825623743,56,92,36,2,3,3,3,7,60,62,7
912,0,616,1,100,99,0,50,1,45,44,0,50,1,52,51,0.0,0.02117158514585248,1,83,82,2,-1,3,5,0,50,85,7
913,40,1680,50,100,50,82,150,41,64,23,40,122,50,75,25,0.0015317063208414173,0.019095272133156337,41,82,41,1,2,2,11,1,5,4,17
914,0,101,1,74,73,0,11,1,25,24,0,1,1,25,24,0.0,0.00017018959120460194,1,30,29,5,-1,6,11,0,19,81,65
915,606,2206,100,100,0,400,400,99,99,0,400,400,99,99,0,0.052554545763981074,0.07410054801048369,99,100,1,1,2,2,13,36,13,2,9
916,76,692,56,100,44,142,162,62,67,5,76,116,56,82,26,0.005888559855679227,0.010177337554035196,56,67,11,2,2,2,13,6,13,35,28
917,0,206,1,90,89,0,18,1,27,26,0,6,1,28,27,0.0,0.0005446066918547262,1,33,32,3,-1,4,13,0,13,86,58
918,8,8,39,39,0,12,12,35,35,0,8,8,39,39,0,0.00176997174852786,0.00176997174852786,45,45,0,-1,4,4,2,2,86,61,93
919,16,118,42,85,43,38,38,47,47,0,16,18,42,44,2,0.0026889955410327104,0.0030634126416828346,48,50,2,4,3,3,3,2,75,94,42
920,100,100,67,67,0,100,100,55,55,0,100,100,67,67,0,0.05670717178937336,0.05670717178937336,99,99,0,-1,1,1,9,29,23,1,66
921,0,206,1,95,94,0,8,1,31,30,0,8,1,37,36,0.0,0.00353994349705572,1,50,49,3,-1,4,2,0,95,93,47
922,140,140,86,86,0,100,100,68,68,0,100,100,73,73,0,0.010381565063480718,0.010381565063480718,70,70,0,-1,2,2,6,13,48,24,81
923,64,270,67,97,30,48,48,73,73,0,48,48,75,75,0,0.013989584397018279,0.01773375540351952,76,82,6,3,3,3,3,9,92,39,47
924,46,252,57,93,36,66,66,49,49,0,46,52,57,57,0,0.0026549576227917903,0.0032336022328874367,49,50,1,3,2,2,6,2,44,63,42
925,166,1766,84,100,16,208,208,85,85,0,166,208,84,90,6,0.014874570271282209,0.04714251676367474,76,97,21,1,2,2,10,9,18,39,3
926,0,1640,1,100,99,0,126,1,68,67,0,126,1,77,76,0.0,0.042819701147077845,1,96,95,1,-1,2,7,0,24,67,2
927,116,732,78,100,22,120,120,79,79,0,120,120,81,81,0,0.01415977398822288,0.021784267674189048,78,84,6,2,2,2,6,8,44,17,21
928,100,100,62,62,0,100,100,43,43,0,100,100,62,62,0,0.04697232717247013,0.04697232717247013,95,95,0,-1,1,1,12,30,14,7,45
929,210,416,94,99,5,94,94,71,71,0,94,94,72,72,0,0.019912182170938427,0.02290751897613942,84,86,2,3,2,2,5,17,63,6,29
930,16,222,47,96,49,22,22,49,49,0,16,22,48,49,1,0.002382654276864427,0.008986010415602982,47,67,20,3,3,3,2,1,93,53,77
931,6,212,31,92,61,14,18,36,37,1,6,18,31,46,15,0.0005446066918547262,0.012934408931549747,37,76,39,3,4,4,3,1,85,49,18
932,54,670,56,100,44,102,102,68,68,0,54,102,56,75,19,0.006739507811702236,0.010313489226998877,61,69,8,2,3,3,7,7,43,62,41
933,464,664,98,100,2,288,288,98,98,0,288,288,98,98,0,0.03727152047380782,0.04128799482623643,96,97,1,3,2,2,9,30,54,7,38
934,39,655,46,100,54,94,94,45,45,0,39,94,46,59,13,0.003778208924742163,0.016712617856291908,50,78,28,2,3,3,9,4,29,22,5
935,249,449,96,100,4,48,48,62,62,0,48,48,64,64,0,0.032063718982947,0.03444637325981143,91,93,2,3,3,3,3,30,64,7,28
936,0,616,1,100,99,0,60,1,38,37,0,60,1,56,55,0.0,0.01157289220191293,1,71,70,2,-1,3,9,0,54,81,30
937,0,102,1,82,81,0,5,1,28,27,0,2,1,26,25,0.0,0.00034037918240920387,1,32,31,4,-1,5,3,0,85,87,42
938,144,760,81,100,19,224,224,85,85,0,144,224,81,88,7,0.01058579257292624,0.026753803737363423,68,89,21,2,2,2,11,7,5,21,16
939,0,0,1,1,0,0,0,1,1,0,0,0,1,1,0,0.0,0.0,1,1,0,-1,-1,-1,2,0,68,40,99
940,77,283,65,95,30,44,44,49,49,0,44,44,55,55,0,0.006535280302256714,0.008543517478471017,60,65,5,3,3,3,4,8,79,57,53
941,86,86,54,54,0,180,180,64,64,0,86,86,54,54,0,0.003710133088260322,0.003710133088260322,49,49,0,-1,2,2,16,3,4,43,76
942,102,102,75,75,0,134,134,90,90,0,102,102,79,79,0,0.0123557643214541,0.0123557643214541,71,71,0,-1,2,2,6,7,74,62,69
943,14,630,41,100,59,24,34,38,42,4,14,34,41,51,10,0.003608019333537561,0.007011811157629599,51,62,11,2,4,3,4,6,79,73,54
944,0,206,1,90,89,0,24,1,33,32,0,26,1,47,46,0.0,0.003812246842983083,1,52,51,3,-1,4,6,1,74,45,26
945,16,632,36,100,64,46,56,39,43,4,16,56,36,51,15,0.002723033459273631,0.009190237925048503,45,66,21,2,3,3,6,3,56,46,44
946,0,0,1,1,0,0,0,1,1,0,0,0,1,1,0,0.0,0.0,1,1,0,-1,-1,-1,5,0,70,59,40
947,0,1640,1,100,99,0,122,1,58,57,0,56,1,50,49,0.0,0.008271214132543654,1,60,59,1,-1,2,17,0,20,59,29
948,32,648,53,100,47,22,22,48,48,0,32,22,70,51,-19,0.004663194799006093,0.014636304843595765,55,77,22,2,3,3,2,3,95,29,17
949,0,1640,1,100,99,0,180,1,69,68,0,180,1,82,81,0.0,0.0212056230640934,1,86,85,1,-1,2,16,1,9,45,15
950,6,212,32,93,61,8,8,32,32,0,6,8,32,35,3,0.00034037918240920387,0.0033357159876101976,34,51,17,3,4,4,2,1,68,88,29
951,0,616,1,100,99,0,34,1,46,45,0,34,1,54,53,0.0,0.014840532353041287,1,79,78,2,-1,3,4,0,77,87,23
952,40,1680,50,100,50,110,154,60,71,11,40,154,50,84,34,0.004561081044283332,0.026855917492086184,55,88,33,1,3,2,10,6,11,73,6
953,16,16,43,43,0,28,28,44,44,0,16,16,43,43,0,0.0026549576227917903,0.0026549576227917903,47,47,0,-1,3,3,3,1,92,53,89
954,174,380,87,98,11,262,262,84,84,0,174,182,87,87,0,0.017393376221110316,0.018176248340651485,77,80,3,3,2,2,14,12,8,37,74
955,2,1642,27,100,73,23,79,28,36,8,2,43,27,52,25,0.0002042275094455223,0.008305252050784574,29,63,34,1,5,2,13,1,13,55,56
956,386,1002,96,100,4,310,320,97,97,0,310,320,97,97,0,0.026039007454304094,0.0298852922155281,88,90,2,2,2,2,11,19,33,15,75
957,100,100,63,63,0,100,100,47,47,0,100,100,63,63,0,0.016610504101569147,0.016610504101569147,81,81,0,-1,1,1,10,2,36,58,92
958,22,1662,40,100,60,84,178,38,68,30,22,178,40,84,44,0.0005105687736138058,0.036794989618434935,36,94,58,1,3,2,14,2,25,63,2
959,2,618,28,100,72,13,58,31,42,11,2,58,28,51,23,0.0002382654276864427,0.013615167296368155,32,77,45,2,5,3,7,1,46,55,6
960,136,752,83,100,17,120,120,85,85,0,120,120,85,85,0,0.014704380680077607,0.019810068416215663,80,84,4,2,2,2,6,13,48,33,57
961,61,267,61,95,34,76,76,54,54,0,61,76,61,65,4,0.004935498144933456,0.00616086320160659,54,57,3,3,3,3,6,6,32,35,52
962,0,616,1,100,99,0,42,1,36,35,0,42,1,50,49,0.0,0.009462541270975866,1,64,63,2,-1,3,6,0,71,91,32
963,0,616,1,100,99,0,52,1,47,46,0,52,1,57,56,0.0,0.02117158514585248,1,81,80,2,-1,3,6,0,69,59,7
964,110,211,74,92,18,126,126,77,77,0,110,111,76,76,0,0.007420266176520644,0.007420266176520644,57,57,0,5,2,2,7,6,46,13,65
965,560,661,100,100,0,272,272,100,100,0,272,272,100,100,0,0.0489124885122026,0.0489124885122026,97,97,0,5,2,2,8,40,30,3,68
966,338,338,98,98,0,128,128,93,93,0,128,128,93,93,0,0.03536539705231628,0.03536539705231628,92,92,0,-1,2,2,5,30,37,7,66
967,0,616,1,100,99,0,46,1,35,34,0,34,1,45,44,0.0,0.007386228258279724,1,61,60,2,-1,3,8,1,27,45,77
968,0,206,1,94,93,0,8,1,32,31,0,6,1,32,31,0.0,0.0026209197045508697,1,48,47,3,-1,4,2,0,90,79,46
969,16,16,44,44,0,22,22,47,47,0,16,16,47,47,0,0.004493005207801491,0.004493005207801491,53,53,0,-1,3,3,2,1,89,90,93
970,403,609,100,100,0,120,120,100,100,0,120,120,100,100,0,0.06031519112291092,0.06681643350692672,97,97,0,3,2,2,3,36,66,2,32
971,40,246,49,91,42,106,106,59,59,0,40,49,49,54,5,0.004356853534837809,0.005412029000306341,54,59,5,3,3,3,11,6,38,73,64
972,8,8,36,36,0,24,24,36,36,0,8,8,36,36,0,0.0005786446100956465,0.0005786446100956465,36,36,0,-1,4,4,4,2,53,56,69
973,100,306,64,96,32,132,132,75,75,0,100,132,65,81,16,0.009632730862180468,0.011096361346540046,68,71,3,3,2,2,8,7,10,21,54
974,22,638,42,100,58,72,82,45,47,2,22,82,42,58,16,0.00176997174852786,0.015589366554341537,45,78,33,2,3,3,7,2,24,83,16
975,66,167,62,91,29,54,54,54,54,0,54,54,58,58,0,0.005037611899656217,0.005037611899656217,57,57,0,5,3,3,4,6,47,28,60
976,86,187,60,86,26,100,100,59,59,0,86,100,60,63,3,0.009258313761530345,0.009258313761530345,66,66,0,5,2,2,6,6,40,34,58
977,6,622,29,100,71,29,84,31,39,8,6,68,29,55,26,0.0002042275094455223,0.008203138296061813,31,66,35,2,4,3,12,1,3,65,20
978,22,1662,42,100,58,68,122,42,75,33,22,122,42,82,40,0.0018040096667687805,0.04047108478845434,44,96,52,1,3,2,8,2,39,52,3
979,88,189,60,90,30,154,154,72,72,0,88,89,60,62,2,0.007692569522448007,0.007692569522448007,62,62,0,5,2,2,10,4,36,72,78
980,38,244,45,91,46,106,106,55,55,0,38,44,45,47,2,0.0015317063208414173,0.002382654276864427,41,43,2,3,3,3,11,4,33,64,42
981,305,511,98,100,2,110,110,82,82,0,110,110,83,83,0,0.031110657272201234,0.03352734946730658,91,94,3,3,2,2,6,29,56,11,41
982,0,102,1,77,76,0,5,1,26,25,0,2,1,26,25,0.0,0.00010211375472276115,1,28,27,4,-1,5,4,0,53,98,4
983,2,104,27,80,53,6,6,29,29,0,2,4,27,31,4,0.00013615167296368154,0.001055175465468532,30,38,8,4,5,5,3,1,58,4,71
984,112,112,79,79,0,146,146,82,82,0,112,112,79,79,0,0.010245413390517035,0.010245413390517035,71,71,0,-1,2,2,8,4,57,38,98
985,100,100,61,61,0,100,100,43,43,0,100,100,61,61,0,0.023520201504475986,0.023520201504475986,84,84,0,4,1,1,12,5,2,25,68
986,82,82,69,69,0,86,86,86,86,0,82,82,86,86,0,0.009564655025698629,0.009564655025698629,66,66,0,-1,2,2,3,6,87,70,40
987,24,230,45,93,48,46,46,43,43,0,24,46,45,51,6,0.0012934408931549745,0.006569318220497634,40,60,20,3,3,3,6,3,65,43,38
988,0,616,1,100,99,0,86,1,42,41,0,72,1,61,60,0.0,0.01317267435923619,1,72,71,2,-1,3,10,0,12,80,37
989,0,616,1,100,99,0,64,1,39,38,0,64,1,57,56,0.0,0.008101024541339052,1,62,61,2,-1,3,8,0,15,86,31
990,370,472,97,100,3,176,176,98,98,0,176,176,98,98,0,0.03859899928520372,0.03880322679464924,92,92,0,4,2,2,5,27,61,10,65
991,46,662,48,100,52,116,188,58,70,12,46,188,48,85,37,0.002927260968719153,0.02563055243541305,49,89,40,2,2,2,14,2,25,83,0
992,58,674,61,100,39,94,104,72,81,9,58,104,61,81,20,0.005514142755029102,0.014023622315259198,59,75,16,2,2,2,5,6,80,70,48
993,62,163,69,94,25,22,22,54,54,0,22,22,54,54,0,0.011028285510058205,0.011028285510058205,71,71,0,6,3,3,2,8,99,20,58
994,126,742,79,100,21,260,260,76,76,0,126,162,79,81,2,0.013138636440995268,0.017291262466387555,71,81,10,2,2,2,16,8,9,17,26
995,0,101,1,81,80,0,3,1,24,23,0,1,1,24,23,0.0,0.0,1,1,0,6,-1,7,3,1,96,69,58
996,0,101,1,77,76,0,11,1,24,23,0,1,1,24,23,0.0,6.807583648184077e-05,1,27,26,5,-1,6,11,0,33,92,55
997,178,794,93,100,7,72,72,77,77,0,72,72,79,79,0,0.026855917492086184,0.033084856530174615,91,93,2,2,2,2,3,20,96,23,47
998,64,680,59,100,41,134,134,69,69,0,64,99,59,65,6,0.006977773239388679,0.011062323428299126,61,70,9,2,3,3,9,7,54,62,28
999,2,2,29,29,0,10,10,31,31,0,2,2,29,29,0,0.00010211375472276115,0.00010211375472276115,30,30,0,-1,5,5,5,1,49,65,87
