,FreeNet_pre_score,FreeNet_post_score,FreeNet_pre_rank,FreeNet_post_rank,FreeNet_delta_ranks,Reversed_pre_score,Reversed_post_score,Reversed_pre_rank,Reversed_post_rank,Reversed_delta_ranks,Independent_pre_score,Independent_post_score,Independent_pre_rank,Independent_post_rank,Independent_delta_ranks,Random_pre_score,Random_post_score,Random_pre_rank,Random_post_rank,Random_delta_ranks,dist_victim_relayer,dist_victim_vilain_pre,dist_victim_vilain_post,out_deg_victim,in_deg_villain,victim,villain,relayer
0,40,656,47,100,53,186,210,66,71,5,40,155,47,85,38,0.0025188059498281084,0.01940161339732462,45,81,36,2,2,2,16,1,4,53,23
1,0,206,1,93,92,0,12,1,33,32,0,9,1,39,38,0.0,0.0011232513019503727,1,41,40,3,-1,4,4,0,72,99,64
2,40,656,47,100,53,66,80,44,55,11,40,80,47,60,13,0.003437829742332959,0.012219612648490419,46,72,26,2,2,2,6,1,51,71,21
3,118,219,86,96,10,72,72,79,79,0,72,72,80,80,0,0.02038871302631131,0.02038871302631131,85,85,0,5,2,2,3,9,75,39,60
4,54,260,60,97,37,38,38,51,51,0,38,38,54,54,0,0.007352190340038803,0.0088498587426393,62,65,3,3,3,3,3,4,94,38,53
5,22,638,40,99,59,102,152,57,65,8,22,152,40,87,47,0.0017359338302869397,0.025154021580040164,44,88,44,2,3,3,12,2,6,83,1
6,49,149,64,89,25,22,22,47,47,0,22,22,52,52,0,0.005582218591510943,0.005582218591510943,60,60,0,6,3,3,2,4,89,22,58
7,100,100,61,61,0,100,100,43,43,0,100,100,61,61,0,0.03536539705231628,0.035569624561761805,95,95,0,3,1,1,12,19,2,15,56
8,0,206,1,93,92,0,18,1,34,33,0,18,1,44,43,0.0,0.011368664692467409,1,70,69,3,-1,4,3,0,58,92,37
9,0,1640,1,100,99,0,118,1,63,62,0,118,1,74,73,0.0,0.02828551005820484,1,89,88,1,-1,2,9,0,28,82,23
10,74,1714,69,100,31,38,72,55,79,24,38,72,58,79,21,0.011096361346540046,0.05915790190271963,72,97,25,1,3,2,3,9,76,27,30
11,100,100,76,76,0,100,100,96,96,0,100,100,96,96,0,0.0549372000408455,0.057183702644746245,97,99,2,3,1,1,3,4,58,22,75
12,100,100,58,58,0,100,100,35,35,0,100,100,59,59,0,0.014772456516559448,0.035705776234725484,75,93,18,1,1,1,17,5,20,47,9
13,2,2,29,29,0,7,7,29,29,0,2,2,29,29,0,0.0002042275094455223,0.0002042275094455223,32,32,0,-1,5,5,4,1,73,55,50
14,6,212,30,91,61,12,16,30,32,2,6,16,30,40,10,0.00010211375472276115,0.0028932230504782326,29,49,20,3,4,4,4,1,83,65,35
15,0,206,1,93,92,0,17,1,29,28,0,8,1,34,33,0.0,0.00030634126416828345,1,32,31,3,-1,4,9,0,23,97,63
16,217,217,89,89,0,160,160,86,86,0,160,160,88,88,0,0.017052997038701112,0.017052997038701112,79,79,0,-1,2,2,7,15,24,19,80
17,128,128,85,85,0,94,94,75,75,0,94,94,75,75,0,0.018925082541951733,0.018925082541951733,81,81,0,-1,2,2,5,9,49,39,80
18,2,208,29,90,61,14,34,29,33,4,2,14,29,39,10,0.00013615167296368154,0.0031314884781646754,30,45,15,3,5,4,9,1,26,60,29
19,0,1640,1,100,99,0,56,1,81,80,0,56,1,81,80,0.0,0.0781510602811532,1,99,98,1,-1,2,2,0,89,87,3
20,169,375,85,98,13,152,152,83,83,0,152,152,86,86,0,0.017291262466387555,0.018040096667687803,78,79,1,3,2,2,8,15,21,19,71
21,120,720,86,100,14,48,48,73,73,0,48,48,75,75,0,0.023554239422716908,0.04499812791449675,88,96,8,2,3,3,3,20,92,23,0
22,0,206,1,94,93,0,12,1,39,38,0,12,1,41,40,0.0,0.011879233466081215,1,74,73,3,-1,4,2,0,90,99,18
23,52,52,53,53,0,80,80,54,54,0,52,52,53,53,0,0.004322815616596889,0.004322815616596889,54,54,0,-1,2,2,6,3,40,43,59
24,0,206,1,87,86,0,44,1,32,31,0,10,1,33,32,0.0,0.001497668402600497,1,42,41,3,-1,4,16,1,9,69,54
25,0,206,1,93,92,0,18,1,40,39,0,18,1,44,43,0.0,0.011334626774226489,1,71,70,3,-1,4,3,1,60,45,6
26,0,102,1,75,74,0,8,1,25,24,0,2,1,25,24,0.0,3.4037918240920386e-05,1,26,25,4,-1,5,6,0,51,84,95
27,100,100,66,66,0,100,100,45,45,0,100,100,66,66,0,0.03315293236665646,0.038564961366962795,90,95,5,2,1,1,10,12,1,37,48
28,1,617,26,100,74,5,52,26,54,28,1,52,26,54,28,3.4037918240920386e-05,0.01327478811395895,27,74,47,2,6,3,5,2,70,58,14
29,246,452,90,99,9,200,200,93,93,0,200,200,93,93,0,0.024166921951053473,0.025154021580040164,86,86,0,3,2,2,8,16,27,18,64
30,0,0,1,1,0,0,0,1,1,0,0,0,1,1,0,0.0,0.0,1,1,0,-1,-1,-1,6,0,59,80,87
31,86,702,60,100,40,100,110,59,71,12,86,110,60,75,15,0.009258313761530345,0.03563770039824364,66,94,28,2,2,2,6,6,40,34,10
32,16,16,42,42,0,24,24,42,42,0,16,16,42,42,0,0.0007147962830593281,0.0007147962830593281,37,37,0,-1,3,3,3,1,75,88,85
33,75,177,60,87,27,118,118,75,75,0,75,77,60,62,2,0.007386228258279724,0.00796487286837537,60,60,0,4,2,2,9,6,26,35,71
34,44,146,66,93,27,12,12,39,39,0,12,12,44,44,0,0.008203138296061813,0.010041185881071514,66,70,4,4,4,4,2,8,97,8,70
35,2,104,27,84,57,4,5,27,29,2,2,4,27,30,3,6.807583648184077e-05,0.0007488342013002485,27,35,8,4,5,5,3,1,92,60,42
36,42,658,54,100,46,98,98,53,53,0,40,98,54,68,14,0.0034718676605738795,0.011606930120153852,51,73,22,2,3,3,8,6,57,41,77
37,40,141,49,85,36,84,84,40,40,0,40,41,49,54,5,0.002212464685659825,0.002280540522141666,45,46,1,5,2,2,11,2,38,42,68
38,0,206,1,97,96,0,12,1,38,37,0,12,1,43,42,0.0,0.01681473161101467,1,81,80,3,-1,4,2,1,97,50,9
39,34,240,47,93,46,80,80,45,45,0,34,42,47,50,3,0.0013955546478777359,0.0022465026039007454,41,44,3,3,3,3,9,4,31,64,74
40,46,46,58,58,0,22,22,48,48,0,22,22,51,51,0,0.007726607440688927,0.007726607440688927,63,63,0,-1,3,3,2,7,95,21,80
41,78,694,61,100,39,124,134,75,76,1,78,134,61,84,23,0.008237176214302734,0.021852343510670887,66,84,18,2,3,3,9,8,23,44,18
42,362,464,98,100,2,158,158,97,97,0,158,158,97,97,0,0.03897341638585384,0.039994553933081455,96,96,0,4,2,2,6,29,71,0,51
43,45,251,62,98,36,32,32,69,69,0,32,32,69,69,0,0.005990673610401988,0.010279451308757957,58,69,11,3,3,3,2,6,93,28,13
44,0,616,1,100,99,0,28,1,42,41,0,28,1,48,47,0.0,0.013615167296368155,1,79,78,2,-1,3,3,0,75,84,12
45,60,266,64,96,32,38,38,59,59,0,38,38,62,62,0,0.006058749446883829,0.008986010415602982,57,69,12,3,3,3,3,6,92,28,35
46,168,768,89,100,11,110,110,80,80,0,110,110,83,83,0,0.013989584397018279,0.0176997174852786,77,82,5,2,2,2,6,14,48,32,13
47,90,706,65,100,35,126,136,68,75,7,88,136,64,83,19,0.006092787365124749,0.024779604479390042,59,86,27,2,2,2,8,6,30,41,16
48,0,0,1,1,0,0,0,1,1,0,0,0,1,1,0,0.0,0.0,1,1,0,-1,-1,-1,5,0,63,96,91
49,12,628,35,100,65,28,56,35,43,8,12,56,35,53,18,0.0009870996289866913,0.011606930120153852,39,71,32,2,4,3,6,3,41,51,33
50,202,1802,92,100,8,216,216,80,80,0,216,216,92,92,0,0.018788930868988054,0.055788147996868515,81,99,18,1,2,2,12,18,6,30,2
51,83,83,71,71,0,64,64,68,68,0,64,64,70,70,0,0.01507879778072773,0.01507879778072773,79,79,0,-1,3,3,4,9,78,39,96
52,100,100,77,77,0,100,100,96,96,0,100,100,96,96,0,0.07610878518669797,0.07610878518669797,98,98,0,-1,1,1,3,20,66,23,98
53,100,100,57,57,0,100,100,38,38,0,100,100,57,57,0,0.011402702610708328,0.011402702610708328,70,70,0,-1,1,1,16,2,4,56,97
54,16,632,35,100,65,78,88,45,47,2,16,54,35,53,18,0.002484768031587188,0.010109261717553355,47,66,19,2,3,3,8,2,15,94,25
55,543,644,100,100,0,232,232,100,100,0,232,232,100,100,0,0.0490826781034072,0.049048640185166276,95,95,0,6,2,2,7,40,46,3,78
56,106,208,83,93,10,64,64,68,68,0,64,64,69,69,0,0.009973110044589673,0.012049423057285817,70,75,5,4,3,3,4,13,73,24,90
57,0,616,1,100,99,0,70,1,35,34,0,36,1,45,44,0.0,0.003880322679464924,1,53,52,2,-1,3,14,0,17,76,28
58,170,786,87,100,13,150,150,86,86,0,150,150,86,86,0,0.01592974573675074,0.032063718982947,78,89,11,2,2,2,7,13,43,33,16
59,130,746,87,100,13,72,72,84,84,0,72,72,84,84,0,0.022601177711971135,0.03223390857415161,87,91,4,2,2,2,3,18,85,30,39
60,75,75,73,73,0,22,22,52,52,0,22,22,54,54,0,0.010994247591817285,0.010994247591817285,68,68,0,-1,3,3,2,14,86,32,66
61,100,100,59,59,0,100,100,46,46,0,100,100,59,59,0,0.04932094353109364,0.055958337588073115,99,100,1,2,1,1,11,29,5,1,27
62,100,100,60,60,0,100,100,50,50,0,100,100,60,60,0,0.04952517104053916,0.05235031825453555,96,98,2,2,1,1,9,29,28,11,94
63,80,286,60,95,35,142,142,71,71,0,80,86,60,60,0,0.010347527145239796,0.011164437183021887,68,70,2,3,2,2,8,6,15,77,71
64,100,100,64,64,0,100,100,45,45,0,100,100,64,64,0,0.05680928554409612,0.07005003573981415,99,100,1,2,1,1,10,40,18,3,6
65,112,1752,74,100,26,208,232,89,93,4,112,152,74,82,8,0.008577555396711936,0.020048333843902106,65,84,19,1,2,2,10,7,0,62,46
66,0,0,1,1,0,0,0,1,1,0,0,0,1,1,0,0.0,0.0,1,1,0,-1,-1,-1,3,0,60,97,80
67,170,272,90,94,4,128,128,93,93,0,128,128,93,93,0,0.018959120460192654,0.019265461724360937,82,82,0,4,2,2,5,14,88,14,42
68,58,58,57,57,0,54,54,52,52,0,54,54,55,55,0,0.008509479560230097,0.008509479560230097,66,66,0,-1,3,3,4,6,83,34,50
69,0,0,1,1,0,0,0,1,1,0,0,0,1,1,0,0.0,0.0,1,1,0,-1,-1,-1,16,0,4,98,69
70,0,1640,1,100,99,0,116,1,57,56,0,88,1,56,55,0.0,0.014227849824704722,1,72,71,1,-1,2,14,0,25,85,27
71,40,40,54,54,0,54,54,52,52,0,54,54,55,55,0,0.006058749446883829,0.006058749446883829,57,57,0,-1,3,3,4,6,83,26,92
72,0,206,1,91,90,0,22,1,33,32,0,19,1,44,43,0.0,0.002382654276864427,1,46,45,3,-1,4,7,0,62,36,22
73,16,1656,38,100,62,60,104,51,84,33,16,104,38,85,47,0.003914360597705844,0.04595118962524252,51,96,45,1,3,2,5,3,37,46,10
74,490,1106,99,100,1,312,312,98,98,0,312,312,98,98,0,0.036794989618434935,0.04278566322883692,96,97,1,2,2,2,12,30,2,7,26
75,100,100,68,68,0,100,100,57,57,0,100,100,68,68,0,0.032199870655910685,0.03277851526600633,91,91,0,3,1,1,8,9,39,27,88
76,406,406,97,97,0,192,192,100,100,0,192,192,100,100,0,0.03921168181354028,0.03921168181354028,95,95,0,-1,2,2,6,27,40,10,98
77,235,235,95,95,0,72,72,84,84,0,72,72,84,84,0,0.03699921712788046,0.03699921712788046,93,93,0,-1,2,2,3,29,85,0,84
78,100,100,69,69,0,100,100,66,66,0,100,100,75,75,0,0.03512713162462984,0.039824364341876854,93,95,2,2,1,1,6,9,51,27,35
79,122,223,91,98,7,56,56,92,92,0,56,56,92,92,0,0.029544913033118896,0.029715102624323496,91,91,0,6,2,2,2,17,97,6,95
80,100,100,65,65,0,100,100,47,47,0,100,100,65,65,0,0.059498281085128835,0.06239150413560707,99,100,1,2,1,1,11,40,38,3,46
81,2,2,26,26,0,9,9,26,26,0,2,2,26,26,0,6.807583648184077e-05,6.807583648184077e-05,27,27,0,-1,5,5,8,1,27,78,69
82,112,112,76,76,0,144,144,89,89,0,112,112,83,83,0,0.009836958371625992,0.009836958371625992,68,68,0,-1,2,2,6,4,40,72,50
83,125,331,79,96,17,102,102,65,65,0,102,102,74,74,0,0.016202049082678104,0.019061234214915415,79,84,5,3,3,3,7,12,46,37,29
84,100,716,79,100,21,56,56,80,80,0,56,56,81,81,0,0.014840532353041287,0.03267640151128357,79,93,14,2,2,2,2,13,91,24,9
85,0,206,1,95,94,0,14,1,31,30,0,14,1,38,37,0.0,0.00707988699411144,1,62,61,3,-1,4,3,0,94,87,24
86,140,346,89,98,9,48,48,54,54,0,48,48,56,56,0,0.020831205963443275,0.021341774737057083,85,86,1,3,3,3,3,20,87,23,63
87,16,16,37,37,0,66,66,49,49,0,16,16,37,37,0,0.003914360597705844,0.003914360597705844,52,52,0,-1,3,3,6,1,41,90,84
88,97,198,65,90,25,80,80,53,53,0,80,80,60,60,0,0.009462541270975866,0.009462541270975866,67,67,0,5,3,3,5,8,52,44,68
89,226,1826,92,100,8,176,176,85,85,0,176,176,89,89,0,0.019571802988529223,0.04077742605262262,82,96,14,1,2,2,8,18,42,30,19
90,118,118,81,81,0,104,104,85,85,0,104,104,85,85,0,0.014806494434800367,0.014806494434800367,75,75,0,-1,2,2,5,9,70,27,84
91,100,100,59,59,0,100,100,39,39,0,100,100,59,59,0,0.04962728479526192,0.05003573981415296,98,98,0,3,1,1,14,29,16,1,51
92,203,305,94,95,1,144,144,91,91,0,144,144,91,91,0,0.025766704108376733,0.02631131080023146,88,88,0,4,2,2,6,15,32,16,74
93,0,206,1,89,88,0,32,1,35,34,0,32,1,43,42,0.0,0.007182000748834201,1,58,57,3,-1,4,6,0,71,82,27
94,136,237,79,93,14,152,152,76,76,0,136,137,80,80,0,0.01412573606998196,0.01412573606998196,78,78,0,5,2,2,8,8,15,20,68
95,115,321,85,98,13,48,48,59,59,0,48,48,63,63,0,0.0141938119064638,0.014534191088873005,80,80,0,3,3,3,3,15,75,19,88
96,16,117,39,80,41,46,46,43,43,0,16,17,39,43,4,0.0017359338302869397,0.0017359338302869397,43,43,0,6,3,3,6,2,69,94,68
97,2,2,29,29,0,3,3,29,29,0,2,2,29,29,0,0.0002042275094455223,0.0002042275094455223,32,32,0,-1,5,5,2,1,90,55,76
98,260,362,93,99,6,328,328,91,91,0,258,260,93,93,0,0.0195377650702883,0.019639878825011062,85,85,0,4,2,2,16,18,9,5,60
99,70,276,65,98,33,38,38,46,46,0,38,38,51,51,0,0.010347527145239796,0.015385139044896015,74,79,5,3,3,3,3,9,96,27,34
100,1,1,26,26,0,6,6,26,26,0,1,1,26,26,0,3.4037918240920386e-05,3.4037918240920386e-05,28,28,0,-1,6,6,6,1,41,78,50
101,16,16,32,32,0,48,48,33,33,0,16,16,32,32,0,0.0002723033459273631,0.0002723033459273631,31,31,0,-1,3,3,14,1,8,95,66
102,16,632,35,100,65,100,120,45,64,19,16,54,35,52,17,0.0020422750944552232,0.009530617107457708,45,69,24,2,3,3,10,1,1,53,25
103,100,100,71,71,0,100,100,79,79,0,100,100,79,79,0,0.030361823070900983,0.05544776881445931,88,100,12,1,1,1,5,4,70,64,34
104,78,694,71,100,29,48,48,64,64,0,48,48,66,66,0,0.01245787807617686,0.034140031995643146,74,92,18,2,3,3,3,8,85,20,1
105,210,312,94,97,3,94,94,71,71,0,94,94,72,72,0,0.019912182170938427,0.020695054290479593,84,84,0,4,2,2,5,17,63,6,74
106,0,0,1,1,0,0,0,1,1,0,0,0,1,1,0,0.0,0.0,1,1,0,-1,-1,-1,2,0,93,76,82
107,2,208,28,96,68,4,12,30,38,8,2,12,28,44,16,0.00013615167296368154,0.02127369890057524,31,86,55,3,5,4,2,1,93,60,11
108,0,616,1,100,99,0,34,1,33,32,0,24,1,42,41,0.0,0.0030974505599237552,1,47,46,2,-1,3,8,0,27,98,43
109,0,616,1,100,99,0,72,1,34,33,0,25,1,39,38,0.0,0.0036760951700194017,1,51,50,2,-1,3,15,0,7,85,41
110,83,699,71,100,29,64,64,68,68,0,64,64,70,70,0,0.01507879778072773,0.03301678069369277,79,93,14,2,3,3,4,9,78,39,9
111,15,631,44,100,56,18,28,38,45,7,18,28,47,50,3,0.003880322679464924,0.014534191088873005,52,78,26,2,4,3,3,6,85,73,39
112,6,622,29,99,70,30,58,30,33,3,6,22,29,39,10,0.0,0.002212464685659825,1,45,44,2,4,3,12,1,6,95,53
113,54,155,59,87,28,60,60,52,52,0,54,55,60,61,1,0.006909697402906838,0.00704584907587052,60,60,0,5,3,3,5,7,45,62,65
114,100,100,64,64,0,100,100,44,44,0,100,100,64,64,0,0.02757071377514551,0.03002144388849178,89,90,1,3,1,1,13,13,13,33,90
115,1,617,25,100,75,3,28,25,39,14,1,28,25,48,23,6.807583648184077e-05,0.01153885428367201,27,73,46,2,6,3,3,1,82,78,33
116,40,40,47,47,0,144,144,61,61,0,40,40,47,47,0,0.0030974505599237552,0.0030974505599237552,48,48,0,-1,2,2,10,1,0,53,45
117,0,616,1,100,99,0,52,1,39,38,0,52,1,50,49,0.0,0.014500153170632085,1,75,74,2,-1,3,6,0,56,86,30
118,22,638,43,100,57,58,88,43,51,8,22,88,43,64,21,0.0023486163586235067,0.014466115252391163,47,76,29,2,3,3,8,2,21,75,8
119,40,142,61,93,32,22,22,55,55,0,22,22,57,57,0,0.005548180673270023,0.00622893903808843,58,61,3,4,3,3,2,6,97,41,43
120,0,1640,1,100,99,0,188,1,68,67,0,188,1,86,85,0.0,0.03002144388849178,1,93,92,1,-1,2,14,0,16,96,1
121,34,34,52,52,0,54,54,55,55,0,34,34,52,52,0,0.0034037918240920387,0.0034037918240920387,51,51,0,-1,3,3,4,6,73,70,96
122,78,78,63,63,0,142,142,79,79,0,78,78,63,63,0,0.009190237925048503,0.009190237925048503,67,67,0,-1,2,2,8,7,57,62,99
123,160,366,86,96,10,104,104,73,73,0,104,104,79,79,0,0.01776779332176044,0.01858470335954253,82,82,0,3,2,2,5,12,52,37,51
124,0,102,1,84,83,0,4,1,28,27,0,4,1,31,30,0.0,0.0026209197045508697,1,48,47,4,-1,5,2,0,98,87,73
125,314,930,95,100,5,264,264,93,93,0,264,264,93,93,0,0.02314578440382586,0.04731270635487934,85,98,13,2,2,2,12,19,3,15,0
126,166,268,88,97,9,210,210,78,78,0,166,168,88,88,0,0.01412573606998196,0.014295925661186561,73,75,2,4,2,2,12,8,6,8,65
127,6,6,29,29,0,18,18,33,33,0,6,6,29,29,0,0.00017018959120460194,0.00017018959120460194,32,32,0,-1,4,4,5,1,61,4,97
128,6,108,29,79,50,34,34,30,30,0,6,8,29,33,4,0.0002723033459273631,0.0005446066918547262,30,33,3,4,4,4,13,1,13,4,60
129,100,100,64,64,0,100,100,44,44,0,100,100,64,64,0,0.03478675244222063,0.03553558664352088,92,93,1,3,1,1,13,19,13,15,71
130,0,102,1,81,80,0,5,1,27,26,0,4,1,28,27,0.0,0.0010211375472276116,1,37,36,4,-1,5,3,0,82,89,51
131,100,100,65,65,0,100,100,75,75,0,100,100,77,77,0,0.04625753088941081,0.05085264985193506,97,99,2,2,1,1,5,16,61,12,72
132,6,212,30,92,62,24,33,32,33,1,6,20,30,40,10,0.0002723033459273631,0.0031314884781646754,33,49,16,3,4,4,9,1,35,60,41
133,56,157,58,84,26,90,90,65,65,0,56,57,58,59,1,0.006024711528642908,0.006058749446883829,57,57,0,5,2,2,6,3,34,29,68
134,0,206,1,94,93,0,18,1,37,36,0,18,1,43,42,0.0,0.018925082541951733,1,84,83,3,-1,4,3,0,96,85,1
135,0,1640,1,100,99,0,134,1,62,61,0,125,1,79,78,0.0,0.0195377650702883,1,80,79,1,-1,2,14,1,16,45,6
136,0,616,1,100,99,0,94,1,41,40,0,94,1,60,59,0.0,0.0123557643214541,1,70,69,2,-1,3,12,0,2,66,5
137,100,100,59,59,0,100,100,45,45,0,100,100,59,59,0,0.027945130875795636,0.037475747983253344,89,94,5,2,1,1,10,8,0,20,33
138,38,1678,50,100,50,78,112,45,62,17,38,112,50,77,27,0.0021784267674189047,0.024983831988835564,45,89,44,1,3,2,8,3,15,54,8
139,16,222,35,90,55,80,80,40,40,0,16,38,35,46,11,0.0023486163586235067,0.009598692943939549,47,67,20,3,3,3,10,2,12,94,34
140,100,100,61,61,0,100,100,44,44,0,100,100,61,61,0,0.023179822322066782,0.028421661731168522,85,89,4,2,1,1,12,7,6,21,57
141,202,304,93,96,3,104,104,86,86,0,104,104,86,86,0,0.02566459035365397,0.025834779944858572,88,88,0,4,2,2,5,19,45,15,49
142,0,206,1,89,88,0,14,1,28,27,0,6,1,28,27,0.0,0.00013615167296368154,1,30,29,3,-1,4,8,0,42,84,4
143,0,102,1,77,76,0,12,1,26,25,0,2,1,26,25,0.0,3.4037918240920386e-05,1,27,26,4,-1,5,11,0,33,36,65
144,100,100,58,58,0,100,100,38,38,0,100,100,58,58,0,0.04782327512849314,0.04857210932979339,97,97,0,3,1,1,16,29,9,1,43
145,16,16,33,33,0,32,32,28,28,0,16,16,33,33,0,0.0005446066918547262,0.0005446066918547262,34,34,0,-1,3,3,16,2,4,58,84
146,230,436,95,100,5,152,152,95,95,0,152,152,95,95,0,0.023213860240307704,0.023622315259198747,87,87,0,3,2,2,5,18,63,5,56
147,16,222,36,92,56,76,76,54,54,0,16,37,36,46,10,0.0033016780693692774,0.007011811157629599,47,59,12,3,3,3,6,2,56,94,28
148,100,100,59,59,0,100,100,46,46,0,100,100,59,59,0,0.026243234963749616,0.027026107083290785,87,87,0,3,1,1,11,8,5,17,51
149,32,32,52,52,0,38,38,56,56,0,32,32,58,58,0,0.003165526396405596,0.003165526396405596,48,48,0,-1,3,3,3,2,58,75,98
150,29,645,57,100,43,32,32,63,63,0,32,32,65,65,0,0.0046972327172470135,0.03917764389529936,56,95,39,2,3,3,2,4,98,22,2
151,0,616,1,100,99,0,62,1,42,41,0,41,1,55,54,0.0,0.006739507811702236,1,59,58,2,-1,3,7,0,24,76,25
152,25,231,54,94,40,44,44,53,53,0,25,29,54,54,0,0.005071649817897137,0.007147962830593281,58,62,4,3,3,3,4,6,78,73,46
153,100,100,66,66,0,100,100,52,52,0,100,100,66,66,0,0.06964158072092311,0.07049252867694612,100,100,0,3,1,1,8,36,15,2,74
154,56,158,61,89,28,64,64,68,68,0,64,64,71,71,0,0.010279451308757957,0.010381565063480718,70,72,2,4,3,3,4,5,72,25,56
155,2,1642,27,100,73,10,90,28,62,34,2,90,27,68,41,3.4037918240920386e-05,0.04428333163143742,27,96,69,1,5,2,6,1,65,95,2
156,16,632,34,100,66,68,88,41,46,5,16,88,34,59,25,0.002314578440382586,0.02110350930937064,45,85,40,2,3,3,8,2,42,94,0
157,400,1000,97,100,3,224,224,96,96,0,224,224,96,96,0,0.03652268627250757,0.04894652643044351,93,99,6,2,2,2,8,27,15,10,23
158,40,40,60,60,0,22,22,52,52,0,22,22,55,55,0,0.005616256509751864,0.005616256509751864,59,59,0,-1,3,3,2,5,98,47,87
159,16,632,35,100,65,78,88,44,48,4,16,48,35,49,14,0.0020763130126961434,0.005786446100956465,41,57,16,2,3,3,8,1,27,53,35
160,0,206,1,86,85,0,50,1,33,32,0,27,1,44,43,0.0,0.00616086320160659,1,55,54,3,-1,4,11,1,5,69,34
161,88,190,78,93,15,32,32,63,63,0,32,32,65,65,0,0.01232172640321318,0.01405766023350012,76,79,3,4,3,3,2,9,98,27,75
162,8,624,38,100,62,20,34,35,43,8,8,34,38,51,13,0.0006807583648184077,0.013513053541645392,37,78,41,2,4,3,4,3,47,51,5
163,6,622,29,100,71,30,86,30,42,12,6,86,29,63,34,0.0,0.014772456516559448,1,74,73,2,4,3,10,1,12,95,15
164,66,272,72,100,28,32,32,69,69,0,32,32,69,69,0,0.011198475101262807,0.018244324177133328,72,82,10,3,3,3,2,9,90,27,20
165,73,175,64,91,27,54,54,54,54,0,54,54,58,58,0,0.006773545729943157,0.007726607440688927,60,62,2,4,3,3,4,8,47,57,64
166,10,10,40,40,0,24,24,38,38,0,10,10,40,40,0,0.0009190237925048504,0.0009190237925048504,38,38,0,-1,4,4,4,3,72,43,85
167,6,212,31,93,62,14,26,31,36,5,6,26,31,49,18,0.00030634126416828345,0.007726607440688927,33,65,32,3,4,4,5,1,70,88,32
168,0,206,1,96,95,0,8,1,33,32,0,8,1,39,38,0.0,0.016202049082678104,1,80,79,3,-1,4,2,0,93,59,9
169,0,616,1,100,99,0,50,1,45,44,0,50,1,56,55,0.0,0.01606589740971442,1,82,81,2,-1,3,5,0,80,85,16
170,29,235,51,93,42,50,50,50,50,0,29,35,51,52,1,0.004935498144933456,0.006705469893461316,54,59,5,3,3,3,5,4,70,22,46
171,0,0,1,1,0,0,0,1,1,0,0,0,1,1,0,0.0,0.0,1,1,0,-1,-1,-1,10,0,36,80,89
172,0,0,1,1,0,0,0,1,1,0,0,0,1,1,0,0.0,0.0,1,1,0,-1,-1,-1,6,0,41,84,92
173,38,140,52,87,35,56,56,47,47,0,36,38,52,52,0,0.0035739814152966403,0.003948398515946765,52,52,0,4,3,3,6,6,32,41,49
174,0,0,1,1,0,0,0,1,1,0,0,0,1,1,0,0.0,0.0,1,1,0,-1,-1,-1,4,0,78,84,98
175,0,616,1,100,99,0,40,1,42,41,0,40,1,51,50,0.0,0.01405766023350012,1,77,76,2,-1,3,5,0,45,86,6
176,194,1834,89,100,11,120,144,88,93,5,120,144,87,93,6,0.02215868477483917,0.04111780523503183,83,96,13,1,2,2,6,16,71,18,70
177,100,100,58,58,0,100,100,35,35,0,100,100,59,59,0,0.03192756730998332,0.03213179481942884,91,91,0,4,1,1,17,16,20,18,65
178,426,626,99,100,1,152,152,96,96,0,152,152,96,96,0,0.05071649817897137,0.051533408216753465,99,99,0,3,2,2,5,36,61,2,42
179,134,750,77,100,23,228,228,77,77,0,134,168,77,83,6,0.006569318220497634,0.011879233466081215,58,68,10,2,2,2,15,6,7,13,62
180,0,102,1,82,81,0,6,1,28,27,0,5,1,32,31,0.0,0.0008169100377820892,1,37,36,4,-1,5,3,1,75,50,64
181,0,616,1,100,99,0,46,1,35,34,0,34,1,45,44,0.0,0.007284114503556962,1,60,59,2,-1,3,8,0,27,40,77
182,16,222,42,96,54,38,38,47,47,0,16,38,42,52,10,0.0026889955410327104,0.008237176214302734,48,64,16,3,3,3,3,2,75,94,31
183,63,63,61,61,0,72,72,77,77,0,72,72,77,77,0,0.007352190340038803,0.007352190340038803,64,64,0,-1,2,2,3,4,64,22,36
184,0,616,1,100,99,0,100,1,44,43,0,100,1,63,62,0.0,0.021716191837707205,1,84,83,2,-1,3,10,0,18,87,11
185,100,100,76,76,0,100,100,96,96,0,100,100,96,96,0,0.05589026175159127,0.05589026175159127,98,98,0,-1,1,1,3,6,58,35,91
186,190,396,88,98,10,176,176,79,79,0,176,176,86,86,0,0.017427414139351238,0.01960584090677014,79,80,1,3,3,3,11,17,38,6,90
187,6,6,29,29,0,18,18,29,29,0,6,6,29,29,0,0.0002723033459273631,0.0002723033459273631,33,33,0,-1,4,4,8,1,30,55,66
188,0,101,1,81,80,0,4,1,25,24,0,1,1,25,24,0.0,3.4037918240920386e-05,1,26,25,6,-1,7,4,0,77,99,68
189,80,80,70,70,0,88,88,82,82,0,88,88,82,82,0,0.01320671227747711,0.01320671227747711,77,77,0,-1,2,2,4,5,78,25,96
190,54,670,65,100,35,38,38,61,61,0,38,38,63,63,0,0.006501242384015794,0.017155110793423873,63,78,15,2,3,3,3,4,81,38,20
191,62,62,53,53,0,108,108,58,58,0,62,62,53,53,0,0.003165526396405596,0.003165526396405596,49,49,0,-1,2,2,12,3,3,54,80
192,46,662,54,100,46,90,104,49,63,14,46,104,54,77,23,0.005071649817897137,0.014500153170632085,53,75,22,2,2,2,9,2,35,75,39
193,36,242,52,96,44,38,38,47,47,0,38,38,53,53,0,0.0040845501889104465,0.012389802239695021,52,77,25,3,3,3,3,6,75,41,17
194,0,101,1,77,76,0,11,1,25,24,0,1,1,25,24,0.0,0.0,1,1,0,6,-1,7,11,0,33,76,78
195,38,244,53,93,40,118,118,69,69,0,38,46,53,55,2,0.003608019333537561,0.006467204465774873,52,60,8,3,3,3,8,6,57,70,29
196,116,217,77,94,17,128,128,90,90,0,128,128,90,90,0,0.011947309302563056,0.011981347220803976,71,71,0,5,2,2,5,7,63,48,58
197,525,525,99,99,0,360,360,99,99,0,360,360,99,99,0,0.036658837945471257,0.036658837945471257,93,93,0,-1,2,2,12,29,6,1,86
198,40,656,47,100,53,128,138,70,74,4,40,80,47,57,10,0.005548180673270023,0.011232513019503728,55,69,14,2,2,2,9,1,29,90,57
199,80,696,73,100,27,32,32,64,64,0,32,32,64,64,0,0.012559991830899623,0.036760951700194014,74,96,22,2,3,3,2,13,89,33,11
200,88,704,60,100,40,164,164,77,77,0,88,134,60,83,23,0.007352190340038803,0.013444977705163553,61,76,15,2,2,2,10,7,36,62,21
201,40,141,57,87,30,28,28,44,44,0,28,28,54,54,0,0.0051397256543789785,0.0051397256543789785,59,59,0,5,3,3,3,6,76,26,95
202,0,206,1,94,93,0,12,1,39,38,0,12,1,41,40,0.0,0.005003573981415297,1,56,55,3,-1,4,2,1,90,50,72
203,125,227,83,94,11,60,60,53,53,0,60,60,60,60,0,0.014329963579427483,0.01504475986248681,76,78,2,4,3,3,5,15,49,19,74
204,100,100,67,67,0,100,100,55,55,0,100,100,67,67,0,0.05670717178937336,0.05670717178937336,99,99,0,-1,1,1,9,29,23,1,85
205,100,100,62,62,0,100,100,43,43,0,100,100,62,62,0,0.029919330133769018,0.032948704857210936,91,92,1,2,1,1,12,15,14,19,22
206,88,704,61,100,39,142,142,78,78,0,88,142,61,81,20,0.010041185881071514,0.0313829606181286,66,92,26,2,2,2,8,4,27,38,0
207,64,680,54,100,46,164,174,66,66,0,64,174,54,84,30,0.005616256509751864,0.014568229007113924,54,74,20,2,2,2,15,6,7,73,14
208,6,622,33,100,67,30,40,40,42,2,6,40,33,52,19,0.0012934408931549745,0.007794683277170768,40,63,23,2,4,3,5,1,49,71,31
209,126,126,82,82,0,80,80,59,59,0,80,80,63,63,0,0.009632730862180468,0.009632730862180468,69,69,0,-1,3,3,5,13,61,24,87
210,0,0,1,1,0,0,0,1,1,0,0,0,1,1,0,0.0,0.0,1,1,0,-1,-1,-1,9,1,29,69,82
211,1,207,26,95,69,2,8,26,31,5,1,8,26,37,11,0.0,0.005446066918547262,1,57,56,3,6,4,2,1,95,78,44
212,6,6,30,30,0,28,28,34,34,0,6,6,30,30,0,0.0002042275094455223,0.0002042275094455223,29,29,0,-1,4,4,6,1,71,4,87
213,0,616,1,100,99,0,66,1,47,46,0,66,1,58,57,0.0,0.017495489975833077,1,80,79,2,-1,3,6,0,59,81,30
214,22,228,47,95,48,28,28,45,45,0,22,28,47,48,1,0.002484768031587188,0.0053439531638245,47,53,6,3,3,3,3,2,60,52,29
215,0,616,1,100,99,0,70,1,34,33,0,35,1,43,42,0.0,0.003165526396405596,1,49,48,2,-1,3,14,0,8,96,28
216,40,40,45,45,0,110,110,57,57,0,40,40,45,45,0,0.0037441710065012424,0.0037441710065012424,52,52,0,-1,3,3,14,6,25,73,81
217,115,321,85,100,15,32,32,58,58,0,32,32,60,60,0,0.013955546478777357,0.02559651451717213,77,89,12,3,3,3,2,15,91,19,15
218,60,676,56,100,44,114,114,64,64,0,60,114,56,80,24,0.004969536063174376,0.015487252799618776,57,76,19,2,3,3,9,6,31,28,6
219,0,102,1,75,74,0,7,1,25,24,0,2,1,25,24,0.0,0.00010211375472276115,1,27,26,4,-1,5,6,0,51,82,68
220,16,632,32,100,68,40,62,32,38,6,16,62,32,55,23,0.00037441710065012424,0.006705469893461316,32,57,25,2,3,3,9,1,29,4,31
221,100,100,63,63,0,100,100,47,47,0,100,100,63,63,0,0.049593246877021,0.07515572347595222,96,100,4,1,1,1,10,29,36,0,11
222,148,748,88,100,12,88,88,82,82,0,88,88,82,82,0,0.022465026039007456,0.05391606249361789,85,97,12,2,2,2,4,18,72,30,2
223,144,144,89,89,0,48,48,70,70,0,48,48,72,72,0,0.017052997038701112,0.017052997038701112,79,79,0,-1,3,3,3,18,94,5,81
224,22,228,43,94,51,50,50,45,45,0,22,29,43,47,4,0.0008509479560230097,0.0018720855032506212,38,43,5,3,3,3,5,2,52,56,51
225,24,640,46,100,54,58,68,38,39,1,24,66,46,58,12,0.001157289220191293,0.006331052792811192,40,58,18,2,3,3,8,4,15,64,28
226,0,0,1,1,0,0,0,1,1,0,0,0,1,1,0,0.0,0.0,1,1,0,-1,-1,-1,3,0,81,87,91
227,22,638,42,100,58,42,66,38,48,10,22,66,42,56,14,0.000442492937131965,0.026821879573845263,34,89,55,2,3,3,6,2,41,56,10
228,312,414,96,98,2,168,168,96,96,0,168,168,96,96,0,0.03601211749889377,0.03611423125361653,92,92,0,4,2,2,6,22,32,9,60
229,388,2028,98,100,2,248,272,90,95,5,248,272,92,95,3,0.03366350114027026,0.052588583682221995,93,98,5,1,2,2,11,27,38,10,39
230,2,618,27,100,73,15,54,29,38,9,2,54,27,55,28,3.4037918240920386e-05,0.008203138296061813,26,63,37,2,5,3,8,1,21,95,27
231,22,638,41,100,59,76,96,39,41,2,22,60,41,53,12,0.0019061234214915416,0.006705469893461316,42,57,15,2,3,3,11,2,33,83,26
232,396,596,98,100,2,192,192,99,99,0,192,192,99,99,0,0.04571292419755608,0.04632560672589264,95,95,0,3,2,2,6,30,32,7,71
233,100,100,79,79,0,100,100,97,97,0,100,100,97,97,0,0.05269069743694476,0.05548180673270023,98,98,0,3,1,1,3,6,60,73,29
234,16,222,33,90,57,66,66,44,44,0,16,66,33,56,23,0.004152626025392287,0.012696143503863304,49,73,24,3,3,3,6,1,51,90,14
235,6,212,30,89,59,54,54,38,38,0,6,26,30,44,14,0.002314578440382586,0.00707988699411144,45,62,17,3,4,4,9,3,54,46,72
236,0,0,1,1,0,0,0,1,1,0,0,0,1,1,0,0.0,0.0,1,1,0,-1,-1,-1,5,0,61,86,93
237,22,228,43,92,49,54,58,37,37,0,22,58,43,54,11,0.0011232513019503727,0.009054086252084823,38,65,27,3,3,3,8,3,15,51,17
238,16,16,33,33,0,66,66,44,44,0,16,16,33,33,0,0.0028932230504782326,0.0028932230504782326,46,46,0,-1,3,3,6,3,40,46,86
239,94,94,67,67,0,86,86,65,65,0,86,86,68,68,0,0.011640968038394772,0.011640968038394772,69,69,0,-1,3,3,6,9,71,27,85
240,16,118,41,82,41,48,48,62,62,0,16,19,41,46,5,0.0031314884781646754,0.003710133088260322,51,52,1,4,3,3,3,3,64,46,74
241,219,425,91,98,7,184,184,78,78,0,184,184,87,87,0,0.022328874366043774,0.025392287007726607,85,88,3,3,2,2,10,20,18,23,73
242,2,208,26,90,64,10,18,28,32,4,2,9,26,38,12,0.00013615167296368154,0.0007147962830593281,30,37,7,3,5,4,5,1,80,60,56
243,0,101,1,75,74,0,8,1,25,24,0,1,1,25,24,0.0,3.4037918240920386e-05,1,25,24,5,-1,6,8,0,27,97,78
244,100,100,64,64,0,100,100,49,49,0,100,100,64,64,0,0.038939378467612924,0.038939378467612924,94,94,0,-1,1,1,8,18,42,5,40
245,28,644,43,100,57,124,124,60,60,0,28,59,43,53,10,0.0025188059498281084,0.00616086320160659,47,56,9,2,3,3,14,3,16,54,35
246,22,1662,45,100,55,46,100,40,65,25,22,100,45,71,26,0.002382654276864427,0.030225671397937304,47,90,43,1,3,2,6,2,44,75,14
247,44,660,57,100,43,38,38,59,59,0,38,38,62,62,0,0.006399128629293032,0.02491575615235372,60,88,28,2,3,3,3,7,92,62,9
248,203,203,90,90,0,144,144,88,88,0,144,144,88,88,0,0.02542632492596753,0.02542632492596753,87,87,0,-1,2,2,6,16,44,18,81
249,8,214,36,93,57,14,14,35,35,0,8,14,36,42,6,0.0008509479560230097,0.008203138296061813,36,68,32,3,4,4,3,2,92,74,8
250,0,0,1,1,0,0,0,1,1,0,0,0,1,1,0,0.0,0.0,1,1,0,-1,-1,-1,14,0,17,67,93
251,111,727,76,100,24,164,164,74,74,0,111,133,76,83,7,0.008203138296061813,0.012219612648490419,64,71,7,2,2,2,10,8,22,44,29
252,97,713,74,100,26,72,72,80,80,0,72,72,80,80,0,0.010007147962830594,0.01596378365499166,69,80,11,2,2,2,3,8,87,57,70
253,100,100,58,58,0,100,100,38,38,0,100,100,58,58,0,0.011334626774226489,0.011675005956635693,64,65,1,3,1,1,16,2,9,61,49
254,62,164,58,86,28,90,90,63,63,0,62,64,59,59,0,0.006399128629293032,0.006943735321147759,59,61,2,4,2,2,6,3,65,54,49
255,8,109,39,84,45,12,12,35,35,0,8,12,39,42,3,0.0002723033459273631,0.00034037918240920387,34,36,2,5,4,4,2,2,86,63,4
256,18,120,48,84,36,38,38,55,55,0,18,38,47,57,10,0.0017359338302869397,0.002995336805200994,41,51,10,4,3,3,3,2,76,61,83
257,8,109,37,78,41,30,30,37,37,0,8,9,37,38,1,0.0016338200755641784,0.0018040096667687805,41,41,0,5,4,4,5,2,80,83,65
258,40,656,46,100,54,140,150,65,68,3,40,89,46,64,18,0.003199564314646516,0.010994247591817285,49,70,21,2,2,2,11,1,33,53,27
259,62,662,62,100,38,76,76,54,54,0,62,76,62,65,3,0.007794683277170768,0.012015385139044895,64,72,8,2,3,3,6,6,32,34,72
260,158,158,84,84,0,228,228,89,89,0,158,158,84,84,0,0.011198475101262807,0.011198475101262807,70,70,0,-1,2,2,11,7,19,21,79
261,161,777,93,100,7,80,80,96,96,0,80,80,96,96,0,0.03271043942952449,0.047789237210252224,93,97,4,2,2,2,2,15,98,16,39
262,138,754,89,100,11,88,88,80,80,0,88,88,81,81,0,0.017052997038701112,0.02563055243541305,83,88,5,2,2,2,4,15,77,19,25
263,6,622,30,100,70,24,42,34,39,5,6,36,30,50,20,0.000442492937131965,0.006637394056979475,36,62,26,2,4,3,6,1,74,49,72
264,214,830,89,100,11,300,310,89,90,1,214,310,89,94,5,0.014806494434800367,0.036965179209639536,77,96,19,2,2,2,14,9,16,27,9
265,100,100,59,59,0,100,100,46,46,0,100,100,59,59,0,0.04789135096497498,0.064127437965894,97,100,3,1,1,1,11,30,5,7,17
266,0,616,1,100,99,0,78,1,43,42,0,78,1,57,56,0.0,0.013479015623404473,1,72,71,2,-1,3,8,1,27,45,14
267,88,704,61,100,39,174,174,76,76,0,88,174,61,86,25,0.007862759113652609,0.017359338302869398,63,78,15,2,2,2,10,7,22,62,33
268,28,228,49,94,45,50,50,45,45,0,28,29,49,50,1,0.0018380475850097008,0.002280540522141666,43,46,3,3,3,3,5,3,63,43,56
269,0,0,1,1,0,0,0,1,1,0,0,0,1,1,0,0.0,0.0,1,1,0,-1,-1,-1,6,0,48,96,99
270,114,114,79,79,0,176,176,87,87,0,114,114,80,80,0,0.012253650566731339,0.012253650566731339,72,72,0,-1,2,2,8,5,39,25,59
271,40,246,48,94,46,114,114,60,60,0,40,53,48,52,4,0.005582218591510943,0.006841621566424997,56,60,4,3,2,2,10,1,12,90,54
272,0,616,1,100,99,0,90,1,45,44,0,69,1,56,55,0.0,0.01153885428367201,1,72,71,2,-1,3,10,1,36,69,39
273,107,307,83,100,17,56,56,86,86,0,56,56,86,86,0,0.019095272133156337,0.03437829742332959,82,93,11,3,2,2,2,9,95,39,10
274,0,616,1,99,98,0,124,1,58,57,0,74,1,54,53,0.0,0.014364001497668403,1,74,73,2,-1,3,17,0,20,81,39
275,29,645,48,100,52,40,50,44,46,2,29,50,48,53,5,0.004220701861874128,0.011640968038394772,51,72,21,2,3,3,5,4,88,22,77
276,48,48,63,63,0,12,12,37,37,0,12,12,41,41,0,0.00707988699411144,0.00707988699411144,63,63,0,-1,4,4,2,13,89,24,92
277,0,616,1,100,99,0,40,1,37,36,0,16,1,39,38,0.0,0.002723033459273631,1,45,44,2,-1,3,9,0,26,80,46
278,359,461,96,100,4,136,136,98,98,0,136,136,98,98,0,0.040164743524286055,0.04053916062493618,93,93,0,4,2,2,4,29,83,11,49
279,86,286,66,96,30,122,122,76,76,0,86,94,66,67,1,0.00881582082439838,0.01055175465468532,68,69,1,3,2,2,8,6,39,34,70
280,8,214,37,93,56,20,20,35,35,0,8,20,37,47,10,0.000442492937131965,0.003778208924742163,35,52,17,3,4,4,4,2,73,63,26
281,16,118,39,82,43,28,28,40,40,0,16,18,39,44,5,0.0013615167296368155,0.001497668402600497,40,41,1,4,3,3,3,2,82,42,60
282,405,611,98,100,2,160,160,86,86,0,160,160,88,88,0,0.03400388032267947,0.03597807958065285,93,94,1,3,2,2,7,29,24,1,94
283,524,1140,99,100,1,264,264,99,99,0,264,264,99,99,0,0.05289492494639028,0.07549610265836142,98,100,2,2,2,2,9,36,31,2,3
284,40,246,47,94,47,144,144,61,61,0,40,52,47,51,4,0.0030974505599237552,0.00445896728956057,48,52,4,3,2,2,10,1,0,53,51
285,64,680,57,100,43,66,86,50,62,12,64,86,59,66,7,0.006297014874570271,0.02828551005820484,57,91,34,2,3,3,6,4,56,72,16
286,100,100,67,67,0,100,100,54,54,0,100,100,67,67,0,0.061098063242452094,0.06140440450662037,100,100,0,4,1,1,8,40,27,3,55
287,0,616,1,100,99,0,28,1,39,38,0,28,1,48,47,0.0,0.007250076585316042,1,64,63,2,-1,3,3,1,82,69,57
288,9,215,43,96,53,12,12,35,35,0,12,12,43,43,0,0.0011913271384322134,0.011300588855985567,39,72,33,3,4,4,2,4,86,64,5
289,0,206,1,89,88,0,20,1,27,26,0,6,1,27,26,0.0,0.0006467204465774873,1,33,32,3,-1,4,9,0,29,98,42
290,208,1848,87,100,13,248,272,89,94,5,208,272,88,94,6,0.01923142380612002,0.035910003744171005,81,94,13,1,2,2,11,12,5,37,20
291,64,165,71,93,22,32,32,63,63,0,32,32,65,65,0,0.011743081793117532,0.011777119711358454,74,74,0,5,3,3,2,8,98,20,4
292,0,616,1,100,99,0,76,1,41,40,0,44,1,49,48,0.0,0.0053099152455835805,1,53,52,2,-1,3,10,1,0,50,72
293,0,616,1,100,99,0,80,1,42,41,0,78,1,60,59,0.0,0.010824058000612683,1,70,69,2,-1,3,9,0,23,84,27
294,122,122,82,82,0,104,104,82,82,0,104,104,82,82,0,0.01494264610776405,0.01494264610776405,77,77,0,-1,2,2,5,8,80,8,82
295,40,1680,55,100,45,52,86,78,93,15,40,86,64,93,29,0.007556417849484326,0.044589672895605705,62,96,34,1,2,2,3,2,85,94,24
296,162,162,85,85,0,194,194,78,78,0,162,162,85,85,0,0.010960209673576363,0.010960209673576363,69,69,0,-1,2,2,11,9,19,31,66
297,186,186,92,92,0,120,120,87,87,0,120,120,89,89,0,0.01943565131556554,0.01943565131556554,86,86,0,-1,2,2,6,18,32,5,92
298,100,100,65,65,0,100,100,75,75,0,100,100,77,77,0,0.04979747438646653,0.05156744613499439,98,99,1,3,1,1,5,18,61,30,54
299,6,212,32,92,60,16,36,32,35,3,6,14,32,38,6,3.4037918240920386e-05,0.0029612988869600733,28,49,21,3,4,4,6,1,44,95,29
300,0,616,1,100,99,0,34,1,46,45,0,34,1,54,53,0.0,0.005582218591510943,1,58,57,2,-1,3,4,0,77,93,26
301,100,100,84,84,0,100,100,98,98,0,100,100,98,98,0,0.09292351679771266,0.0935021614078083,100,100,0,4,1,1,2,12,97,37,43
302,222,838,92,100,8,172,182,86,87,1,172,182,90,91,1,0.02209060893835733,0.031655263964055956,84,91,7,2,2,2,9,17,29,6,27
303,0,616,1,100,99,0,90,1,44,43,0,68,1,53,52,0.0,0.009462541270975866,1,70,69,2,-1,3,10,0,0,79,17
304,70,686,64,100,36,96,96,70,70,0,70,96,65,74,9,0.007113924912352361,0.013785356887572755,63,78,15,2,3,3,6,5,32,47,24
305,0,616,1,100,99,0,30,1,34,33,0,16,1,36,35,0.0,0.0030634126416828346,1,46,45,2,-1,3,6,0,48,98,94
306,170,770,89,100,11,222,222,90,90,0,170,222,89,94,5,0.013615167296368155,0.02917049593246877,77,89,12,2,2,2,10,8,36,17,16
307,232,832,93,100,7,208,208,89,89,0,208,208,92,92,0,0.01940161339732462,0.02719629667449539,84,88,4,2,2,2,10,17,0,6,17
308,304,1904,96,100,4,152,152,100,100,0,152,152,100,100,0,0.037373634228530586,0.08002314578440382,94,100,6,1,2,2,5,22,49,9,3
309,22,638,42,100,58,42,42,38,38,0,22,51,42,54,12,0.002382654276864427,0.010007147962830594,44,67,23,2,3,3,6,2,65,83,25
310,116,322,81,99,18,104,104,86,86,0,104,104,87,87,0,0.0176997174852786,0.020831205963443275,80,83,3,3,2,2,5,8,49,20,35
311,0,1640,1,100,99,0,72,1,38,37,0,48,1,51,50,0.0,0.009632730862180468,1,68,67,1,-1,2,11,0,33,98,43
312,146,146,87,87,0,78,78,72,72,0,78,78,75,75,0,0.016916845365737433,0.016916845365737433,80,80,0,-1,2,2,4,16,47,12,84
313,156,362,88,99,11,94,94,78,78,0,94,94,78,78,0,0.018108172504169646,0.02215868477483917,83,83,0,3,2,2,5,14,45,14,38
314,206,412,89,99,10,166,166,87,87,0,166,166,91,91,0,0.019878144252697506,0.020967357636406957,79,83,4,3,2,2,8,18,10,30,52
315,102,308,71,94,23,124,124,85,85,0,102,108,74,75,1,0.00970080669866231,0.010994247591817285,67,69,2,3,2,2,6,7,40,62,74
316,0,0,1,1,0,0,0,1,1,0,0,0,1,1,0,0.0,0.0,1,1,0,-1,-1,-1,2,0,98,36,97
317,120,736,81,100,19,166,166,86,86,0,120,166,82,90,8,0.010824058000612683,0.019844106334456584,70,84,14,2,2,2,8,7,39,48,77
318,275,1915,94,100,6,246,280,95,99,4,246,280,96,99,3,0.018857006705469893,0.057183702644746245,79,98,19,1,2,2,10,15,22,19,3
319,413,619,99,100,1,152,152,94,94,0,152,152,94,94,0,0.03720344463732598,0.037850165083903466,93,93,0,3,2,2,5,29,52,1,42
320,6,108,29,77,48,32,32,33,33,0,6,8,29,34,5,0.0002382654276864427,0.00037441710065012424,32,33,1,4,4,4,8,1,30,88,60
321,61,61,55,55,0,88,88,48,48,0,61,61,55,55,0,0.004833384390210695,0.004833384390210695,55,55,0,-1,3,3,8,6,15,35,80
322,0,616,1,100,99,0,78,1,43,42,0,78,1,56,55,0.0,0.022226760611321013,1,84,83,2,-1,3,8,0,27,81,7
323,0,616,1,100,99,0,98,1,38,37,0,42,1,47,46,0.0,0.006024711528642908,1,57,56,2,-1,3,15,0,7,40,25
324,168,168,85,85,0,276,276,89,89,0,168,168,85,85,0,0.010415602981721638,0.010415602981721638,67,67,0,-1,2,2,14,7,17,21,76
325,0,1640,1,100,99,0,112,1,62,61,0,112,1,77,76,0.0,0.027808979202831954,1,88,87,1,-1,2,8,0,15,85,9
326,0,0,1,1,0,0,0,1,1,0,0,0,1,1,0,0.0,0.0,1,1,0,-1,-1,-1,6,0,74,99,85
327,100,100,61,61,0,100,100,44,44,0,100,100,61,61,0,0.04687021341774737,0.04687021341774737,96,96,0,-1,1,1,12,27,6,10,76
328,0,616,1,100,99,0,30,1,31,30,0,16,1,32,31,0.0,0.002552843868069029,1,45,44,2,-1,3,9,0,31,97,71
329,2,104,27,80,53,5,6,27,28,1,2,6,27,30,3,6.807583648184077e-05,0.0020082371762143027,28,42,14,4,5,5,3,1,94,95,75
330,0,206,1,87,86,0,52,1,33,32,0,52,1,52,51,0.0,0.008475441641989176,1,64,63,3,-1,4,10,1,22,50,32
331,129,129,83,83,0,96,96,74,74,0,96,96,74,74,0,0.016304162837400864,0.016304162837400864,79,79,0,-1,3,3,6,15,69,19,92
332,126,332,80,98,18,164,164,74,74,0,126,164,80,88,8,0.008271214132543654,0.010755982164130842,65,71,6,3,2,2,10,7,1,48,41
333,86,292,65,97,32,86,86,63,63,0,86,86,67,67,0,0.007011811157629599,0.008577555396711936,58,63,5,3,3,3,6,6,56,13,46
334,62,163,63,92,29,48,48,59,59,0,48,48,63,63,0,0.008135062459579971,0.008101024541339052,64,64,0,6,3,3,3,6,75,34,58
335,0,206,1,95,94,0,18,1,34,33,0,18,1,45,44,0.0,0.00891793457912114,1,65,64,3,-1,4,3,0,94,80,32
336,16,632,34,100,66,96,130,37,61,24,16,124,34,79,45,0.0008509479560230097,0.012219612648490419,36,71,35,2,3,3,14,2,16,42,14
337,0,206,1,88,87,0,18,1,29,28,0,6,1,28,27,0.0,0.00030634126416828345,1,32,31,3,-1,4,8,0,10,99,49
338,86,188,62,88,26,156,156,65,65,0,86,88,62,63,1,0.0035739814152966403,0.0037441710065012424,49,50,1,4,2,2,13,3,13,43,4
339,6,212,31,90,59,15,24,32,32,0,6,12,31,35,4,0.00030634126416828345,0.002825147213996392,33,45,12,3,4,4,6,1,48,55,90
340,0,206,1,88,87,0,32,1,33,32,0,8,1,35,34,0.0,0.0008169100377820892,1,38,37,3,-1,4,8,0,10,85,61
341,174,790,87,100,13,192,192,86,86,0,192,192,89,89,0,0.020150447598624867,0.03213179481942884,83,92,9,2,2,2,9,12,28,37,12
342,40,246,51,91,40,102,102,66,66,0,40,46,51,53,2,0.004288777698355968,0.006399128629293032,53,57,4,3,2,2,8,2,10,94,46
343,6,108,29,74,45,16,16,29,29,0,6,8,29,33,4,6.807583648184077e-05,0.00010211375472276115,27,28,1,4,4,4,7,1,24,95,4
344,67,273,60,95,35,76,76,57,57,0,76,76,61,61,0,0.007318152421797883,0.008373327887266415,62,64,2,3,3,3,6,8,74,44,64
345,0,206,1,97,96,0,12,1,38,37,0,12,1,43,42,0.0,0.00888389666088022,1,68,67,3,-1,4,2,1,97,69,33
346,0,1640,1,100,99,0,128,1,60,59,0,111,1,79,78,0.0,0.016712617856291908,1,77,76,1,-1,2,13,0,13,89,32
347,16,222,37,94,57,38,42,38,38,0,16,42,37,50,13,0.0006467204465774873,0.005548180673270023,38,54,16,3,3,3,6,1,59,4,57
348,0,0,1,1,0,0,0,1,1,0,0,0,1,1,0,0.0,0.0,1,1,0,-1,-1,-1,17,0,20,66,59
349,88,294,63,95,32,184,184,78,78,0,88,109,63,77,14,0.006943735321147759,0.009190237925048503,57,67,10,3,2,2,11,4,33,22,35
350,0,206,1,94,93,0,12,1,39,38,0,12,1,41,40,0.0,0.005037611899656217,1,56,55,3,-1,4,2,0,90,40,72
351,0,206,1,90,89,0,58,1,32,31,0,6,1,28,27,0.0,0.002280540522141666,1,43,42,3,-1,4,13,1,13,69,46
352,12,218,34,87,53,58,62,34,35,1,12,24,34,44,10,0.00030634126416828345,0.002314578440382586,33,44,11,3,4,4,11,2,5,63,52
353,42,248,54,93,39,98,98,53,53,0,40,98,54,68,14,0.0034718676605738795,0.006603356138738555,51,60,9,3,3,3,8,6,57,41,28
354,108,724,74,100,26,172,172,86,86,0,108,172,74,89,15,0.012083460975526737,0.022567139793730217,71,84,13,2,2,2,9,5,29,25,39
355,0,0,1,1,0,0,0,1,1,0,0,0,1,1,0,0.0,0.0,1,1,0,-1,-1,-1,6,0,41,92,76
356,2,2,27,27,0,10,10,28,28,0,2,2,27,27,0,3.4037918240920386e-05,3.4037918240920386e-05,27,27,0,-1,5,5,6,1,65,95,36
357,6,1646,33,100,67,20,58,35,64,29,6,58,33,65,32,0.0011913271384322134,0.03087239184451479,40,92,52,1,4,2,4,1,47,71,44
358,239,239,94,94,0,176,176,90,90,0,176,176,91,91,0,0.02546036284420845,0.02546036284420845,87,87,0,-1,2,2,8,15,21,16,81
359,62,678,52,100,48,154,174,63,66,3,62,174,52,84,32,0.0030634126416828346,0.01674665577453283,49,77,28,2,2,2,15,3,7,54,30
360,260,361,93,95,2,272,272,94,94,0,272,272,94,94,0,0.021035433472888797,0.021035433472888797,86,86,0,6,2,2,11,17,33,6,78
361,359,959,97,100,3,136,136,98,98,0,136,136,98,98,0,0.03720344463732598,0.04455563497736478,93,93,0,2,2,2,4,30,79,7,24
362,292,492,95,99,4,252,252,94,94,0,252,252,94,94,0,0.02294155689438034,0.023179822322066782,86,87,1,3,2,2,11,16,19,12,64
363,376,992,99,100,1,256,256,97,97,0,256,256,98,98,0,0.03362946322202934,0.036080193335375606,92,95,3,2,2,2,10,22,22,9,75
364,56,56,52,52,0,76,76,54,54,0,56,56,52,52,0,0.005548180673270023,0.005548180673270023,53,53,0,-1,2,2,6,2,56,75,40
365,28,644,44,100,56,88,88,47,47,0,28,88,44,60,16,0.0023486163586235067,0.009020048333843901,46,66,20,2,3,3,8,3,10,54,44
366,0,1640,1,100,99,0,55,1,38,37,0,40,1,47,46,0.0,0.011198475101262807,1,70,69,1,-1,2,9,0,54,59,4
367,62,268,58,95,37,90,90,63,63,0,62,70,59,60,1,0.006399128629293032,0.007998910786616291,59,63,4,3,2,2,6,3,65,54,52
368,102,203,75,89,14,134,134,90,90,0,102,103,79,79,0,0.0123557643214541,0.01242384015793594,71,71,0,5,2,2,6,7,74,62,95
369,6,622,29,100,71,26,74,30,41,11,6,74,29,60,31,0.0002382654276864427,0.022022533101875488,32,84,52,2,4,3,9,1,23,4,11
370,100,100,58,58,0,100,100,38,38,0,100,100,58,58,0,0.014874570271282209,0.02501786990707648,76,89,13,1,1,1,16,5,9,47,28
371,0,616,1,100,99,0,156,1,59,58,0,146,1,85,84,0.0,0.01746145205759216,1,79,78,2,-1,3,16,0,4,85,16
372,178,794,89,100,11,150,150,65,65,0,150,150,82,82,0,0.009939072126348753,0.01504475986248681,71,78,7,2,3,3,10,14,0,32,28
373,0,0,1,1,0,0,0,1,1,0,0,0,1,1,0,0.0,0.0,1,1,0,-1,-1,-1,10,0,11,79,50
374,0,616,1,100,99,0,42,1,39,38,0,23,1,47,46,0.0,0.002825147213996392,1,49,48,2,-1,3,6,0,44,91,70
375,0,0,1,1,0,0,0,1,1,0,0,0,1,1,0,0.0,0.0,1,1,0,-1,-1,-1,3,0,92,40,89
376,122,328,85,99,14,72,72,84,84,0,72,72,84,84,0,0.018925082541951733,0.02392865652336703,81,87,6,3,2,2,3,15,81,19,34
377,80,286,74,97,23,72,72,79,79,0,72,72,80,80,0,0.010415602981721638,0.011675005956635693,74,76,2,3,2,2,3,7,75,21,52
378,42,42,59,59,0,48,48,66,66,0,48,48,67,67,0,0.00970080669866231,0.00970080669866231,70,70,0,-1,3,3,3,5,76,25,67
379,137,343,88,100,12,48,48,68,68,0,48,48,69,69,0,0.023452125667994147,0.030702202253310187,87,91,4,3,3,3,3,15,81,16,17
380,218,834,90,100,10,256,266,85,85,0,218,266,90,92,2,0.010892133837094524,0.020150447598624867,70,80,10,2,2,2,14,13,16,24,27
381,16,16,37,37,0,126,126,64,64,0,16,16,37,37,0,0.002825147213996392,0.002825147213996392,48,48,0,-1,3,3,11,3,19,46,98
382,6,622,30,100,70,18,64,30,41,11,6,64,30,56,26,0.0002382654276864427,0.015623404472582456,32,76,44,2,4,3,9,1,35,55,16
383,0,0,1,1,0,0,0,1,1,0,0,0,1,1,0,0.0,0.0,1,1,0,-1,-1,-1,11,0,33,86,69
384,100,100,66,66,0,100,100,45,45,0,100,100,66,66,0,0.038224582184553595,0.03985840226011777,95,95,0,3,1,1,10,19,1,15,52
385,94,710,75,100,25,54,64,60,67,7,54,64,62,69,7,0.010381565063480718,0.027264372510977228,71,89,18,2,3,3,4,9,78,27,6
386,0,0,1,1,0,0,0,1,1,0,0,0,1,1,0,0.0,0.0,1,1,0,-1,-1,-1,9,0,31,99,45
387,120,1760,82,100,18,70,94,67,75,8,70,94,71,76,5,0.01756356581231492,0.047414820109602095,79,100,21,1,3,2,5,17,70,6,30
388,0,616,1,100,99,0,60,1,38,37,0,50,1,51,50,0.0,0.011130399264780965,1,69,68,2,-1,3,9,0,29,76,39
389,190,190,91,91,0,88,88,71,71,0,88,88,71,71,0,0.019061234214915415,0.019061234214915415,81,81,0,-1,2,2,4,16,53,12,36
390,0,616,1,100,99,0,66,1,47,46,0,66,1,60,59,0.0,0.020252561353347628,1,84,83,2,-1,3,6,0,48,92,30
391,130,130,82,82,0,128,128,93,93,0,128,128,93,93,0,0.01674665577453283,0.01674665577453283,80,80,0,-1,2,2,5,8,37,20,99
392,0,0,1,1,0,0,0,1,1,0,0,0,1,1,0,0.0,0.0,1,1,0,-1,-1,-1,3,0,85,93,66
393,0,616,1,100,99,0,48,1,36,35,0,48,1,55,54,0.0,0.007522379931243405,1,59,58,2,-1,3,7,0,24,40,14
394,6,6,31,31,0,12,12,37,37,0,6,6,31,31,0,0.0005786446100956465,0.0005786446100956465,35,35,0,-1,4,4,2,1,99,49,69
395,138,754,79,100,21,142,142,78,78,0,138,142,81,81,0,0.0160318594914735,0.036965179209639536,74,96,22,2,2,2,8,9,27,39,11
396,0,206,1,96,95,0,8,1,31,30,0,8,1,37,36,0.0,0.0040845501889104465,1,53,52,3,-1,4,2,0,98,93,38
397,124,1764,78,100,22,242,276,80,89,9,124,276,78,96,18,0.010960209673576363,0.024269035705776234,70,90,20,1,2,2,14,6,8,34,24
398,0,0,1,1,0,0,0,1,1,0,0,0,1,1,0,0.0,0.0,1,1,0,-1,-1,-1,5,0,49,98,82
399,0,0,1,1,0,0,0,1,1,0,0,0,1,1,0,0.0,0.0,1,1,0,-1,-1,-1,5,0,52,96,45
400,83,699,80,100,20,32,32,67,67,0,32,32,68,68,0,0.013376901868681712,0.026958031246808945,76,90,14,2,3,3,2,15,97,19,32
401,260,860,93,100,7,222,222,91,91,0,222,222,94,94,0,0.01504475986248681,0.028728002995336805,77,88,11,2,2,2,10,14,18,32,12
402,0,206,1,93,92,0,24,1,37,36,0,24,1,49,48,0.0,0.0053099152455835805,1,57,56,3,-1,4,4,0,73,82,48
403,22,123,40,82,42,60,60,40,40,0,22,23,40,43,3,0.0010892133837094523,0.0011232513019503727,39,39,0,5,3,3,9,2,31,74,78
404,63,269,54,95,41,86,86,49,49,0,63,86,54,60,6,0.007216038667075122,0.01334286395044079,56,77,21,3,2,2,7,6,46,73,77
405,76,76,67,67,0,70,70,62,62,0,70,70,69,69,0,0.008305252050784574,0.008305252050784574,66,66,0,-1,3,3,5,7,45,21,59
406,36,1676,52,100,48,88,132,52,73,21,36,132,52,80,28,0.00439089145307873,0.031280846863405834,54,92,38,1,3,2,8,6,21,73,18
407,6,622,33,100,67,24,54,38,61,23,6,54,33,67,34,0.0011232513019503727,0.028830116750059566,41,89,48,2,4,3,4,1,72,71,10
408,84,700,75,100,25,56,56,80,80,0,56,56,81,81,0,0.010687906327649,0.026719765819122502,69,90,21,2,2,2,2,5,91,47,33
409,142,348,87,98,11,118,118,93,93,0,118,118,93,93,0,0.0176997174852786,0.021137547227611558,80,83,3,3,2,2,5,9,45,39,28
410,153,359,87,98,11,104,104,88,88,0,104,104,88,88,0,0.018312400013615168,0.028421661731168522,81,87,6,3,2,2,5,15,88,19,6
411,58,159,63,92,29,48,48,70,70,0,48,48,72,72,0,0.01242384015793594,0.012764219340345145,72,73,1,5,3,3,3,8,94,20,42
412,1,617,25,100,75,3,24,25,41,16,1,24,25,48,23,0.00010211375472276115,0.013819394805813677,29,79,50,2,6,3,3,1,66,68,12
413,24,230,52,100,48,12,12,39,39,0,12,12,44,44,0,0.0057524081827155455,0.00970080669866231,60,69,9,3,4,4,2,4,97,38,57
414,160,776,84,100,16,242,242,83,83,0,160,188,84,85,1,0.014806494434800367,0.019878144252697506,72,79,7,2,2,2,14,8,25,20,72
415,73,73,64,64,0,70,70,62,62,0,70,70,69,69,0,0.007760645358929848,0.007760645358929848,63,63,0,-1,3,3,5,8,45,57,97
416,48,664,63,100,37,12,22,37,46,9,12,22,41,51,10,0.00707988699411144,0.03002144388849178,63,93,30,2,4,3,2,13,89,24,11
417,164,164,89,89,0,96,96,90,90,0,96,96,90,90,0,0.02831954797644576,0.02831954797644576,90,90,0,-1,2,2,3,16,82,18,36
418,6,6,29,29,0,28,28,31,31,0,6,6,29,29,0,0.0,0.0,1,1,0,-1,4,4,10,1,22,65,92
419,16,16,37,37,0,92,92,42,42,0,16,16,37,37,0,0.0009190237925048504,0.0009190237925048504,38,38,0,-1,3,3,11,2,19,42,45
420,133,133,88,88,0,54,54,59,59,0,54,54,63,63,0,0.016304162837400864,0.016304162837400864,82,82,0,-1,3,3,4,18,77,5,96
421,0,616,1,100,99,0,34,1,38,37,0,34,1,50,49,0.0,0.006739507811702236,1,59,58,2,-1,3,4,1,53,50,44
422,324,324,98,98,0,144,144,91,91,0,144,144,91,91,0,0.036590762108989414,0.036590762108989414,95,95,0,-1,2,2,6,27,74,10,84
423,0,102,1,73,72,0,15,1,27,26,0,2,1,25,24,0.0,0.0002042275094455223,1,31,30,4,-1,5,12,0,6,89,65
424,50,50,51,51,0,110,110,58,58,0,50,50,51,51,0,0.005480104836788182,0.005480104836788182,53,53,0,-1,3,3,10,6,0,73,98
425,0,206,1,91,90,0,20,1,33,32,0,20,1,47,46,0.0,0.0040845501889104465,1,52,51,3,-1,4,4,0,84,89,13
426,152,152,84,84,0,100,100,69,69,0,100,100,71,71,0,0.016508390346846386,0.016508390346846386,78,78,0,-1,2,2,6,13,34,33,67
427,114,730,78,100,22,100,100,73,73,0,100,100,74,74,0,0.013547091459886314,0.017972020831205963,72,80,8,2,2,2,6,9,71,31,26
428,16,632,33,100,67,52,70,36,41,5,16,50,33,54,21,0.0005786446100956465,0.006058749446883829,35,60,25,2,3,3,9,1,31,49,38
429,222,222,92,92,0,192,192,89,89,0,192,192,92,92,0,0.022430988120766535,0.022430988120766535,85,85,0,-1,2,2,9,16,31,18,92
430,22,638,45,100,55,66,86,49,56,7,22,86,45,63,18,0.0019061234214915416,0.02559651451717213,44,88,44,2,3,3,6,2,44,61,1
431,142,348,82,96,14,86,86,56,56,0,86,86,62,62,0,0.013070560604513427,0.02028659927158855,75,83,8,3,3,3,6,14,51,14,17
432,33,239,57,97,40,22,22,52,52,0,22,22,54,54,0,0.005105687736138058,0.010007147962830594,60,66,6,3,3,3,2,6,86,35,62
433,167,167,86,86,0,126,126,80,80,0,126,126,83,83,0,0.014908608189523128,0.014908608189523128,76,76,0,-1,2,2,7,15,62,19,92
434,6,212,32,94,62,14,14,34,34,0,6,12,32,38,6,0.0006126825283365669,0.0021784267674189047,34,44,10,3,4,4,3,1,60,49,94
435,22,124,44,81,37,42,42,41,41,0,22,24,44,46,2,0.0007147962830593281,0.001157289220191293,37,41,4,4,3,3,6,2,69,63,42
436,63,679,58,100,42,114,124,61,65,4,63,124,58,80,22,0.006297014874570271,0.01861874127778345,57,80,23,2,3,3,9,8,54,57,30
437,0,102,1,82,81,0,4,1,26,25,0,3,1,29,28,0.0,0.0002042275094455223,1,30,29,4,-1,5,2,0,91,76,56
438,0,616,1,100,99,0,70,1,34,33,0,22,1,39,38,0.0,0.002825147213996392,1,48,47,2,-1,3,14,0,25,76,29
439,0,101,1,77,76,0,6,1,25,24,0,1,1,25,24,0.0,0.0,1,1,0,5,-1,6,6,1,48,45,58
440,0,206,1,92,91,0,14,1,30,29,0,6,1,30,29,0.0,0.0016338200755641784,1,43,42,3,-1,4,5,0,70,40,94
441,214,420,92,100,8,102,102,93,93,0,102,102,93,93,0,0.02644746247319514,0.04523639334218319,88,96,8,3,2,2,4,16,84,12,1
442,80,696,73,100,27,32,32,71,71,0,32,32,71,71,0,0.014772456516559448,0.03247217400183805,75,95,20,2,3,3,2,9,99,27,34
443,28,234,44,92,48,64,64,41,41,0,28,50,44,54,10,0.0017018959120460194,0.0046972327172470135,42,56,14,3,3,3,9,3,31,43,28
444,190,190,90,90,0,158,158,80,80,0,158,158,86,86,0,0.02042275094455223,0.02042275094455223,84,84,0,-1,2,2,9,17,23,6,99
445,0,206,1,90,89,0,26,1,34,33,0,20,1,44,43,0.0,0.005071649817897137,1,57,56,3,-1,4,5,0,80,97,25
446,160,366,86,96,10,134,134,73,73,0,134,134,84,84,0,0.017972020831205963,0.018142210422410564,80,80,0,3,3,3,9,12,29,37,4
447,0,616,1,100,99,0,20,1,42,41,0,18,1,44,43,0.0,0.003437829742332959,1,49,48,2,-1,3,3,1,58,69,63
448,0,616,1,100,99,0,48,1,65,64,0,48,1,66,65,0.0,0.02818339630348208,1,88,87,2,-1,3,3,0,76,85,11
449,100,100,74,74,0,100,100,87,87,0,100,100,87,87,0,0.07525783723067497,0.07787875693522585,100,100,0,3,1,1,4,30,47,7,28
450,22,638,40,100,60,84,154,38,65,27,22,154,40,83,43,0.0005105687736138058,0.024337111542258077,36,88,52,2,3,3,14,2,25,63,11
451,40,246,47,91,44,130,142,61,65,4,40,62,47,55,8,0.0014636304843595766,0.005241839409101739,41,54,13,3,2,2,16,2,9,42,35
452,0,206,1,90,89,0,16,1,32,31,0,7,1,34,33,0.0,0.0008169100377820892,1,37,36,3,-1,4,6,0,74,66,61
453,157,258,91,97,6,72,72,77,77,0,72,72,79,79,0,0.023724429013921508,0.023724429013921508,89,89,0,5,2,2,3,15,96,16,60
454,22,638,43,100,57,82,82,50,50,0,22,51,43,54,11,0.004186663943633207,0.008101024541339052,51,62,11,2,3,3,7,3,43,29,41
455,2,618,25,100,75,7,56,25,40,15,2,56,25,53,28,3.4037918240920386e-05,0.018482589604819768,27,83,56,2,5,3,6,2,40,58,1
456,0,0,1,1,0,0,0,1,1,0,0,0,1,1,0,0.0,0.0,1,1,0,-1,-1,-1,9,0,23,84,81
457,0,102,1,77,76,0,6,1,26,25,0,2,1,26,25,0.0,0.0002042275094455223,1,32,31,4,-1,5,5,0,37,79,55
458,168,784,87,100,13,318,318,91,91,0,168,243,87,94,7,0.012662105585622384,0.02566459035365397,73,86,13,2,2,2,16,6,4,77,37
459,32,32,53,53,0,22,22,48,48,0,32,32,70,70,0,0.004663194799006093,0.004663194799006093,55,55,0,-1,3,3,2,3,95,29,85
460,0,616,1,100,99,0,84,1,45,44,0,54,1,55,54,0.0,0.007352190340038803,1,61,60,2,-1,3,9,0,28,99,62
461,0,0,1,1,0,0,0,1,1,0,0,0,1,1,0,0.0,0.0,1,1,0,-1,-1,-1,3,1,60,69,45
462,46,46,55,55,0,50,50,45,45,0,50,50,56,56,0,0.007216038667075122,0.007216038667075122,62,62,0,-1,3,3,5,6,45,34,82
463,90,706,64,100,36,94,94,68,68,0,94,94,71,71,0,0.00891793457912114,0.013070560604513427,68,77,9,2,2,2,5,6,50,34,46
464,24,640,47,100,53,38,38,46,46,0,24,38,48,50,2,0.0030634126416828346,0.022328874366043774,49,88,39,2,3,3,3,6,96,70,5
465,175,1815,88,100,12,120,144,80,87,7,120,144,81,88,7,0.024166921951053473,0.05286088702814936,88,97,9,1,2,2,6,15,34,16,39
466,0,101,1,75,74,0,10,1,25,24,0,1,1,25,24,0.0,6.807583648184077e-05,1,28,27,6,-1,7,10,0,12,85,78
467,44,660,62,100,38,32,32,69,69,0,32,32,69,69,0,0.007590455767725246,0.03332312195786106,67,94,27,2,3,3,2,4,90,72,10
468,0,101,1,79,78,0,3,1,25,24,0,1,1,25,24,0.0,0.0,1,1,0,5,-1,6,3,0,94,87,68
469,0,206,1,94,93,0,24,1,35,34,0,20,1,41,40,0.0,0.0046972327172470135,1,53,52,3,-1,4,4,0,53,91,38
470,110,316,73,94,21,110,110,72,72,0,110,110,76,76,0,0.011606930120153852,0.012083460975526737,73,73,0,3,2,2,6,6,40,77,64
471,0,0,1,1,0,0,0,1,1,0,0,0,1,1,0,0.0,0.0,1,1,0,-1,-1,-1,4,0,72,82,89
472,128,128,79,79,0,86,86,55,55,0,86,86,60,60,0,0.012696143503863304,0.012696143503863304,75,75,0,-1,3,3,6,8,40,8,59
473,100,100,61,61,0,100,100,44,44,0,100,100,61,61,0,0.04527043126042411,0.04649579631709724,95,95,0,3,1,1,12,29,6,11,51
474,254,1894,93,100,7,256,280,94,97,3,256,280,96,97,1,0.02324789815854862,0.05905578814799687,86,99,13,1,2,2,10,18,11,30,3
475,100,100,64,64,0,100,100,49,49,0,100,100,64,64,0,0.03819054426631267,0.06266380748153443,92,99,7,2,1,1,8,15,42,19,7
476,1,617,26,100,74,8,42,26,37,11,1,23,26,43,17,6.807583648184077e-05,0.004118588107151367,27,51,24,2,6,3,8,2,39,58,75
477,0,616,1,100,99,0,110,1,56,55,0,106,1,76,75,0.0,0.01415977398822288,1,72,71,2,-1,3,14,0,25,96,18
478,375,476,97,100,3,160,160,93,93,0,160,160,94,94,0,0.03448041117805235,0.03448041117805235,91,91,0,6,2,2,7,29,62,1,58
479,38,38,47,47,0,54,54,56,56,0,38,38,48,48,0,0.003642057251778481,0.003642057251778481,47,47,0,-1,3,3,4,6,67,70,92
480,0,206,1,92,91,0,13,1,30,29,0,8,1,36,35,0.0,0.0011913271384322134,1,39,38,3,-1,4,5,0,37,93,74
481,0,616,1,100,99,0,76,1,51,50,0,76,1,61,60,0.0,0.020661016372238675,1,85,84,2,-1,3,6,1,65,45,16
482,100,100,69,69,0,100,100,70,70,0,100,100,72,72,0,0.03318697028489737,0.03318697028489737,93,93,0,-1,1,1,6,6,65,41,82
483,118,734,81,100,19,88,88,80,80,0,88,88,80,80,0,0.01763164164879676,0.026821879573845263,81,87,6,2,2,2,4,9,84,39,33
484,100,100,77,77,0,100,100,96,96,0,100,100,96,96,0,0.06620375097859015,0.09278736512474897,98,100,2,2,1,1,3,8,82,17,1
485,16,16,39,39,0,28,28,36,36,0,16,16,39,39,0,0.0004765308553728854,0.0004765308553728854,35,35,0,-1,3,3,6,1,69,4,91
486,170,170,86,86,0,96,96,64,64,0,96,96,73,73,0,0.019946220089179345,0.019946220089179345,81,81,0,-1,3,3,6,17,51,6,69
487,110,316,75,95,20,148,148,76,76,0,110,148,75,87,12,0.00796487286837537,0.014432077334150244,61,74,13,3,2,2,9,6,29,13,48
488,6,6,33,33,0,16,16,33,33,0,6,6,33,33,0,0.00030634126416828345,0.00030634126416828345,34,34,0,-1,4,4,4,1,78,88,85
489,42,42,59,59,0,48,48,66,66,0,48,48,67,67,0,0.00970080669866231,0.00970080669866231,70,70,0,-1,3,3,3,5,76,25,81
490,0,1640,1,100,99,0,132,1,62,61,0,100,1,60,59,0.0,0.014840532353041287,1,75,74,1,-1,2,12,1,14,69,21
491,12,628,40,100,60,20,44,35,47,12,12,44,40,57,17,0.002110350930937064,0.021546002246502605,47,86,39,2,4,3,4,2,47,83,9
492,38,38,44,44,0,136,136,61,61,0,38,38,44,44,0,0.0011913271384322134,0.0011913271384322134,39,39,0,-1,3,3,15,4,7,64,84
493,22,622,40,100,60,56,56,38,38,0,22,22,40,40,0,0.0012934408931549745,0.0030634126416828346,40,46,6,2,3,3,9,3,31,51,94
494,317,517,99,100,1,128,128,96,96,0,128,128,96,96,0,0.03812246842983083,0.04261547363763232,95,96,1,3,2,2,5,29,49,0,24
495,22,1662,40,100,60,122,180,55,63,8,22,152,40,85,45,0.002212464685659825,0.02215868477483917,42,82,40,1,3,2,16,2,4,83,6
496,136,342,84,96,12,80,80,68,68,0,80,80,72,72,0,0.017972020831205963,0.018788930868988054,80,81,1,3,3,3,5,17,88,6,61
497,56,672,50,100,50,220,250,73,78,5,56,250,50,94,44,0.00442492937131965,0.026753803737363423,54,88,34,2,2,2,16,3,4,29,10
498,248,350,92,96,4,128,128,90,90,0,128,128,90,90,0,0.023350011913271386,0.023384049831512304,86,86,0,4,2,2,5,19,61,15,55
499,40,656,48,99,51,146,156,64,65,1,40,98,48,60,12,0.004595118962524252,0.01412573606998196,55,74,19,2,2,2,12,1,6,90,17
500,100,100,63,63,0,100,100,45,45,0,100,100,63,63,0,0.039994553933081455,0.039994553933081455,94,94,0,-1,1,1,11,20,19,23,66
501,100,100,66,66,0,100,100,45,45,0,100,100,66,66,0,0.0245413390517036,0.0245413390517036,86,86,0,-1,1,1,10,9,1,31,69
502,0,616,1,100,99,0,34,1,37,36,0,24,1,48,47,0.0,0.003608019333537561,1,48,47,2,-1,3,6,0,59,76,64
503,100,100,72,72,0,100,100,77,77,0,100,100,77,77,0,0.028830116750059566,0.0405731985431771,89,96,7,2,1,1,6,6,69,41,5
504,0,101,1,82,81,0,3,1,24,23,0,1,1,24,23,0.0,3.4037918240920386e-05,1,28,27,5,-1,6,3,0,85,86,78
505,0,206,1,89,88,0,36,1,35,34,0,8,1,35,34,0.0,0.0027911092957554717,1,49,48,3,-1,4,8,0,57,86,29
506,62,268,59,97,38,22,22,42,42,0,22,22,46,46,0,0.00881582082439838,0.020048333843902106,64,85,21,3,3,3,2,6,68,34,39
507,0,616,1,100,99,0,42,1,35,34,0,42,1,51,50,0.0,0.008475441641989176,1,66,65,2,-1,3,6,0,51,66,32
508,22,124,53,84,31,22,22,52,52,0,22,22,54,54,0,0.0020763130126961434,0.0030293747234419145,47,52,5,4,3,3,2,2,86,52,61
509,22,22,47,47,0,22,22,42,42,0,22,22,46,46,0,0.0018720855032506212,0.0018720855032506212,45,45,0,-1,3,3,2,2,68,52,87
510,8,8,33,33,0,24,24,31,31,0,8,8,33,33,0,0.00030634126416828345,0.00030634126416828345,33,33,0,-1,4,4,6,2,71,56,66
511,6,622,28,100,72,28,58,31,37,6,6,58,28,54,26,0.00017018959120460194,0.011198475101262807,28,67,39,2,4,3,8,1,27,4,39
512,210,416,92,99,7,104,104,73,73,0,104,104,79,79,0,0.023009632730862182,0.023894618605126112,89,89,0,3,2,2,5,15,52,16,43
513,112,728,79,100,21,146,146,82,82,0,112,146,79,85,6,0.010245413390517035,0.01763164164879676,71,81,10,2,2,2,8,4,57,38,48
514,151,767,92,100,8,56,56,84,84,0,56,56,84,84,0,0.028523775485891283,0.039415909322985804,92,96,4,2,2,2,2,15,86,16,34
515,1,617,26,100,74,7,31,26,36,10,1,19,26,44,18,0.0,0.00353994349705572,1,49,48,2,6,3,7,2,62,58,75
516,92,92,78,78,0,80,80,97,97,0,80,80,97,97,0,0.02978317846080534,0.02978317846080534,92,92,0,-1,2,2,2,4,95,22,80
517,388,1004,97,100,3,392,392,99,99,0,392,392,99,99,0,0.032199870655910685,0.04251335988290956,91,94,3,2,2,2,14,15,17,16,5
518,90,296,69,98,29,54,54,55,55,0,54,54,58,58,0,0.008305252050784574,0.012049423057285817,67,74,7,3,3,3,4,9,53,31,28
519,100,100,64,64,0,100,100,45,45,0,100,100,64,64,0,0.03448041117805235,0.03584192790768916,94,95,1,3,1,1,10,18,18,30,70
520,2,618,29,100,71,8,30,31,44,13,2,30,29,54,25,0.00030634126416828345,0.007658531604207087,33,64,31,2,5,3,4,1,77,65,21
521,28,130,54,86,32,30,30,43,43,0,28,30,54,54,0,0.001599782157323258,0.00176997174852786,44,44,0,4,3,3,4,3,72,54,55
522,160,776,88,100,12,94,94,72,72,0,94,94,73,73,0,0.019163347969638176,0.0230436706491031,83,84,1,2,2,2,5,16,80,12,70
523,0,206,1,89,88,0,31,1,30,29,0,12,1,32,31,0.0,0.0033357159876101976,1,49,48,3,-1,4,10,0,12,59,73
524,66,167,64,89,25,48,48,60,60,0,48,48,63,63,0,0.009190237925048503,0.009360427516253106,65,65,0,5,3,3,3,6,58,34,65
525,56,262,58,95,37,64,64,65,65,0,64,64,67,67,0,0.0088498587426393,0.01841451376833793,67,81,14,3,3,3,4,5,47,25,39
526,0,101,1,77,76,0,8,1,25,24,0,1,1,25,24,0.0,3.4037918240920386e-05,1,25,24,5,-1,6,8,0,30,93,78
527,2,104,27,78,51,7,7,28,28,0,2,4,27,31,4,0.0002042275094455223,0.000442492937131965,31,33,2,4,5,5,4,1,79,60,55
528,37,237,56,94,38,28,28,44,44,0,28,28,54,54,0,0.005582218591510943,0.010790020082371761,61,70,9,3,3,3,3,6,76,35,77
529,0,102,1,77,76,0,9,1,28,27,0,4,1,30,29,0.0,0.001599782157323258,1,42,41,4,-1,5,5,0,37,99,75
530,0,0,1,1,0,0,0,1,1,0,0,0,1,1,0,0.0,0.0,1,1,0,-1,-1,-1,2,0,97,98,45
531,100,100,66,66,0,100,100,45,45,0,100,100,66,66,0,0.047959426801456824,0.04915075393988903,97,97,0,3,1,1,10,22,1,9,52
532,86,292,65,95,30,86,86,62,62,0,86,86,65,65,0,0.007454304094761564,0.008951972497362062,63,66,3,3,3,3,6,7,74,21,52
533,292,908,95,100,5,252,262,94,94,0,252,262,94,94,0,0.02294155689438034,0.04428333163143742,86,94,8,2,2,2,11,16,19,12,10
534,22,638,45,100,55,50,70,48,62,14,22,70,45,65,20,0.0016678579938050988,0.017903944994724124,43,80,37,2,3,3,5,2,49,52,30
535,96,96,71,71,0,72,72,77,77,0,72,72,77,77,0,0.014806494434800367,0.014806494434800367,77,77,0,-1,2,2,3,6,64,77,67
536,6,212,32,92,60,14,18,32,34,2,6,18,32,47,15,3.4037918240920386e-05,0.005820484019197386,27,56,29,3,4,4,3,1,87,95,48
537,110,316,73,94,21,110,110,72,72,0,110,110,76,76,0,0.011606930120153852,0.012662105585622384,73,75,2,3,2,2,6,6,40,77,61
538,0,102,1,79,78,0,5,1,26,25,0,4,1,30,29,0.0,0.00013615167296368154,1,28,27,4,-1,5,3,0,94,40,56
539,281,381,98,100,2,88,88,84,84,0,88,88,84,84,0,0.03618230709009837,0.03635249668130297,94,94,0,4,2,2,4,29,67,11,4
540,0,0,1,1,0,0,0,1,1,0,0,0,1,1,0,0.0,0.0,1,1,0,-1,-1,-1,8,0,42,91,92
541,0,102,1,77,76,0,8,1,28,27,0,2,1,26,25,0.0,0.00030634126416828345,1,33,32,4,-1,5,5,0,37,81,42
542,8,214,37,95,58,18,18,38,38,0,8,18,37,46,9,0.0020082371762143027,0.015657442390823378,46,76,30,3,4,4,3,2,81,61,16
543,413,413,99,99,0,152,152,94,94,0,152,152,94,94,0,0.03720344463732598,0.03720344463732598,93,93,0,-1,2,2,5,29,52,1,50
544,40,656,52,100,48,106,116,66,67,1,40,73,52,58,6,0.0030293747234419145,0.009292351679771264,49,65,16,2,2,2,7,1,24,53,34
545,100,100,63,63,0,100,100,47,47,0,100,100,63,63,0,0.06017903944994724,0.06017903944994724,99,99,0,-1,1,1,10,40,22,3,89
546,16,16,39,39,0,66,66,49,49,0,16,16,39,39,0,0.0034037918240920387,0.0034037918240920387,51,51,0,-1,3,3,6,1,44,90,92
547,80,696,57,100,43,180,180,71,71,0,80,180,57,85,28,0.00970080669866231,0.021648116001225366,63,84,21,2,2,2,11,5,5,25,6
548,110,316,77,95,18,138,138,71,71,0,110,138,77,80,3,0.007862759113652609,0.012662105585622384,64,71,7,3,2,2,9,6,54,13,38
549,130,1770,81,100,19,172,216,75,84,9,130,216,81,91,10,0.008237176214302734,0.02757071377514551,65,87,22,1,3,2,12,13,3,24,39
550,46,252,62,99,37,22,22,47,47,0,22,22,52,52,0,0.005071649817897137,0.00878178290615746,58,69,11,3,3,3,2,6,89,26,22
551,98,714,77,100,23,72,72,84,84,0,72,72,84,84,0,0.015487252799618776,0.026753803737363423,77,89,12,2,2,2,3,9,81,27,33
552,100,100,81,81,0,100,100,98,98,0,100,100,98,98,0,0.07835528779059872,0.07835528779059872,99,99,0,5,1,1,2,2,99,94,95
553,0,102,1,77,76,0,7,1,27,26,0,2,1,24,23,0.0,0.00013615167296368154,1,29,28,4,-1,5,5,0,50,36,4
554,22,22,47,47,0,28,28,45,45,0,22,22,47,47,0,0.002484768031587188,0.002484768031587188,47,47,0,-1,3,3,3,2,60,52,91
555,0,102,1,81,80,0,6,1,28,27,0,2,1,28,27,0.0,0.00030634126416828345,1,32,31,4,-1,5,4,0,77,96,88
556,0,102,1,78,77,0,7,1,28,27,0,2,1,28,27,0.0,0.0005105687736138058,1,35,34,4,-1,5,4,0,47,85,42
557,0,206,1,90,89,0,24,1,32,31,0,6,1,30,29,0.0,0.0026209197045508697,1,45,44,3,-1,4,6,0,48,84,90
558,1,103,25,81,56,3,4,25,26,1,1,3,25,30,5,3.4037918240920386e-05,0.00013615167296368154,27,30,3,4,6,5,3,2,81,58,65
559,102,718,82,100,18,72,72,80,80,0,72,72,80,80,0,0.01575955614554614,0.02828551005820484,81,91,10,2,2,2,3,8,66,8,5
560,58,658,57,100,43,54,54,52,52,0,54,54,55,55,0,0.008509479560230097,0.011368664692467409,66,70,4,2,3,3,4,6,83,34,70
561,6,622,30,100,70,36,56,36,47,11,6,56,30,56,26,0.0006807583648184077,0.016406276592123625,36,79,43,2,4,3,6,1,65,49,19
562,96,197,59,90,31,202,202,72,72,0,96,97,59,59,0,0.0035059055788147996,0.0035059055788147996,51,51,0,5,2,2,14,6,8,70,78
563,8,8,38,38,0,24,24,38,38,0,8,8,38,38,0,0.0010211375472276116,0.0010211375472276116,39,39,0,-1,4,4,4,2,72,74,98
564,18,224,48,99,51,22,22,55,55,0,18,22,54,56,2,0.002552843868069029,0.0068075836481840775,49,63,14,3,3,3,2,2,97,52,24
565,100,100,65,65,0,100,100,47,47,0,100,100,65,65,0,0.020014295925661188,0.02307770856734402,82,83,1,3,1,1,11,8,38,57,13
566,12,218,41,96,55,8,8,32,32,0,12,8,41,38,-3,0.0013274788113958951,0.0020763130126961434,41,44,3,3,4,4,2,2,95,61,64
567,100,100,58,58,0,100,100,38,38,0,100,100,58,58,0,0.014806494434800367,0.05248646992749923,75,98,23,1,1,1,16,6,9,28,2
568,49,665,54,100,46,98,98,54,54,0,49,98,54,63,9,0.004561081044283332,0.009156200006807584,54,66,12,2,3,3,8,4,10,22,28
569,2,2,26,26,0,14,14,27,27,0,2,2,26,26,0,0.0,0.0,1,1,0,-1,5,5,12,2,6,58,98
570,64,270,62,93,31,54,54,52,52,0,64,54,63,55,-8,0.007862759113652609,0.008577555396711936,64,66,2,3,3,3,4,4,83,38,71
571,2,618,26,100,74,13,102,26,57,31,2,102,26,74,48,0.00010211375472276115,0.0156914803090643,30,77,47,2,5,3,12,1,3,78,15
572,129,129,87,87,0,78,78,75,75,0,78,78,77,77,0,0.015214949453691413,0.015214949453691413,79,79,0,-1,2,2,4,14,77,32,98
573,104,205,78,92,14,70,70,56,56,0,70,70,63,63,0,0.012253650566731339,0.01232172640321318,72,72,0,5,3,3,5,8,37,8,95
574,100,100,70,70,0,100,100,53,53,0,100,100,70,70,0,0.02743456210218183,0.02743456210218183,87,87,0,-1,1,1,9,9,31,27,99
575,100,100,81,81,0,100,100,98,98,0,100,100,98,98,0,0.10425814357193915,0.12117498893767657,100,100,0,2,1,1,2,29,86,11,18
576,0,616,1,99,98,0,62,1,33,32,0,36,1,47,46,0.0,0.004050512270669526,1,53,52,2,-1,3,12,0,6,81,28
577,100,100,61,61,0,100,100,40,40,0,100,100,61,61,0,0.04738078219136117,0.057864461009564654,98,99,1,2,1,1,14,30,8,7,37
578,0,101,1,80,79,0,3,1,24,23,0,1,1,24,23,0.0,0.0,1,1,0,6,-1,7,3,0,76,89,78
579,260,260,95,95,0,88,88,76,76,0,88,88,79,79,0,0.03240409816535621,0.03240409816535621,91,91,0,-1,2,2,4,27,47,10,89
580,100,100,62,62,0,100,100,43,43,0,100,100,62,62,0,0.04697232717247013,0.04697232717247013,95,95,0,-1,1,1,12,30,14,7,87
581,240,856,90,100,10,300,300,91,91,0,240,300,90,94,4,0.011845195547840293,0.023520201504475986,68,88,20,2,2,2,14,9,25,31,37
582,24,640,47,100,53,34,44,39,48,9,24,44,47,53,6,0.0013274788113958951,0.01334286395044079,41,76,35,2,3,3,4,3,53,43,20
583,100,100,67,67,0,100,100,54,54,0,100,100,67,67,0,0.031314884781646755,0.031314884781646755,91,91,0,-1,1,1,9,6,35,77,66
584,16,222,36,93,57,70,74,44,44,0,16,30,36,46,10,0.0021784267674189047,0.004288777698355968,46,52,6,3,3,3,9,2,35,94,70
585,0,1640,1,100,99,0,44,1,71,70,0,44,1,72,71,0.0,0.036760951700194014,1,93,92,1,-1,2,3,0,60,66,73
586,6,212,27,89,62,24,28,31,31,0,6,13,27,32,5,0.00030634126416828345,0.0013615167296368155,31,38,7,3,4,4,6,1,40,88,61
587,0,1640,1,100,99,0,118,1,60,59,0,92,1,63,62,0.0,0.01674665577453283,1,77,76,1,-1,2,13,0,13,86,33
588,100,100,69,69,0,100,100,70,70,0,100,100,72,72,0,0.06776949521767249,0.06776949521767249,99,99,0,-1,1,1,6,40,65,3,59
589,54,54,54,54,0,86,86,57,57,0,54,54,55,55,0,0.006705469893461316,0.006705469893461316,60,60,0,-1,3,3,6,4,65,72,98
590,1,617,25,100,75,3,28,25,42,17,1,28,25,49,24,0.0,0.020729092208720514,1,87,86,2,6,3,3,1,96,68,0
591,92,708,67,100,33,78,78,68,68,0,78,78,71,71,0,0.009496579189216788,0.02018448551686579,69,83,14,2,2,2,4,7,83,48,8
592,136,136,84,84,0,80,80,68,68,0,80,80,72,72,0,0.017972020831205963,0.017972020831205963,80,80,0,-1,3,3,5,17,88,6,86
593,132,338,81,96,15,158,158,78,78,0,132,138,82,86,4,0.017052997038701112,0.017393376221110316,78,78,0,3,2,2,9,9,29,39,56
594,1,207,25,96,71,2,12,25,38,13,1,12,25,44,19,0.0,0.018176248340651485,1,82,81,3,6,4,2,1,93,78,0
595,0,206,1,91,90,0,24,1,33,32,0,8,1,34,33,0.0,0.0018380475850097008,1,39,38,3,-1,4,6,0,56,91,52
596,0,0,1,1,0,0,0,1,1,0,0,0,1,1,0,0.0,0.0,1,1,0,-1,-1,-1,5,0,80,79,84
597,381,981,100,100,0,96,96,89,89,0,96,96,89,89,0,0.04823173014738419,0.05680928554409612,96,97,1,2,2,2,3,40,64,3,39
598,16,632,39,100,61,38,48,51,62,11,16,48,39,63,24,0.0024507301133462676,0.02032063718982947,48,85,37,2,3,3,3,1,82,53,18
599,234,850,91,100,9,180,190,71,73,2,180,190,86,86,0,0.01872085503250621,0.03114469519044215,78,92,14,2,2,2,11,16,5,12,37
600,0,206,1,89,88,0,20,1,27,26,0,8,1,31,30,0.0,0.00034037918240920387,1,31,30,3,-1,4,9,0,29,36,56
601,38,1678,44,100,56,100,158,40,65,25,38,146,44,83,39,0.001055175465468532,0.014466115252391163,38,73,35,1,3,2,14,4,25,64,24
602,76,282,68,97,29,32,32,58,58,0,32,32,59,59,0,0.010075223799312433,0.01674665577453283,68,81,13,3,3,3,2,6,68,77,27
603,100,100,82,82,0,100,100,98,98,0,100,100,98,98,0,0.10075223799312434,0.10810442833316314,99,100,1,2,1,1,2,20,98,23,94
604,50,256,52,94,42,94,94,45,45,0,50,56,52,54,2,0.005956635692161067,0.006569318220497634,56,57,1,3,2,2,9,6,29,73,78
605,0,206,1,90,89,0,12,1,31,30,0,8,1,36,35,0.0,0.0007488342013002485,1,38,37,3,-1,4,4,0,79,84,74
606,0,0,1,1,0,0,0,1,1,0,0,0,1,1,0,0.0,0.0,1,1,0,-1,-1,-1,12,0,14,96,45
607,18,634,42,100,58,68,78,41,46,5,18,42,42,51,9,0.001497668402600497,0.003165526396405596,42,50,8,2,3,3,8,2,30,61,64
608,12,12,40,40,0,20,20,35,35,0,12,12,40,40,0,0.0009530617107457708,0.0009530617107457708,39,39,0,-1,4,4,4,2,47,74,82
609,250,456,92,99,7,168,168,97,97,0,168,168,97,97,0,0.021546002246502605,0.021784267674189048,84,84,0,3,2,2,6,18,51,5,65
610,0,102,1,78,77,0,15,1,26,25,0,2,1,26,25,0.0,6.807583648184077e-05,1,27,26,4,-1,5,13,0,13,97,65
611,209,825,94,100,6,144,144,90,90,0,144,144,90,90,0,0.023622315259198747,0.03182545355526056,87,92,5,2,2,2,6,20,59,23,34
612,8,1648,37,100,63,10,48,32,63,31,8,48,37,65,28,0.00030634126416828345,0.03897341638585384,32,94,62,1,4,2,3,2,85,63,24
613,70,686,59,100,41,104,104,81,81,0,70,104,60,83,23,0.005786446100956465,0.010109261717553355,56,69,13,2,2,2,5,6,61,28,35
614,262,468,92,98,6,216,216,95,95,0,216,216,95,95,0,0.026243234963749616,0.027843017121072875,86,86,0,3,2,2,9,17,54,6,70
615,78,78,71,71,0,48,48,64,64,0,48,48,66,66,0,0.013070560604513427,0.013070560604513427,75,75,0,-1,3,3,3,13,85,33,69
616,0,206,1,88,87,0,26,1,31,30,0,8,1,33,32,0.0,0.0009870996289866913,1,38,37,3,-1,4,7,0,24,40,83
617,72,278,58,95,37,66,66,44,44,0,66,66,57,57,0,0.007726607440688927,0.012934408931549747,62,73,11,3,3,3,6,8,51,57,48
618,0,206,1,88,87,0,23,1,32,31,0,14,1,35,34,0.0,0.0026549576227917903,1,46,45,3,-1,4,6,0,41,40,73
619,0,0,1,1,0,0,0,1,1,0,0,0,1,1,0,0.0,0.0,1,1,0,-1,-1,-1,9,0,29,89,91
620,0,0,1,1,0,0,0,1,1,0,0,0,1,1,0,0.0,0.0,1,1,0,-1,-1,-1,9,0,35,86,45
621,40,1680,52,100,48,72,126,45,68,23,40,126,52,77,25,0.004050512270669526,0.045304469178665034,52,97,45,1,3,2,7,6,24,73,2
622,36,36,52,52,0,88,88,52,52,0,36,36,52,52,0,0.00439089145307873,0.00439089145307873,54,54,0,-1,3,3,8,6,21,73,59
623,241,241,92,92,0,232,232,92,92,0,232,232,93,93,0,0.018754892950747133,0.018754892950747133,82,82,0,-1,2,2,10,15,1,19,40
624,0,0,1,1,0,0,0,1,1,0,0,0,1,1,0,0.0,0.0,1,1,0,-1,-1,-1,2,1,89,50,92
625,0,1640,1,100,99,0,52,1,39,38,0,47,1,51,50,0.0,0.018074134585928724,1,80,79,1,-1,2,6,0,71,80,43
626,56,262,57,95,38,78,78,69,69,0,56,78,62,69,7,0.006841621566424997,0.013887470642295518,59,77,18,3,2,2,4,3,53,29,8
627,100,100,74,74,0,100,100,87,87,0,100,100,87,87,0,0.07525783723067497,0.08928145954593417,100,100,0,2,1,1,4,30,47,7,15
628,106,106,81,81,0,72,72,83,83,0,72,72,83,83,0,0.01695088328397835,0.01695088328397835,81,81,0,-1,2,2,3,6,58,77,50
629,16,16,38,38,0,48,48,41,41,0,16,16,38,38,0,0.001157289220191293,0.001157289220191293,39,39,0,-1,3,3,7,1,62,71,45
630,126,742,80,100,20,82,92,50,54,4,82,92,65,66,1,0.009292351679771264,0.03182545355526056,65,89,24,2,3,3,7,13,43,24,7
631,0,1640,1,100,99,0,172,1,65,64,0,153,1,83,82,0.0,0.023384049831512304,1,87,86,1,-1,2,17,0,20,79,18
632,138,344,84,98,14,216,216,83,83,0,138,146,84,86,2,0.016440314510364547,0.018006058749446885,79,80,1,3,2,2,12,9,14,39,52
633,12,12,35,35,0,18,18,35,35,0,12,12,35,35,0,0.0014295925661186562,0.0014295925661186562,39,39,0,-1,4,4,3,2,94,61,67
634,6,622,29,100,71,21,44,29,34,5,6,33,29,48,19,0.0,0.003608019333537561,1,51,50,2,4,3,9,1,28,95,35
635,184,384,94,100,6,56,56,88,88,0,56,56,88,88,0,0.03209775690118792,0.04898056434868443,92,98,6,3,2,2,2,15,93,16,11
636,100,100,59,59,0,100,100,46,46,0,100,100,59,59,0,0.02719629667449539,0.04053916062493618,88,95,7,2,1,1,11,8,5,20,37
637,234,336,93,97,4,156,156,87,87,0,156,156,89,89,0,0.022499063957248374,0.022635215630212056,85,85,0,4,2,2,8,16,21,12,65
638,40,246,51,93,42,150,150,68,68,0,40,50,51,55,4,0.002825147213996392,0.0040845501889104465,48,51,3,3,2,2,11,1,19,53,54
639,0,206,1,95,94,0,12,1,40,39,0,12,1,40,39,0.0,0.006331052792811192,1,59,58,3,-1,4,2,1,95,45,31
640,0,0,1,1,0,0,0,1,1,0,0,0,1,1,0,0.0,0.0,1,1,0,-1,-1,-1,7,0,46,89,97
641,387,387,100,100,0,176,176,100,100,0,176,176,100,100,0,0.045134279587460434,0.045134279587460434,97,97,0,-1,2,2,5,29,88,11,66
642,51,153,53,85,32,50,50,46,46,0,50,50,53,53,0,0.004322815616596889,0.00445896728956057,51,51,0,4,3,3,5,6,50,35,55
643,0,1640,1,100,99,0,216,1,72,71,0,216,1,88,87,0.0,0.03311889444841554,1,92,91,1,-1,2,17,0,20,40,3
644,0,616,1,100,99,0,24,1,44,43,0,17,1,45,44,0.0,0.0032336022328874367,1,50,49,2,-1,3,3,0,87,96,61
645,0,616,1,100,99,0,22,1,46,45,0,22,1,51,50,0.0,0.00881582082439838,1,68,67,2,-1,3,2,0,89,67,44
646,18,224,47,93,46,44,44,50,50,0,18,44,47,56,9,0.0016338200755641784,0.010449640899962559,43,72,29,3,3,3,4,2,73,61,39
647,91,297,76,99,23,38,38,56,56,0,38,38,57,57,0,0.015248987371932332,0.01773375540351952,80,83,3,3,3,3,3,12,60,37,75
648,0,0,1,1,0,0,0,1,1,0,0,0,1,1,0,0.0,0.0,1,1,0,-1,-1,-1,5,0,80,86,79
649,16,632,34,100,66,36,76,31,37,6,16,56,34,53,19,0.0004084550188910446,0.004220701861874128,35,53,18,2,3,3,12,1,2,55,47
650,40,142,52,82,30,80,80,65,65,0,40,43,52,52,0,0.006467204465774873,0.006773545729943157,60,60,0,4,2,2,5,1,37,90,56
651,128,334,80,96,16,120,120,79,79,0,120,120,81,81,0,0.015317063208414174,0.01851662752306069,80,81,1,3,2,2,6,9,44,39,28
652,67,169,62,89,27,54,54,55,55,0,54,54,60,60,0,0.007862759113652609,0.008135062459579971,62,64,2,4,3,3,4,8,73,44,49
653,128,728,82,100,18,90,90,71,71,0,90,90,73,73,0,0.01412573606998196,0.0228734810578985,77,82,5,2,2,2,6,14,69,32,39
654,6,622,32,100,68,24,34,40,44,4,6,34,32,52,20,0.002212464685659825,0.007862759113652609,47,64,17,2,4,3,4,2,84,94,35
655,216,216,87,87,0,176,176,88,88,0,176,176,88,88,0,0.024064808196330712,0.024064808196330712,85,85,0,-1,2,2,8,18,27,30,93
656,0,206,1,93,92,0,16,1,32,31,0,16,1,42,41,0.0,0.0051397256543789785,1,56,55,3,-1,4,4,0,73,85,31
657,244,450,97,100,3,96,96,90,90,0,96,96,90,90,0,0.033935804486197624,0.04162837400864563,94,95,1,3,2,2,3,22,75,9,77
658,100,100,66,66,0,100,100,60,60,0,100,100,68,68,0,0.03168930188229688,0.03744171006501242,89,93,4,3,1,1,7,14,43,32,25
659,58,160,60,92,32,22,22,42,42,0,22,22,45,45,0,0.008679669151434699,0.00888389666088022,66,66,0,4,3,3,2,6,91,34,78
660,0,206,1,92,91,0,26,1,31,30,0,9,1,35,34,0.0,0.0009530617107457708,1,38,37,3,-1,4,11,0,19,79,43
661,350,452,100,100,0,88,88,84,84,0,88,88,84,84,0,0.04819769222914327,0.0482657680656251,99,99,0,4,2,2,4,36,67,2,88
662,12,212,36,93,57,22,22,34,34,0,12,12,36,36,0,0.0006807583648184077,0.0012253650566731338,36,41,5,3,4,4,5,2,70,63,49
663,44,250,53,94,41,50,50,48,48,0,44,50,53,56,3,0.005956635692161067,0.0141938119064638,59,77,18,3,3,3,5,4,49,38,33
664,22,228,45,91,46,42,46,40,41,1,22,46,45,53,8,0.0018040096667687805,0.005105687736138058,45,56,11,3,3,3,6,2,74,83,28
665,406,506,97,99,2,182,182,99,99,0,182,182,99,99,0,0.03897341638585384,0.03917764389529936,95,95,0,4,2,2,6,29,41,0,88
666,16,222,41,94,53,24,24,43,43,0,16,24,42,50,8,0.0007488342013002485,0.0030634126416828346,36,49,13,3,3,3,3,1,55,49,41
667,174,790,91,100,9,144,144,91,91,0,144,144,91,91,0,0.02314578440382586,0.038258620102794516,87,92,5,2,2,2,6,16,32,18,16
668,86,86,58,58,0,170,170,69,69,0,86,86,58,58,0,0.004016474352428605,0.004016474352428605,54,54,0,-1,2,2,12,6,6,70,50
669,0,616,1,100,99,0,30,1,33,32,0,16,1,36,35,0.0,0.002995336805200994,1,48,47,2,-1,3,6,0,59,97,46
670,191,291,91,98,7,88,88,82,82,0,88,88,82,82,0,0.027162258756254467,0.027162258756254467,89,89,0,5,2,2,4,15,78,16,95
671,63,165,65,90,25,54,54,55,55,0,54,54,60,60,0,0.007284114503556962,0.007454304094761564,61,61,0,4,3,3,4,8,84,57,4
672,20,636,48,100,52,18,22,48,48,0,18,22,49,49,0,0.0017359338302869397,0.009360427516253106,42,67,25,2,3,3,2,3,93,43,41
673,0,1640,1,100,99,0,100,1,44,43,0,100,1,63,62,0.0,0.017529527894074,1,79,78,1,-1,2,10,0,18,98,24
674,0,0,1,1,0,0,0,1,1,0,0,0,1,1,0,0.0,0.0,1,1,0,-1,-1,-1,2,0,97,67,84
675,6,622,29,100,71,29,70,31,40,9,6,70,29,60,31,0.0002042275094455223,0.0212056230640934,31,84,53,2,4,3,9,1,23,65,11
676,28,234,44,92,48,74,74,42,42,0,28,50,44,54,10,0.002484768031587188,0.005548180673270023,45,58,13,3,3,3,9,3,31,54,28
677,16,632,35,100,65,78,88,44,48,4,16,38,35,46,11,0.0020763130126961434,0.005650294427992784,41,55,14,2,3,3,8,1,27,53,29
678,134,340,81,95,14,150,150,84,84,0,134,150,82,86,4,0.011062323428299126,0.013070560604513427,70,73,3,3,2,2,7,7,24,21,75
679,72,278,55,93,38,136,136,64,64,0,72,78,55,56,1,0.00881582082439838,0.009054086252084823,60,61,1,3,3,3,11,6,5,34,49
680,70,686,65,100,35,70,70,59,59,0,70,70,67,67,0,0.00622893903808843,0.01334286395044079,56,75,19,2,3,3,5,5,88,47,77
681,100,100,69,69,0,100,100,55,55,0,100,100,69,69,0,0.021443888491779844,0.027094182919772627,81,91,10,2,1,1,9,6,26,73,57
682,22,124,41,80,39,48,48,36,36,0,22,24,41,43,2,0.0014295925661186562,0.001497668402600497,41,42,1,4,3,3,9,3,35,51,4
683,138,344,82,96,14,172,176,73,73,0,138,176,82,84,2,0.010279451308757957,0.014295925661186561,68,72,4,3,2,2,12,9,2,31,57
684,0,206,1,91,90,0,18,1,32,31,0,8,1,34,33,0.0,0.0014636304843595766,1,41,40,3,-1,4,7,0,62,99,83
685,0,206,1,92,91,0,20,1,31,30,0,16,1,38,37,0.0,0.00445896728956057,1,51,50,3,-1,4,6,0,69,66,62
686,6,108,32,81,49,18,18,35,35,0,6,9,32,39,7,0.0009190237925048504,0.0019061234214915416,39,44,5,4,4,4,3,1,87,71,83
687,22,638,43,100,57,52,62,39,42,3,22,53,43,55,12,0.0020082371762143027,0.00622893903808843,44,57,13,2,3,3,7,2,43,83,28
688,40,656,53,100,47,50,60,45,47,2,40,60,53,60,7,0.00445896728956057,0.01157289220191293,53,71,18,2,3,3,5,6,63,73,24
689,0,206,1,93,92,0,34,1,32,31,0,15,1,35,34,0.0,0.0026889955410327104,1,45,44,3,-1,4,9,0,23,96,41
690,24,1664,51,100,49,34,68,44,76,32,24,68,51,78,27,0.0015317063208414173,0.04009666768780421,43,94,51,1,3,2,4,4,72,64,23
691,68,684,65,100,35,64,64,64,64,0,64,64,67,67,0,0.010517716736444398,0.03420810783212499,70,92,22,2,3,3,4,8,77,17,0
692,6,622,31,100,69,10,48,32,63,31,6,48,31,65,34,0.00034037918240920387,0.022601177711971135,33,87,54,2,4,3,3,1,85,4,12
693,34,135,49,81,32,94,94,51,51,0,34,34,49,49,0,0.0033016780693692774,0.0033357159876101976,47,47,0,6,3,3,9,6,26,70,68
694,32,134,47,80,33,100,100,45,45,0,32,34,47,48,1,0.0029612988869600733,0.003199564314646516,48,48,0,4,3,3,10,2,18,75,88
695,0,616,1,100,99,0,78,1,48,47,0,78,1,61,60,0.0,0.019027196296674494,1,82,81,2,-1,3,8,0,21,98,9
696,95,95,68,68,0,76,76,55,55,0,76,76,60,60,0,0.014398039415909322,0.014398039415909322,75,75,0,-1,3,3,6,12,71,37,97
697,18,18,44,44,0,66,66,49,49,0,18,18,44,44,0,0.00176997174852786,0.00176997174852786,43,43,0,-1,3,3,6,2,32,61,36
698,2,2,28,28,0,8,8,32,32,0,2,2,28,28,0,0.00034037918240920387,0.00034037918240920387,35,35,0,-1,5,5,4,1,78,4,80
699,58,159,64,90,26,48,48,64,64,0,48,48,66,66,0,0.010892133837094524,0.010892133837094524,68,68,0,5,3,3,3,6,85,34,95
700,100,202,70,90,20,100,100,68,68,0,100,100,73,73,0,0.00980292045338507,0.011232513019503728,69,73,4,4,2,2,6,7,48,21,83
701,0,206,1,92,91,0,25,1,33,32,0,6,1,29,28,0.0,0.0015657442390823377,1,42,41,3,-1,4,9,0,35,85,94
702,28,129,47,80,33,52,52,40,40,0,28,28,47,47,0,0.0011232513019503727,0.0012253650566731338,40,40,0,5,3,3,7,3,24,43,68
703,217,217,95,95,0,168,168,96,96,0,168,168,96,96,0,0.029442799278396135,0.029442799278396135,90,90,0,-1,2,2,6,20,32,23,59
704,107,107,79,79,0,48,48,62,62,0,48,48,64,64,0,0.013036522686272508,0.013036522686272508,75,75,0,-1,3,3,3,13,64,33,67
705,40,142,51,84,33,134,134,67,67,0,40,45,51,53,2,0.004016474352428605,0.005037611899656217,52,54,2,4,2,2,10,3,36,46,43
706,138,344,84,96,12,158,158,82,82,0,138,158,84,86,2,0.0158616699002689,0.01756356581231492,77,78,1,3,2,2,9,9,35,39,83
707,189,289,96,100,4,32,32,69,69,0,32,32,69,69,0,0.03240409816535621,0.03271043942952449,93,93,0,4,3,3,2,29,93,11,4
708,16,16,36,36,0,62,62,44,44,0,16,16,36,36,0,0.0028932230504782326,0.0028932230504782326,40,40,0,-1,3,3,6,3,71,46,59
709,76,1716,61,100,39,104,148,66,78,12,76,148,61,85,24,0.00616086320160659,0.046359644644133564,56,98,42,1,3,2,9,6,26,13,11
710,0,616,1,100,99,0,36,1,37,36,0,36,1,52,51,0.0,0.00793083495013445,1,64,63,2,-1,3,5,0,61,92,77
711,16,222,43,97,54,28,28,46,46,0,16,28,43,52,9,0.003165526396405596,0.007828721195411689,49,67,18,3,3,3,3,3,81,46,21
712,305,511,98,100,2,128,128,96,96,0,128,128,96,96,0,0.03465060076925695,0.03642057251778481,93,93,0,3,2,2,5,29,49,11,70
713,36,36,56,56,0,28,28,46,46,0,28,28,53,53,0,0.004765308553728854,0.004765308553728854,57,57,0,-1,3,3,3,6,81,28,45
714,0,206,1,93,92,0,13,1,33,32,0,6,1,30,29,0.0,0.002757071377514551,1,47,46,3,-1,4,3,1,55,45,90
715,0,102,1,82,81,0,5,1,28,27,0,2,1,26,25,0.0,0.00037441710065012424,1,33,32,4,-1,5,3,0,85,93,42
716,0,0,1,1,0,0,0,1,1,0,0,0,1,1,0,0.0,0.0,1,1,0,-1,-1,-1,3,0,58,59,97
717,78,278,57,95,38,128,128,72,72,0,78,128,57,82,25,0.007420266176520644,0.011709043874876613,60,71,11,3,2,2,9,7,35,62,48
718,1,1641,25,100,75,3,62,25,76,51,1,62,25,78,53,0.00010211375472276115,0.050103815650634806,29,96,67,1,6,2,3,1,66,68,23
719,100,100,66,66,0,100,100,43,43,0,100,100,66,66,0,0.020729092208720514,0.020899281799925118,85,85,0,3,1,1,11,6,33,13,95
720,0,206,1,96,95,0,12,1,34,33,0,8,1,37,36,0.0,0.0030634126416828346,1,51,50,3,-1,4,2,0,98,97,29
721,32,238,48,92,44,76,76,41,41,0,32,41,48,54,6,0.00176997174852786,0.002586881786309949,42,49,7,3,3,3,10,3,11,51,64
722,431,637,100,100,0,224,224,98,98,0,224,224,98,98,0,0.038530923448721874,0.03955206099594949,95,95,0,3,2,2,8,30,21,7,61
723,40,1680,48,100,52,146,210,67,82,15,40,210,48,90,42,0.002314578440382586,0.031621226045815035,45,92,47,1,2,2,12,1,3,53,16
724,0,206,1,94,93,0,14,1,31,30,0,14,1,40,39,0.0,0.0020763130126961434,1,43,42,3,-1,4,3,0,96,79,41
725,100,100,84,84,0,100,100,98,98,0,100,100,98,98,0,0.09292351679771266,0.09292351679771266,100,100,0,-1,1,1,2,12,97,37,59
726,16,632,39,100,61,68,88,43,50,7,16,80,39,63,24,0.002144388849177984,0.012287688484972258,46,75,29,2,3,3,8,2,57,94,17
727,44,660,55,100,45,48,48,54,54,0,48,48,56,56,0,0.007147962830593281,0.016304162837400864,59,79,20,2,3,3,3,4,87,72,21
728,423,423,98,98,0,184,184,96,96,0,184,184,96,96,0,0.03516116954287076,0.03516116954287076,91,91,0,-1,2,2,7,29,46,1,80
729,284,490,97,100,3,134,134,90,90,0,134,134,90,90,0,0.030497974743864665,0.034684638687497875,90,95,5,3,2,2,6,22,56,9,38
730,221,821,93,100,7,72,72,80,80,0,72,72,80,80,0,0.03359542530378842,0.0405731985431771,91,94,3,2,2,2,3,29,76,0,24
731,6,212,31,93,62,14,18,35,39,4,6,18,31,44,13,0.001055175465468532,0.010143299635794275,39,72,33,3,4,4,3,2,92,42,39
732,8,624,37,100,63,14,48,35,65,30,8,48,37,66,29,0.00037441710065012424,0.028489737567650362,35,89,54,2,4,3,3,2,76,63,11
733,84,700,74,100,26,88,88,80,80,0,88,88,81,81,0,0.008747744987916539,0.012628067667381462,66,74,8,2,2,2,4,6,77,26,52
734,1,102,25,82,57,3,3,25,25,0,1,2,25,26,1,0.0,0.0,1,1,0,6,6,6,3,1,85,68,58
735,76,76,61,61,0,96,96,56,56,0,74,74,60,60,0,0.006467204465774873,0.006467204465774873,58,58,0,-1,2,2,7,6,43,41,45
736,104,104,70,70,0,174,174,72,72,0,104,104,70,70,0,0.007760645358929848,0.007760645358929848,60,60,0,-1,2,2,10,6,0,26,80
737,0,616,1,100,99,0,88,1,47,46,0,88,1,61,60,0.0,0.021069471391129718,1,83,82,2,-1,3,8,0,15,79,1
738,2,102,26,75,49,7,7,26,26,0,2,2,26,26,0,6.807583648184077e-05,0.00017018959120460194,27,30,3,4,5,5,6,1,59,78,55
739,2,618,26,100,74,6,40,26,41,15,2,40,26,52,26,6.807583648184077e-05,0.0051397256543789785,27,55,28,2,5,3,5,2,61,58,13
740,46,662,48,100,52,130,140,61,62,1,46,64,48,53,5,0.0013955546478777359,0.003437829742332959,42,51,9,2,2,2,14,2,25,56,83
741,0,101,1,76,75,0,11,1,25,24,0,1,1,25,24,0.0,3.4037918240920386e-05,1,25,24,6,-1,7,11,0,38,40,58
742,92,708,77,100,23,72,72,86,86,0,72,72,86,86,0,0.016882807447496512,0.04339834575717349,81,95,14,2,2,2,3,8,92,17,2
743,100,100,66,66,0,100,100,45,45,0,100,100,66,66,0,0.04717655468191565,0.04717655468191565,96,96,0,5,1,1,10,29,1,0,68
744,0,0,1,1,0,0,0,1,1,0,0,0,1,1,0,0.0,0.0,1,1,0,-1,-1,-1,17,0,20,99,66
745,0,206,1,89,88,0,48,1,34,33,0,24,1,42,41,0.0,0.005650294427992784,1,57,56,3,-1,4,10,0,12,92,34
746,28,234,49,95,46,34,34,39,39,0,28,34,49,50,1,0.0025188059498281084,0.0029612988869600733,47,51,4,3,3,3,4,6,53,70,63
747,22,22,51,51,0,32,32,70,70,0,22,22,51,51,0,0.002552843868069029,0.002552843868069029,46,46,0,-1,3,3,2,2,95,63,87
748,6,108,34,87,53,7,8,34,34,0,6,8,34,40,6,0.00010211375472276115,0.0007828721195411688,29,38,9,4,4,4,2,1,97,4,71
749,16,222,41,93,52,28,28,42,42,0,16,28,41,50,9,0.0009530617107457708,0.009939072126348753,39,70,31,3,3,3,3,2,64,42,33
750,0,616,1,100,99,0,38,1,33,32,0,18,1,39,38,0.0,0.0026889955410327104,1,47,46,2,-1,3,10,0,22,66,75
751,0,616,1,100,99,0,22,1,53,52,0,22,1,53,52,0.0,0.014329963579427483,1,76,75,2,-1,3,2,0,99,84,39
752,0,0,1,1,0,0,0,1,1,0,0,0,1,1,0,0.0,0.0,1,1,0,-1,-1,-1,6,0,71,85,80
753,134,236,87,95,8,86,86,62,62,0,86,86,68,68,0,0.016236087000919025,0.016304162837400864,80,80,0,4,3,3,6,18,32,30,4
754,233,849,92,100,8,144,144,91,91,0,144,144,91,91,0,0.02913645801422785,0.03621634500833929,88,95,7,2,2,2,6,15,74,16,77
755,28,644,48,100,52,46,56,41,43,2,28,56,48,57,9,0.00176997174852786,0.021546002246502605,43,85,42,2,3,3,6,3,34,54,7
756,40,246,55,95,40,62,62,77,77,0,40,62,66,78,12,0.0063650907110521125,0.013887470642295518,60,79,19,3,2,2,3,2,66,94,34
757,164,780,88,100,12,206,206,92,92,0,164,206,90,93,3,0.016916845365737433,0.027604751693386432,78,87,9,2,2,2,9,8,31,20,12
758,8,110,40,86,46,8,8,34,34,0,8,8,40,40,0,0.0018040096667687805,0.002110350930937064,43,44,1,4,4,4,2,2,93,61,4
759,96,96,74,74,0,88,88,81,81,0,88,88,81,81,0,0.01606589740971442,0.01606589740971442,77,77,0,-1,2,2,4,8,73,20,76
760,0,206,1,90,89,0,20,1,29,28,0,9,1,35,34,0.0,0.0008509479560230097,1,38,37,3,-1,4,8,0,39,85,43
761,160,776,91,100,9,48,48,64,64,0,48,48,66,66,0,0.019027196296674494,0.04360257326661901,83,96,13,2,3,3,3,19,85,15,0
762,14,630,41,100,59,12,22,36,41,5,12,22,37,45,8,0.0013955546478777359,0.03151911229109228,41,91,50,2,4,3,2,4,68,64,2
763,174,174,87,87,0,262,262,84,84,0,174,174,87,87,0,0.017393376221110316,0.017393376221110316,77,77,0,-1,2,2,14,12,8,37,69
764,6,212,33,93,60,16,16,33,33,0,6,16,33,44,11,0.00030634126416828345,0.006739507811702236,34,61,27,3,4,4,4,1,78,88,20
765,0,0,1,1,0,0,0,1,1,0,0,0,1,1,0,0.0,0.0,1,1,0,-1,-1,-1,6,0,41,84,93
766,146,762,87,100,13,88,88,76,76,0,88,88,79,79,0,0.02314578440382586,0.029374723441914292,87,90,3,2,2,2,4,17,47,6,72
767,288,494,96,100,4,94,94,76,76,0,94,94,77,77,0,0.03223390857415161,0.038224582184553595,90,93,3,3,2,2,5,30,70,7,32
768,18,634,41,100,59,50,54,38,41,3,18,46,41,52,11,0.0004765308553728854,0.004152626025392287,36,51,15,2,3,3,7,2,43,56,22
769,32,32,47,47,0,100,100,45,45,0,32,32,47,47,0,0.0029612988869600733,0.0029612988869600733,48,48,0,-1,3,3,10,2,18,75,79
770,66,272,62,96,34,54,54,54,54,0,54,54,58,58,0,0.005037611899656217,0.009326389598012186,57,68,11,3,3,3,4,6,47,28,57
771,44,250,54,96,42,48,48,72,72,0,48,48,74,74,0,0.006637394056979475,0.012798257258586064,57,75,18,3,3,3,3,4,60,38,27
772,22,123,50,91,41,22,22,55,55,0,22,22,57,57,0,0.005241839409101739,0.005412029000306341,57,57,0,5,3,3,2,2,97,83,60
773,223,223,91,91,0,176,176,85,85,0,176,176,89,89,0,0.025085945743558324,0.025085945743558324,87,87,0,-1,2,2,8,20,42,23,59
774,70,70,61,61,0,124,124,66,66,0,70,70,61,61,0,0.005616256509751864,0.005616256509751864,55,55,0,-1,3,3,9,5,54,47,87
775,60,266,54,94,40,168,168,68,68,0,60,68,54,54,0,0.005718370264474625,0.006671431975220395,55,60,5,3,3,3,13,6,13,26,74
776,16,16,44,44,0,34,34,47,47,0,16,16,45,45,0,0.00176997174852786,0.00176997174852786,43,43,0,-1,3,3,4,1,78,53,40
777,105,311,71,97,26,144,144,61,61,0,105,117,71,75,4,0.006024711528642908,0.007318152421797883,56,59,3,3,2,2,10,6,0,35,51
778,0,0,1,1,0,0,0,1,1,0,0,0,1,1,0,0.0,0.0,1,1,0,-1,-1,-1,5,0,37,84,79
779,0,206,1,92,91,0,22,1,33,32,0,22,1,47,46,0.0,0.005446066918547262,1,57,56,3,-1,4,5,0,70,98,48
780,163,779,94,100,6,56,56,84,84,0,56,56,84,84,0,0.02828551005820484,0.03972225058715409,89,96,7,2,2,2,2,19,86,15,44
781,0,616,1,100,99,0,78,1,46,45,0,78,1,62,61,0.0,0.02563055243541305,1,86,85,2,-1,3,8,0,57,82,0
782,54,670,51,100,49,96,126,53,76,23,53,126,51,83,32,0.004493005207801491,0.0348888661969434,53,91,38,2,2,2,7,6,46,41,2
783,54,54,54,54,0,94,94,45,45,0,54,54,54,54,0,0.006467204465774873,0.006467204465774873,57,57,0,-1,3,3,9,7,29,62,86
784,0,102,1,81,80,0,8,1,30,29,0,4,1,33,32,0.0,0.0009870996289866913,1,38,37,4,-1,5,4,1,77,69,51
785,0,206,1,92,91,0,12,1,28,27,0,6,1,28,27,0.0,0.00034037918240920387,1,31,30,3,-1,4,6,0,59,81,88
786,100,100,59,59,0,100,100,39,39,0,100,100,59,59,0,0.014364001497668403,0.015623404472582456,75,77,2,3,1,1,14,2,16,52,54
787,0,206,1,86,85,0,38,1,32,31,0,14,1,34,33,0.0,0.002825147213996392,1,49,48,3,-1,4,11,0,5,87,73
788,0,206,1,95,94,0,10,1,30,29,0,10,1,34,33,0.0,0.013683243132849994,1,75,74,3,-1,4,3,0,94,84,6
789,236,336,92,95,3,174,174,93,93,0,174,174,94,94,0,0.017155110793423873,0.017189148711664794,80,80,0,4,2,2,7,14,24,32,4
790,94,1734,67,100,33,90,124,61,87,26,94,124,67,88,21,0.007284114503556962,0.03985840226011777,61,95,34,1,2,2,6,5,41,47,16
791,8,214,38,97,59,8,8,33,33,0,8,8,38,38,0,0.002314578440382586,0.006467204465774873,44,62,18,3,4,4,2,2,99,75,72
792,100,100,63,63,0,100,100,47,47,0,100,100,63,63,0,0.016610504101569147,0.018380475850097007,81,83,2,3,1,1,10,2,36,58,52
793,142,142,90,90,0,96,96,87,87,0,96,96,87,87,0,0.021511964328261683,0.021511964328261683,87,87,0,-1,2,2,3,8,87,8,81
794,0,616,1,100,99,0,28,1,47,46,0,28,1,53,52,0.0,0.018244324177133328,1,82,81,2,-1,3,3,0,55,79,6
795,16,222,34,86,52,82,82,40,40,0,16,24,34,42,8,0.0029612988869600733,0.003880322679464924,49,52,3,3,3,3,12,3,2,46,61
796,0,206,1,91,90,0,30,1,30,29,0,9,1,34,33,0.0,0.0008509479560230097,1,37,36,3,-1,4,11,0,38,40,43
797,12,12,36,36,0,36,36,36,36,0,12,12,36,36,0,0.00034037918240920387,0.00034037918240920387,34,34,0,-1,4,4,8,2,10,63,59
798,225,841,94,100,6,152,152,94,94,0,152,152,94,94,0,0.021137547227611558,0.029408761360155213,86,90,4,2,2,2,5,15,52,19,21
799,2,618,28,100,72,3,22,28,46,18,2,22,28,51,23,6.807583648184077e-05,0.009939072126348753,28,69,41,2,5,3,2,1,89,95,77
800,348,948,96,100,4,176,176,85,85,0,176,176,89,89,0,0.032165832737669764,0.03635249668130297,88,90,2,2,2,2,8,29,42,0,38
801,16,118,44,83,39,34,34,47,47,0,16,20,45,50,5,0.002586881786309949,0.0038462847612240037,49,53,4,4,3,3,4,2,78,94,83
802,2,104,27,76,49,14,15,28,28,0,2,5,27,28,1,6.807583648184077e-05,0.0004765308553728854,27,34,7,4,5,5,8,1,39,95,63
803,142,1782,80,100,20,270,304,79,86,7,142,304,80,96,16,0.011164437183021887,0.038939378467612924,62,95,33,1,2,2,16,9,9,27,1
804,0,616,1,100,99,0,100,1,44,43,0,100,1,63,62,0.0,0.02110350930937064,1,85,84,2,-1,3,10,0,18,81,11
805,400,501,97,98,1,288,288,95,95,0,288,288,95,95,0,0.033084856530174615,0.033221008203138294,91,91,0,5,2,2,12,27,3,10,78
806,0,616,1,100,99,0,48,1,37,36,0,30,1,44,43,0.0,0.006262976956329351,1,55,54,2,-1,3,7,1,46,45,62
807,248,1888,92,100,8,332,356,92,97,5,248,356,92,99,7,0.017291262466387555,0.04554273460635148,82,96,14,1,2,2,16,13,9,33,1
808,1,102,25,78,53,6,6,25,25,0,1,2,25,27,2,0.0,0.0,1,1,0,6,6,6,6,1,69,68,58
809,58,160,62,91,29,72,72,79,79,0,72,72,80,80,0,0.009734844616903231,0.009734844616903231,73,72,-1,4,2,2,3,4,75,38,4
810,144,246,89,96,7,72,72,84,84,0,72,72,84,84,0,0.019129310051397258,0.019469689233806462,84,84,0,4,2,2,3,14,85,32,49
811,2,2,28,28,0,8,8,29,29,0,2,2,28,28,0,0.00010211375472276115,0.00010211375472276115,30,30,0,-1,5,5,5,1,70,95,36
812,128,744,80,100,20,232,232,76,76,0,128,174,80,86,6,0.007113924912352361,0.013104598522754349,62,72,10,2,2,2,14,6,8,26,25
813,260,362,96,98,2,168,168,97,97,0,168,168,97,97,0,0.02641342455495422,0.02668572790088158,90,90,0,4,2,2,6,19,59,15,49
814,0,0,1,1,0,0,0,1,1,0,0,0,1,1,0,0.0,0.0,1,1,0,-1,-1,-1,2,0,68,85,50
815,0,0,1,1,0,0,0,1,1,0,0,0,1,1,0,0.0,0.0,1,1,0,-1,-1,-1,5,0,70,82,81
816,0,206,1,94,93,0,8,1,32,31,0,8,1,37,36,0.0,0.0014295925661186562,1,42,41,3,-1,4,2,0,90,99,52
817,44,250,58,95,37,38,38,52,52,0,38,38,55,55,0,0.006501242384015794,0.011266550937744648,63,74,11,3,3,3,3,4,66,38,44
818,58,674,61,100,39,94,94,72,72,0,58,94,61,72,11,0.005514142755029102,0.014602266925354846,59,78,19,2,2,2,5,6,80,70,17
819,0,616,1,100,99,0,98,1,41,40,0,98,1,60,59,0.0,0.014568229007113924,1,73,72,2,-1,3,12,1,2,45,6
820,0,1640,1,100,99,0,100,1,68,67,0,100,1,69,68,0.0,0.04482793832329215,1,97,96,1,-1,2,6,0,34,80,3
821,134,750,80,100,20,166,176,88,89,1,134,176,83,90,7,0.013751318969331836,0.03815650634807175,75,94,19,2,2,2,8,6,21,77,11
822,6,212,30,91,61,16,24,33,36,3,6,24,30,49,19,0.0002042275094455223,0.004595118962524252,31,53,22,3,4,4,4,1,83,95,62
823,22,22,53,53,0,32,32,63,63,0,22,22,55,55,0,0.004901460226692535,0.004901460226692535,58,58,0,-1,3,3,2,3,98,29,93
824,100,100,59,59,0,100,100,40,40,0,100,100,59,59,0,0.0631063004186664,0.06732700228054052,100,100,0,1,1,1,15,36,7,2,53
825,22,228,38,90,52,38,38,35,35,0,22,34,38,44,6,0.0013274788113958951,0.0035059055788147996,38,47,9,3,3,3,6,2,51,74,75
826,164,164,92,92,0,48,48,67,67,0,48,48,70,70,0,0.020354675108070392,0.020354675108070392,86,86,0,-1,3,3,3,19,96,15,84
827,0,616,1,99,98,0,72,1,38,37,0,34,1,43,42,0.0,0.0053439531638245,1,53,52,2,-1,3,11,1,33,69,38
828,90,90,67,67,0,68,68,72,72,0,68,68,74,74,0,0.011334626774226489,0.011334626774226489,70,70,0,-1,2,2,4,6,67,26,36
829,248,454,93,99,6,264,264,93,93,0,264,264,94,94,0,0.0228734810578985,0.02324789815854862,86,86,0,3,2,2,12,16,14,18,49
830,42,248,51,93,42,134,134,66,66,0,42,48,52,52,0,0.0026889955410327104,0.005173763572619898,48,55,7,3,2,2,10,2,1,61,90
831,50,50,57,57,0,48,48,54,54,0,48,48,56,56,0,0.006909697402906838,0.006909697402906838,58,58,0,-1,3,3,3,6,87,26,98
832,0,0,1,1,0,0,0,1,1,0,0,0,1,1,0,0.0,0.0,1,1,0,-1,-1,-1,2,0,86,91,50
833,6,622,30,100,70,18,56,32,47,15,6,56,30,56,26,0.00034037918240920387,0.021716191837707205,31,84,53,2,4,3,6,1,65,55,10
834,22,228,45,91,46,50,50,46,46,0,22,50,45,56,11,0.0023486163586235067,0.006126825283365669,46,59,13,3,3,3,5,2,80,52,47
835,274,874,95,100,5,144,144,91,91,0,144,144,92,92,0,0.030225671397937304,0.034310221586847746,90,92,2,2,2,2,6,22,51,9,13
836,120,326,78,98,20,124,124,91,91,0,124,124,91,91,0,0.011981347220803976,0.017359338302869398,70,79,9,3,2,2,6,7,65,48,21
837,16,222,34,90,56,40,45,33,33,0,16,24,34,44,10,0.0004084550188910446,0.0014636304843595766,35,39,4,3,3,3,12,1,3,4,51
838,6,622,30,100,70,14,28,31,35,4,6,22,30,42,12,0.00017018959120460194,0.0036760951700194017,30,51,21,2,4,3,5,1,63,60,46
839,84,290,60,95,35,202,202,74,74,0,84,90,60,63,3,0.006126825283365669,0.00878178290615746,58,64,6,3,2,2,13,5,13,47,90
840,84,684,69,100,31,94,94,76,76,0,84,94,76,76,0,0.009632730862180468,0.027026107083290785,69,87,18,2,2,2,5,6,70,26,16
841,0,102,1,76,75,0,15,1,27,26,0,2,1,26,25,0.0,0.0005105687736138058,1,33,32,4,-1,5,9,0,54,86,42
842,42,144,59,87,28,48,48,66,66,0,48,48,67,67,0,0.00970080669866231,0.010994247591817285,70,71,1,4,3,3,3,5,76,25,52
843,386,592,96,99,3,310,310,97,97,0,310,310,97,97,0,0.026039007454304094,0.037679975492698865,88,93,5,3,2,2,11,19,33,15,18
844,0,0,1,1,0,0,0,1,1,0,0,0,1,1,0,0.0,0.0,1,1,0,-1,-1,-1,2,0,89,59,67
845,0,616,1,100,99,0,44,1,32,31,0,22,1,40,39,0.0,0.0011232513019503727,1,36,35,2,-1,3,14,0,16,67,63
846,166,1766,84,100,16,208,208,85,85,0,166,208,84,90,6,0.014874570271282209,0.04714251676367474,76,97,21,1,2,2,10,9,18,39,3
847,2,2,27,27,0,10,10,27,27,0,2,2,27,27,0,6.807583648184077e-05,6.807583648184077e-05,29,29,0,-1,5,5,9,1,35,78,50
848,38,654,46,100,54,100,130,45,60,15,38,130,46,77,31,0.0012594029749140542,0.020763130126961436,39,84,45,2,3,3,10,4,0,64,16
849,0,616,1,100,99,0,28,1,39,38,0,28,1,48,47,0.0,0.011062323428299126,1,75,74,2,-1,3,3,0,82,92,19
850,133,333,87,98,11,48,48,62,62,0,48,48,64,64,0,0.01579359406378706,0.019741992579733823,80,85,5,3,3,3,3,18,64,5,62
851,0,616,1,100,99,0,38,1,48,47,0,38,1,53,52,0.0,0.007998910786616291,1,61,60,2,-1,3,3,0,87,96,13
852,430,636,100,100,0,168,168,96,96,0,168,168,96,96,0,0.04864018516627523,0.04962728479526192,96,96,0,3,2,2,6,40,32,3,52
853,373,579,99,100,1,120,120,99,99,0,120,120,99,99,0,0.05265665951870384,0.06113210116069301,97,97,0,3,2,2,3,36,75,2,32
854,32,238,44,93,49,78,78,45,45,0,32,56,44,51,7,0.0012934408931549745,0.006569318220497634,41,58,17,3,3,3,8,2,42,74,72
855,16,1656,34,100,66,66,144,37,70,33,16,144,34,81,47,0.0004765308553728854,0.03774805132918071,35,94,59,1,3,2,10,1,11,49,2
856,71,71,57,57,0,108,108,61,61,0,71,71,57,57,0,0.005105687736138058,0.005105687736138058,57,57,0,-1,2,2,9,6,28,35,92
857,144,760,82,100,18,112,112,92,92,0,112,112,92,92,0,0.012049423057285817,0.040300895197249734,72,94,22,2,2,2,4,6,83,13,1
858,42,658,52,100,48,94,104,51,66,15,40,58,51,57,6,0.003642057251778481,0.0053439531638245,51,54,3,2,3,3,9,6,23,41,52
859,0,101,1,86,85,0,2,1,24,23,0,1,1,24,23,0.0,0.0002042275094455223,1,30,29,5,-1,6,2,0,97,82,88
860,40,246,50,92,42,134,134,69,69,0,40,48,50,55,5,0.003778208924742163,0.003948398515946765,53,54,1,3,2,2,10,2,11,94,63
861,0,616,1,100,99,0,30,1,42,41,0,30,1,50,49,0.0,0.015112835698968652,1,78,77,2,-1,3,4,0,73,92,16
862,86,702,69,100,31,48,48,63,63,0,48,48,64,64,0,0.008747744987916539,0.03655672419074849,68,93,25,2,3,3,3,7,82,21,1
863,68,684,55,100,45,212,222,78,82,4,68,102,55,78,23,0.007828721195411689,0.010279451308757957,63,69,6,2,2,2,13,4,13,72,43
864,100,100,65,65,0,100,100,47,47,0,100,100,65,65,0,0.04081146397086354,0.0460873412982062,95,96,1,2,1,1,11,20,38,23,34
865,0,102,1,76,75,0,10,1,28,27,0,2,1,27,26,0.0,6.807583648184077e-05,1,28,27,4,-1,5,6,0,71,84,4
866,90,90,70,70,0,110,110,81,81,0,90,90,73,73,0,0.01232172640321318,0.01232172640321318,74,74,0,-1,2,2,6,6,32,77,36
867,100,100,69,69,0,100,100,55,55,0,100,100,69,69,0,0.03151911229109228,0.032506211920078965,90,91,1,3,1,1,8,14,30,14,43
868,100,100,67,67,0,100,100,70,70,0,100,100,71,71,0,0.0317233398005378,0.03196160522822424,91,91,0,4,1,1,6,8,74,57,49
869,0,616,1,100,99,0,44,1,48,47,0,44,1,53,52,0.0,0.023996732359848873,1,90,89,2,-1,3,4,0,53,98,23
870,124,124,79,79,0,208,208,88,88,0,124,124,79,79,0,0.01153885428367201,0.01153885428367201,71,71,0,-1,2,2,10,6,11,77,81
871,6,212,31,92,61,18,18,38,38,0,6,18,31,46,15,0.0010892133837094523,0.020014295925661188,39,84,45,3,4,4,3,1,85,71,11
872,108,314,72,95,23,70,70,51,51,0,70,70,57,57,0,0.013547091459886314,0.015555328636100617,77,80,3,3,3,3,5,9,52,39,46
873,22,22,43,43,0,62,62,43,43,0,22,22,43,43,0,0.0019061234214915416,0.0019061234214915416,43,43,0,-1,3,3,7,2,43,52,45
874,22,123,49,82,33,54,54,55,55,0,22,23,49,50,1,0.004186663943633207,0.004288777698355968,53,53,0,5,3,3,4,3,84,29,60
875,405,605,98,100,2,184,184,94,94,0,184,184,94,94,0,0.035739814152966405,0.04271758739235508,93,96,3,3,2,2,7,29,43,1,14
876,0,206,1,92,91,0,44,1,35,34,0,36,1,51,50,0.0,0.0040845501889104465,1,53,52,3,-1,4,8,0,21,98,13
877,0,616,1,100,99,0,32,1,28,27,0,16,1,34,33,0.0,0.0006807583648184077,1,34,33,2,-1,3,13,0,13,84,95
878,202,802,88,100,12,186,186,86,86,0,186,186,87,87,0,0.012866333095067906,0.017018959120460194,72,76,4,2,2,2,9,13,54,24,13
879,163,163,94,94,0,56,56,84,84,0,56,56,84,84,0,0.02828551005820484,0.02828551005820484,89,89,0,-1,2,2,2,19,86,15,59
880,2,208,28,92,64,12,42,29,36,7,2,38,28,46,18,3.4037918240920386e-05,0.006773545729943157,29,56,27,3,5,4,7,1,46,65,77
881,0,0,1,1,0,0,0,1,1,0,0,0,1,1,0,0.0,0.0,1,1,0,-1,-1,-1,3,1,76,45,98
882,16,632,32,99,67,68,106,34,54,20,16,68,32,53,21,0.00030634126416828345,0.006535280302256714,34,56,22,2,3,3,17,1,20,4,48
883,0,1640,1,100,99,0,112,1,72,71,0,112,1,79,78,0.0,0.03260832567480173,1,91,90,1,-1,2,8,0,39,67,1
884,100,100,70,70,0,100,100,53,53,0,100,100,70,70,0,0.05544776881445931,0.07110521120528268,100,100,0,1,1,1,9,29,31,0,27
885,115,315,83,98,15,38,38,56,56,0,38,38,59,59,0,0.01756356581231492,0.023588277340957826,83,86,3,3,3,3,3,17,58,6,20
886,52,258,65,99,34,22,22,54,54,0,22,22,54,54,0,0.005820484019197386,0.010211375472276116,60,69,9,3,3,3,2,6,99,13,21
887,84,700,62,100,38,168,168,82,82,0,84,108,62,76,14,0.007386228258279724,0.009020048333843901,63,68,5,2,2,2,9,6,54,26,64
888,0,616,1,100,99,0,116,1,57,56,0,88,1,56,55,0.0,0.009326389598012186,1,66,65,2,-1,3,14,0,25,97,8
889,170,376,90,98,8,128,128,93,93,0,128,128,93,93,0,0.018959120460192654,0.024098846114571634,82,86,4,3,2,2,5,14,88,14,34
890,110,316,77,93,16,104,104,81,81,0,104,104,84,84,0,0.010211375472276116,0.010926171755335444,70,71,1,3,2,2,5,7,61,21,71
891,100,100,71,71,0,100,100,79,79,0,100,100,79,79,0,0.030361823070900983,0.033765614894993023,88,90,2,3,1,1,5,4,70,64,22
892,2,618,26,100,74,9,64,26,39,13,2,60,26,54,28,3.4037918240920386e-05,0.009122162088566664,26,63,37,2,5,3,8,2,27,58,17
893,214,420,89,96,7,300,300,89,89,0,214,220,89,90,1,0.014806494434800367,0.01501072194424589,77,77,0,3,2,2,14,9,16,27,88
894,100,100,70,70,0,100,100,53,53,0,100,100,70,70,0,0.05544776881445931,0.05548180673270023,100,100,0,5,1,1,9,29,31,0,78
895,0,616,1,100,99,0,74,1,44,43,0,72,1,57,56,0.0,0.00970080669866231,1,67,66,2,-1,3,8,1,42,45,20
896,212,418,93,99,6,88,88,76,76,0,88,88,79,79,0,0.023213860240307704,0.03104258143571939,88,91,3,3,2,2,4,19,47,15,32
897,421,1021,99,100,1,152,152,96,96,0,152,152,96,96,0,0.052724735355185674,0.0744749651111338,99,100,1,2,2,2,5,36,80,2,1
898,2,1642,27,100,73,6,52,29,73,44,2,52,27,75,48,0.00013615167296368154,0.045644848361074235,30,96,66,1,5,2,3,1,58,4,23
899,0,206,1,89,88,0,22,1,34,33,0,6,1,28,27,0.0,0.002144388849177984,1,46,45,3,-1,4,5,0,61,84,46
900,88,688,67,100,33,148,148,79,79,0,88,148,67,83,16,0.009020048333843901,0.014568229007113924,68,76,8,2,2,2,9,4,31,38,24
901,16,632,35,100,65,80,90,41,43,2,16,90,35,60,25,0.0010211375472276116,0.011640968038394772,39,71,32,2,3,3,10,1,18,71,14
902,16,222,37,94,57,56,56,44,44,0,16,56,37,57,20,0.0018040096667687805,0.0063650907110521125,45,59,14,3,3,3,6,1,34,53,57
903,52,258,49,94,45,126,126,59,59,0,52,58,49,51,2,0.0022465026039007454,0.0035059055788147996,46,50,4,3,2,2,15,3,7,43,74
904,108,314,86,100,14,32,32,69,69,0,32,32,69,69,0,0.015283025290173252,0.02011640968038395,77,84,7,3,3,3,2,14,93,14,26
905,0,616,1,100,99,0,28,1,43,42,0,28,1,50,49,0.0,0.026039007454304094,1,88,87,2,-1,3,3,0,92,59,0
906,0,616,1,100,99,0,44,1,48,47,0,44,1,54,53,0.0,0.02209060893835733,1,85,84,2,-1,3,4,0,79,80,11
907,0,102,1,74,73,0,8,1,29,28,0,6,1,29,28,0.0,0.0025188059498281084,1,49,48,4,-1,5,4,0,83,82,73
908,0,0,1,1,0,0,0,1,1,0,0,0,1,1,0,0.0,0.0,1,1,0,-1,-1,-1,7,0,62,40,85
909,0,101,1,83,82,0,2,1,24,23,0,1,1,24,23,0.0,0.0,1,1,0,6,-1,7,2,0,99,40,68
910,224,224,95,95,0,56,56,85,85,0,56,56,85,85,0,0.04098165356206814,0.04098165356206814,95,95,0,-1,2,2,2,27,90,10,59
911,161,777,94,100,6,32,32,67,67,0,32,32,68,68,0,0.028728002995336805,0.03403791824092039,90,95,5,2,3,3,2,29,97,1,74
912,0,616,1,100,99,0,42,1,40,39,0,42,1,56,55,0.0,0.009598692943939549,1,69,68,2,-1,3,6,0,32,85,19
913,6,6,32,32,0,10,10,32,32,0,6,6,32,32,0,0.00037441710065012424,0.00037441710065012424,33,33,0,-1,4,4,3,1,58,88,99
914,16,632,35,100,65,50,90,33,45,12,16,90,35,62,27,0.0007147962830593281,0.010517716736444398,35,69,34,2,3,3,10,1,36,88,14
915,126,742,79,100,21,110,110,78,78,0,110,110,82,82,0,0.014261887742945642,0.02552843868069029,77,87,10,2,2,2,6,8,51,20,12
916,22,123,50,85,35,38,38,55,55,0,22,23,50,51,1,0.004731270635487933,0.004731270635487933,56,56,0,6,3,3,3,3,76,29,58
917,0,0,1,1,0,0,0,1,1,0,0,0,1,1,0,0.0,0.0,1,1,0,-1,-1,-1,12,0,3,96,97
918,195,297,93,97,4,96,96,93,93,0,96,96,93,93,0,0.02644746247319514,0.02668572790088158,89,89,0,4,2,2,3,16,58,12,56
919,294,500,98,100,2,136,136,98,98,0,136,136,98,98,0,0.04128799482623643,0.04659791007182001,95,96,1,3,2,2,4,27,77,10,38
920,0,0,1,1,0,0,0,1,1,0,0,0,1,1,0,0.0,0.0,1,1,0,-1,-1,-1,3,0,66,80,76
921,100,100,67,67,0,100,100,55,55,0,100,100,67,67,0,0.03788420300214439,0.04983151230470744,96,97,1,2,1,1,9,15,23,16,5
922,74,74,73,73,0,38,38,61,61,0,38,38,63,63,0,0.011777119711358454,0.011777119711358454,74,74,0,-1,3,3,3,8,81,8,85
923,0,0,1,1,0,0,0,1,1,0,0,0,1,1,0,0.0,0.0,1,1,0,-1,-1,-1,8,0,30,86,69
924,80,696,59,100,41,140,140,69,69,0,80,140,59,83,24,0.006569318220497634,0.014602266925354846,59,75,16,2,3,3,10,6,22,26,17
925,49,649,50,100,50,108,108,63,63,0,49,108,50,76,26,0.005003573981415297,0.019197385887879097,53,79,26,2,3,3,8,4,27,22,16
926,86,702,69,100,31,64,64,68,68,0,64,64,69,69,0,0.009326389598012186,0.032165832737669764,68,92,24,2,3,3,4,7,73,21,1
927,0,1640,1,100,99,0,176,1,69,68,0,176,1,88,87,0.0,0.03182545355526056,1,91,90,1,-1,2,12,0,6,97,0
928,100,100,66,66,0,100,100,66,66,0,100,100,69,69,0,0.021818305592429966,0.021818305592429966,83,83,0,-1,1,1,7,2,62,74,85
929,0,206,1,87,86,0,34,1,30,29,0,6,1,28,27,0.0,0.0005105687736138058,1,34,33,3,-1,4,14,0,16,85,42
930,0,616,1,100,99,0,80,1,40,39,0,80,1,56,55,0.0,0.010313489226998877,1,68,67,2,-1,3,10,0,18,85,19
931,24,230,45,93,48,62,66,42,42,0,24,66,45,58,13,0.0013955546478777359,0.008611593314952858,41,64,23,3,3,3,9,4,26,64,32
932,32,648,51,100,49,48,48,59,59,0,32,48,52,62,10,0.004799346471969774,0.010483678818203479,54,73,19,2,3,3,3,3,75,29,47
933,56,262,56,95,39,54,54,56,56,0,54,54,57,57,0,0.010381565063480718,0.012525953912658701,67,71,4,3,3,3,4,5,67,25,70
934,76,692,61,100,39,60,60,52,52,0,60,60,56,56,0,0.007556417849484326,0.016474352428605468,62,81,19,2,3,3,5,6,61,34,14
935,1,1,26,26,0,4,4,26,26,0,1,1,26,26,0,0.00010211375472276115,0.00010211375472276115,29,29,0,-1,6,6,4,1,73,78,89
936,56,262,59,95,36,88,88,80,80,0,56,63,65,66,1,0.005377991082065421,0.007250076585316042,57,61,4,3,2,2,4,2,77,52,75
937,257,873,95,100,5,54,54,56,56,0,54,54,57,57,0,0.028693965077095884,0.03141699853636951,90,91,1,2,3,3,4,29,67,1,71
938,16,222,39,93,54,52,56,48,48,0,16,56,39,57,18,0.0020763130126961434,0.009258313761530345,44,68,24,3,3,3,6,1,69,53,27
939,339,440,98,100,2,144,144,88,88,0,144,144,89,89,0,0.03516116954287076,0.03516116954287076,93,93,0,6,2,2,6,29,34,11,58
940,197,297,88,95,7,208,208,85,85,0,208,208,91,91,0,0.017052997038701112,0.01756356581231492,79,79,0,4,2,2,10,15,18,19,42
941,54,260,70,100,30,22,22,55,55,0,22,22,57,57,0,0.010007147962830594,0.01324075019571803,70,75,5,3,3,3,2,7,97,48,90
942,247,453,91,99,8,166,166,84,84,0,166,166,85,85,0,0.02386058068688519,0.024200959869294394,84,85,1,3,2,2,8,20,27,23,68
943,16,632,36,100,64,50,50,45,45,0,16,50,36,51,15,0.002825147213996392,0.008101024541339052,48,61,13,2,3,3,5,3,52,46,26
944,16,16,40,40,0,19,19,43,43,0,16,16,40,40,0,0.0016338200755641784,0.0016338200755641784,40,40,0,-1,3,3,3,1,94,78,66
945,6,1646,27,100,73,15,53,28,41,13,6,46,27,51,24,0.00037441710065012424,0.018210286258892407,29,81,52,1,4,2,6,1,51,88,55
946,125,125,88,88,0,48,48,65,65,0,48,48,68,68,0,0.014364001497668403,0.014364001497668403,80,80,0,-1,3,3,3,15,66,19,50
947,22,638,42,100,58,34,44,39,48,9,22,44,42,53,11,0.0012934408931549745,0.020831205963443275,40,89,49,2,3,3,4,3,53,51,1
948,1,1,23,23,0,4,4,23,23,0,1,1,23,23,0,3.4037918240920386e-05,3.4037918240920386e-05,24,24,0,-1,6,6,4,2,67,58,87
949,308,409,99,100,1,80,80,96,96,0,80,80,96,96,0,0.052248204499812795,0.052248204499812795,97,97,0,5,2,2,2,40,86,3,60
950,10,626,39,100,61,24,34,40,46,6,10,34,39,54,15,0.002110350930937064,0.018754892950747133,47,82,35,2,4,3,4,3,78,54,16
951,138,138,82,82,0,158,158,74,74,0,138,138,82,82,0,0.009054086252084823,0.009054086252084823,66,66,0,-1,2,2,9,9,28,31,86
952,0,206,1,92,91,0,18,1,32,31,0,18,1,44,43,0.0,0.005412029000306341,1,53,52,3,-1,4,5,0,88,92,24
953,2,618,28,100,72,7,30,28,43,15,2,30,28,51,23,0.00017018959120460194,0.008679669151434699,31,65,34,2,5,3,4,1,84,55,31
954,174,790,91,100,9,144,144,91,91,0,144,144,91,91,0,0.02314578440382586,0.030634126416828347,87,90,3,2,2,2,6,16,32,18,27
955,222,1862,92,100,8,192,216,89,92,3,192,216,92,93,1,0.022430988120766535,0.03553558664352088,85,92,7,1,2,2,9,16,31,18,75
956,71,687,56,100,44,110,140,61,65,4,71,140,56,80,24,0.005854521937438306,0.022226760611321013,58,85,27,2,2,2,11,6,19,35,12
957,217,1857,95,100,5,168,192,96,98,2,168,192,96,98,2,0.029442799278396135,0.04874229892099799,90,96,6,1,2,2,6,20,32,23,75
958,90,296,65,95,30,126,126,68,68,0,88,94,64,66,2,0.006092787365124749,0.0063650907110521125,59,59,0,3,2,2,8,6,30,41,4
959,0,206,1,95,94,0,8,1,31,30,0,8,1,37,36,0.0,0.003369753905851118,1,50,49,3,-1,4,2,0,95,97,13
960,0,0,1,1,0,0,0,1,1,0,0,0,1,1,0,0.0,0.0,1,1,0,-1,-1,-1,5,0,45,79,40
961,16,632,34,100,66,102,102,55,55,0,16,38,34,45,11,0.0013274788113958951,0.0045270431260424114,39,51,12,2,3,3,16,1,9,71,29
962,49,665,54,100,46,98,108,54,68,14,49,108,54,76,22,0.004561081044283332,0.018822968787228972,54,79,25,2,3,3,8,4,10,22,15
963,146,746,83,100,17,176,176,87,87,0,146,176,83,90,7,0.013853432724054596,0.021546002246502605,77,85,8,2,2,2,8,9,15,27,39
964,38,38,44,44,0,136,136,61,61,0,38,38,44,44,0,0.0011913271384322134,0.0011913271384322134,39,39,0,-1,3,3,15,4,7,64,93
965,0,206,1,91,90,0,34,1,32,31,0,6,1,29,28,0.0,0.0027911092957554717,1,47,46,3,-1,4,11,1,38,45,90
966,8,214,37,92,55,14,18,35,37,2,8,18,37,46,9,0.00037441710065012424,0.011709043874876613,35,74,39,3,4,4,3,2,76,63,6
967,1,207,25,94,69,3,14,25,32,7,1,14,25,40,15,0.00010211375472276115,0.0051397256543789785,29,56,27,3,6,4,3,1,66,68,57
968,300,300,95,95,0,192,192,87,87,0,192,192,88,88,0,0.02811532046700024,0.02811532046700024,87,87,0,-1,2,2,9,22,54,9,79
969,110,316,83,98,15,72,72,80,80,0,72,72,80,80,0,0.012117498893767658,0.01330882603219987,75,76,1,3,2,2,3,13,76,24,61
970,6,212,28,91,63,13,30,28,34,6,6,30,28,47,19,0.0,0.008203138296061813,1,64,63,3,4,4,5,1,50,95,14
971,130,336,83,94,11,142,142,79,79,0,142,142,85,85,0,0.009836958371625992,0.014840532353041287,69,78,9,3,2,2,8,13,57,24,34
972,0,206,1,94,93,0,18,1,35,34,0,18,1,44,43,0.0,0.003267640151128357,1,50,49,3,-1,4,3,0,66,97,22
973,70,686,59,100,41,128,128,73,73,0,70,128,59,80,21,0.005956635692161067,0.010824058000612683,57,69,12,2,3,3,8,5,21,47,22
974,208,1848,90,100,10,200,224,94,96,2,200,224,94,96,2,0.023520201504475986,0.06045134279587461,84,100,16,1,2,2,8,16,57,18,3
975,0,206,1,88,87,0,26,1,28,27,0,6,1,27,26,0.0,0.0002382654276864427,1,31,30,3,-1,4,17,0,20,67,88
976,100,100,64,64,0,100,100,59,59,0,100,100,64,64,0,0.04190067735457299,0.04190067735457299,96,96,0,4,1,1,6,13,40,33,95
977,0,616,1,100,99,0,84,1,46,45,0,84,1,59,58,0.0,0.016202049082678104,1,78,77,2,-1,3,9,0,35,93,6
978,104,310,85,98,13,32,32,58,58,0,32,32,59,59,0,0.010347527145239796,0.018176248340651485,71,85,14,3,3,3,2,14,68,32,20
979,6,622,30,100,70,28,64,34,45,11,6,58,30,56,26,0.0002723033459273631,0.009122162088566664,33,65,32,2,4,3,8,1,21,88,77
980,255,871,95,100,5,288,288,95,95,0,288,288,95,95,0,0.017393376221110316,0.018788930868988054,80,81,1,2,2,2,12,15,6,19,52
981,0,206,1,94,93,0,8,1,30,29,0,8,1,35,34,0.0,0.0020422750944552232,1,45,44,3,-1,4,2,0,91,86,75
982,100,100,79,79,0,100,100,98,98,0,100,100,98,98,0,0.07638108853262535,0.07638108853262535,99,99,0,-1,1,1,2,2,95,58,92
983,0,0,1,1,0,0,0,1,1,0,0,0,1,1,0,0.0,0.0,1,1,0,-1,-1,-1,4,0,73,98,82
984,0,616,1,100,99,0,106,1,56,55,0,66,1,55,54,0.0,0.004969536063174376,1,52,51,2,-1,3,15,0,7,96,28
985,54,156,65,92,27,22,22,52,52,0,22,22,55,55,0,0.010449640899962559,0.013070560604513427,70,79,9,4,3,3,2,8,98,8,28
986,168,168,89,89,0,94,94,75,75,0,94,94,75,75,0,0.01960584090677014,0.01960584090677014,82,82,0,-1,2,2,5,18,49,5,76
987,2,1642,26,100,74,15,130,26,60,34,2,92,26,58,32,3.4037918240920386e-05,0.011198475101262807,27,69,42,1,5,2,14,1,8,78,13
988,0,616,1,100,99,0,22,1,41,40,0,22,1,45,44,0.0,0.0230436706491031,1,89,88,2,-1,3,2,1,68,50,0
989,0,0,1,1,0,0,0,1,1,0,0,0,1,1,0,0.0,0.0,1,1,0,-1,-1,-1,8,0,42,91,40
990,16,16,41,41,0,24,24,37,37,0,16,16,41,41,0,0.0034037918240920387,0.0034037918240920387,51,51,0,-1,4,4,4,6,83,73,93
991,0,101,1,81,80,0,4,1,25,24,0,1,1,25,24,0.0,0.00013615167296368154,1,30,29,5,-1,6,4,0,72,59,60
992,58,160,68,92,24,32,32,63,63,0,32,32,65,65,0,0.010279451308757957,0.010994247591817285,69,70,1,4,3,3,2,6,98,77,64
993,236,336,95,96,1,184,184,96,96,0,184,184,96,96,0,0.02644746247319514,0.02644746247319514,90,90,0,5,2,2,7,20,46,23,65
994,40,1680,51,100,49,134,188,67,84,17,40,188,51,90,39,0.004629156880765172,0.02889819258654141,54,88,34,1,2,2,10,2,36,94,30
995,48,664,51,100,49,134,144,62,64,2,48,80,52,55,3,0.002110350930937064,0.006943735321147759,44,61,17,2,3,3,14,3,8,43,35
996,0,206,1,88,87,0,18,1,30,29,0,10,1,33,32,0.0,0.0007488342013002485,1,37,36,3,-1,4,7,0,24,91,43
997,81,183,76,94,18,56,56,82,82,0,56,56,82,82,0,0.013002484768031588,0.014432077334150244,75,76,1,4,2,2,2,8,89,44,83
998,105,105,78,78,0,70,70,67,67,0,70,70,71,71,0,0.01664454201981007,0.01664454201981007,77,77,0,-1,3,3,5,12,70,37,45
999,138,138,82,82,0,158,158,74,74,0,138,138,82,82,0,0.009054086252084823,0.009054086252084823,66,66,0,-1,2,2,9,9,28,31,82
