,FreeNet_pre_score,FreeNet_post_score,FreeNet_pre_rank,FreeNet_post_rank,FreeNet_delta_ranks,Reversed_pre_score,Reversed_post_score,Reversed_pre_rank,Reversed_post_rank,Reversed_delta_ranks,Independent_pre_score,Independent_post_score,Independent_pre_rank,Independent_post_rank,Independent_delta_ranks,Random_pre_score,Random_post_score,Random_pre_rank,Random_post_rank,Random_delta_ranks,dist_victim_relayer,dist_victim_vilain_pre,dist_victim_vilain_post,out_deg_victim,in_deg_villain,victim,villain,relayer
0,100,100,63,63,0,100,100,56,56,0,100,100,63,63,0,0.03281255318424725,0.04230913237346404,91,96,5,2,1,1,7,8,24,8,33
1,16,222,42,94,52,24,24,43,43,0,16,22,42,46,4,0.0009190237925048504,0.003778208924742163,38,50,12,3,3,3,3,1,58,49,90
2,0,206,1,90,89,0,15,1,30,29,0,6,1,29,28,0.0,0.0007488342013002485,1,38,37,3,-1,4,6,0,74,98,71
3,16,118,35,75,40,48,48,37,37,0,16,18,35,40,5,0.0007488342013002485,0.0009190237925048504,37,38,1,4,3,3,7,2,24,42,60
4,62,62,54,54,0,160,160,68,68,0,62,62,54,54,0,0.004663194799006093,0.004663194799006093,53,53,0,-1,2,2,11,6,5,70,66
5,19,19,49,49,0,18,18,38,38,0,18,18,47,47,0,0.00439089145307873,0.00439089145307873,56,56,0,-1,4,4,3,4,81,22,92
6,14,14,34,34,0,56,56,35,35,0,14,14,34,34,0,0.0013615167296368155,0.0013615167296368155,41,41,0,-1,4,4,10,3,36,43,98
7,8,110,31,81,50,20,20,30,30,0,8,12,31,31,0,0.00037441710065012424,0.0011232513019503727,31,35,4,4,4,4,4,2,67,56,74
8,24,224,45,93,48,80,80,45,45,0,24,32,45,46,1,0.0023486163586235067,0.0051397256543789785,45,54,9,3,3,3,9,3,26,54,41
9,1,617,25,100,75,4,30,25,43,18,1,30,25,51,26,3.4037918240920386e-05,0.009462541270975866,27,66,39,2,6,3,4,1,84,78,33
10,16,16,41,41,0,32,32,58,58,0,16,16,41,41,0,0.004152626025392287,0.004152626025392287,52,52,0,-1,3,3,2,1,91,90,40
11,132,732,80,100,20,86,86,56,56,0,86,86,66,66,0,0.013887470642295518,0.022226760611321013,76,86,10,2,3,3,6,13,59,33,17
12,132,338,86,98,12,44,44,50,50,0,44,44,57,57,0,0.01606589740971442,0.021614078082984444,77,85,8,3,3,3,4,16,73,12,77
13,148,764,79,100,21,252,252,82,82,0,148,164,79,81,2,0.010313489226998877,0.012900371013308825,65,70,5,2,2,2,15,6,7,34,46
14,178,1778,89,100,11,190,190,77,77,0,190,190,91,91,0,0.012832295176826986,0.023894618605126112,74,89,15,1,2,2,11,14,19,32,62
15,0,206,1,88,87,0,23,1,32,31,0,14,1,36,35,0.0,0.002723033459273631,1,46,45,3,-1,4,6,0,41,67,73
16,32,32,43,43,0,166,166,61,61,0,32,32,43,43,0,0.002723033459273631,0.002723033459273631,46,46,0,-1,3,3,16,2,4,52,93
17,46,252,54,95,41,90,94,49,51,2,46,52,54,54,0,0.005071649817897137,0.006875659484665918,53,57,4,3,2,2,9,2,35,75,53
18,14,220,41,94,53,18,18,36,36,0,14,18,41,44,3,0.0011232513019503727,0.009258313761530345,38,70,32,3,4,4,3,4,66,64,14
19,192,808,88,100,12,144,144,94,94,0,144,144,94,94,0,0.02188638142891181,0.04169644984512747,82,97,15,2,2,2,6,18,71,5,10
20,70,70,62,62,0,80,80,66,66,0,70,70,64,64,0,0.005241839409101739,0.005241839409101739,58,58,0,-1,3,3,5,6,63,28,92
21,16,632,37,100,63,62,76,49,58,9,16,76,37,65,28,0.0017018959120460194,0.015283025290173252,41,76,35,2,3,3,6,1,34,71,37
22,0,616,1,100,99,0,64,1,40,39,0,40,1,47,46,0.0,0.0063650907110521125,1,58,57,2,-1,3,8,0,42,92,62
23,7,109,36,78,42,26,26,36,36,0,7,9,36,36,0,0.0004084550188910446,0.0007147962830593281,34,38,4,4,4,4,5,2,37,56,42
24,48,1688,51,100,49,114,146,61,69,8,48,107,51,74,23,0.0024507301133462676,0.016406276592123625,44,74,30,1,3,2,12,3,2,54,25
25,0,616,1,100,99,0,56,1,35,34,0,16,1,35,34,0.0,0.0032336022328874367,1,48,47,2,-1,3,11,0,38,98,46
26,12,628,41,100,59,24,34,38,43,5,12,34,41,54,13,0.0005786446100956465,0.02307770856734402,36,86,50,2,4,3,4,2,72,63,11
27,0,616,1,100,99,0,50,1,37,36,0,31,1,44,43,0.0,0.005888559855679227,1,56,55,2,-1,3,8,0,10,59,25
28,132,132,82,82,0,264,264,93,93,0,132,132,82,82,0,0.011981347220803976,0.011981347220803976,72,72,0,-1,2,2,12,5,6,25,96
29,0,206,1,90,89,0,24,1,28,27,0,10,1,34,33,0.0,0.0010211375472276116,1,39,38,3,-1,4,10,0,1,59,43
30,128,128,79,79,0,86,86,55,55,0,86,86,60,60,0,0.012696143503863304,0.012696143503863304,75,75,0,-1,3,3,6,8,40,8,84
31,100,100,79,79,0,100,100,96,96,0,100,100,96,96,0,0.07539398890363866,0.07539398890363866,100,100,0,-1,1,1,3,20,85,23,98
32,219,219,98,98,0,32,32,64,64,0,32,32,64,64,0,0.029715102624323496,0.029715102624323496,92,92,0,-1,3,3,2,29,89,1,99
33,122,738,80,100,20,118,128,70,71,1,122,128,80,82,2,0.011879233466081215,0.020524864699274992,72,83,11,2,2,2,9,8,35,8,20
34,149,355,84,95,11,190,190,80,80,0,149,155,84,84,0,0.016338200755641786,0.018142210422410564,75,80,5,3,2,2,11,12,33,37,94
35,54,260,62,94,32,48,48,63,63,0,48,48,64,64,0,0.006875659484665918,0.011879233466081215,62,75,13,3,3,3,3,7,82,62,72
36,0,0,1,1,0,0,0,1,1,0,0,0,1,1,0,0.0,0.0,1,1,0,-1,-1,-1,12,0,2,40,85
37,0,206,1,89,88,0,28,1,33,32,0,9,1,37,36,0.0,0.0013955546478777359,1,40,39,3,-1,4,8,0,57,67,64
38,0,0,1,1,0,0,0,1,1,0,0,0,1,1,0,0.0,0.0,1,1,0,-1,-1,-1,4,0,77,85,91
39,0,616,1,100,99,0,34,1,43,42,0,34,1,51,50,0.0,0.00704584907587052,1,61,60,2,-1,3,4,0,47,92,21
40,46,662,49,100,51,112,112,62,62,0,46,112,49,77,28,0.0025188059498281084,0.007113924912352361,46,61,15,2,2,2,8,2,42,61,57
41,67,683,58,100,42,88,98,49,52,3,67,98,58,68,10,0.005377991082065421,0.012117498893767658,57,74,17,2,3,3,8,6,30,35,72
42,16,632,32,100,68,24,70,29,39,10,16,84,32,57,25,0.0009190237925048504,0.010449640899962559,35,68,33,2,3,3,9,1,29,78,27
43,22,22,48,48,0,44,44,48,48,0,22,22,48,48,0,0.0009530617107457708,0.0009530617107457708,40,40,0,-1,3,3,4,2,83,56,81
44,0,1640,1,100,99,0,116,1,54,53,0,81,1,59,58,0.0,0.012151536812008578,1,71,70,1,-1,2,14,0,17,96,44
45,183,389,90,100,10,144,144,95,95,0,144,144,95,95,0,0.017801831240001363,0.021239660982334322,79,85,6,3,2,2,6,15,56,19,47
46,10,216,41,97,56,12,12,37,37,0,12,12,41,41,0,0.0011913271384322134,0.009122162088566664,40,69,29,3,4,4,2,3,89,43,14
47,0,616,1,100,99,0,70,1,40,39,0,54,1,51,50,0.0,0.007454304094761564,1,62,61,2,-1,3,9,0,54,87,20
48,233,433,99,100,1,56,56,82,82,0,56,56,82,82,0,0.037373634228530586,0.04438544538616018,96,98,2,3,2,2,2,29,89,11,14
49,0,0,1,1,0,0,0,1,1,0,0,0,1,1,0,0.0,0.0,1,1,0,-1,-1,-1,9,0,54,67,93
50,0,206,1,91,90,0,36,1,35,34,0,36,1,46,45,0.0,0.012866333095067906,1,74,73,3,-1,4,6,0,56,98,12
51,0,206,1,96,95,0,12,1,36,35,0,12,1,41,40,0.0,0.011947309302563056,1,72,71,3,-1,4,2,0,99,96,12
52,182,388,92,99,7,102,102,94,94,0,102,102,94,94,0,0.026243234963749616,0.03158718812757412,88,91,3,3,2,2,4,20,73,23,34
53,144,350,85,98,13,198,198,86,86,0,144,156,86,88,2,0.007760645358929848,0.010177337554035196,64,70,6,3,2,2,10,6,1,13,83
54,6,212,32,93,61,8,12,32,35,3,6,12,32,36,4,0.00030634126416828345,0.0016338200755641784,33,44,11,3,4,4,2,1,68,4,61
55,100,100,69,69,0,100,100,55,55,0,100,100,69,69,0,0.03179141563701964,0.05395010041185881,91,98,7,2,1,1,8,8,30,17,0
56,96,712,75,100,25,38,48,51,69,18,38,48,54,71,17,0.009258313761530345,0.025392287007726607,67,90,23,2,3,3,3,13,94,24,12
57,150,356,83,100,17,134,134,90,90,0,134,134,90,90,0,0.018040096667687803,0.021784267674189048,80,85,5,3,2,2,6,12,56,37,28
58,68,684,64,100,36,28,38,43,46,3,28,38,50,52,2,0.01147077844719017,0.023588277340957826,76,90,14,2,3,3,3,8,75,8,12
59,0,102,1,75,74,0,16,1,28,27,0,2,1,25,24,0.0,0.0004084550188910446,1,33,32,4,-1,5,8,0,15,36,49
60,16,632,36,100,64,40,40,40,40,0,16,40,36,49,13,0.0011913271384322134,0.015146873617209572,39,81,42,2,3,3,5,1,52,71,18
61,386,386,98,98,0,184,184,97,97,0,184,184,98,98,0,0.036760951700194014,0.036760951700194014,93,93,0,-1,2,2,7,30,62,7,87
62,2,618,27,100,73,4,28,27,45,18,2,28,27,50,23,0.0,0.011130399264780965,1,69,68,2,5,3,3,1,85,95,39
63,0,1640,1,100,99,0,54,1,61,60,0,54,1,66,65,0.0,0.03267640151128357,1,92,91,1,-1,2,4,0,72,36,34
64,0,0,1,1,0,0,0,1,1,0,0,0,1,1,0,0.0,0.0,1,1,0,-1,-1,-1,5,0,45,97,89
65,0,616,1,100,99,0,46,1,40,39,0,46,1,54,53,0.0,0.015657442390823378,1,77,76,2,-1,3,6,0,34,89,16
66,82,698,66,100,34,86,86,57,57,0,86,86,66,66,0,0.012287688484972258,0.017869907076483203,72,79,7,2,3,3,6,8,65,20,62
67,0,206,1,94,93,0,16,1,34,33,0,16,1,37,36,0.0,0.007420266176520644,1,64,63,3,-1,4,4,1,53,50,8
68,0,101,1,79,78,0,3,1,25,24,0,1,1,25,24,0.0,3.4037918240920386e-05,1,26,25,6,-1,7,3,0,58,79,68
69,100,100,78,78,0,100,100,96,96,0,100,100,96,96,0,0.05565199632390483,0.05572007216038667,98,98,0,4,1,1,3,8,81,57,65
70,84,84,58,58,0,126,126,77,77,0,84,84,59,59,0,0.010994247591817285,0.010994247591817285,73,73,0,-1,2,2,7,5,46,25,92
71,120,120,79,79,0,174,174,76,76,0,120,120,79,79,0,0.007284114503556962,0.007284114503556962,62,62,0,-1,2,2,10,6,22,13,69
72,27,233,53,94,41,14,14,34,34,0,14,14,40,40,0,0.003608019333537561,0.007828721195411689,51,60,9,3,4,4,3,6,55,35,62
73,0,101,1,81,80,0,4,1,25,24,0,1,1,25,24,0.0,6.807583648184077e-05,1,28,27,5,-1,6,4,0,72,91,65
74,16,222,35,89,54,54,62,35,36,1,16,30,35,45,10,0.0007147962830593281,0.002212464685659825,36,45,9,3,3,3,10,1,22,88,54
75,0,101,1,80,79,0,4,1,25,24,0,1,1,25,24,0.0,6.807583648184077e-05,1,26,25,6,-1,7,4,0,73,80,68
76,6,108,32,85,53,8,8,32,32,0,6,8,32,35,3,0.00030634126416828345,0.0006467204465774873,33,37,4,4,4,4,2,1,68,4,63
77,0,0,1,1,0,0,0,1,1,0,0,0,1,1,0,0.0,0.0,1,1,0,-1,-1,-1,5,0,88,67,96
78,150,150,84,84,0,208,208,88,88,0,150,150,84,84,0,0.014329963579427483,0.014329963579427483,76,76,0,-1,2,2,10,8,11,17,84
79,32,134,47,78,31,80,80,45,45,0,32,34,47,48,1,0.0019741992579733825,0.002110350930937064,45,46,1,4,3,3,9,3,28,51,4
80,0,0,1,1,0,0,0,1,1,0,0,0,1,1,0,0.0,0.0,1,1,0,-1,-1,-1,3,0,81,80,93
81,72,688,54,100,46,148,148,65,65,0,72,88,55,56,1,0.002484768031587188,0.004152626025392287,46,53,7,2,2,2,14,3,25,43,53
82,40,656,51,100,49,80,80,58,58,0,40,80,51,61,10,0.0035739814152966403,0.011062323428299126,50,71,21,2,2,2,6,1,41,53,24
83,0,206,1,91,90,0,26,1,34,33,0,12,1,35,34,0.0,0.0028591851322373124,1,48,47,3,-1,4,7,0,62,76,29
84,224,430,93,98,5,204,204,85,85,0,204,204,93,93,0,0.020967357636406957,0.023009632730862182,82,85,3,3,2,2,11,17,19,6,46
85,72,1712,54,100,46,186,220,68,72,4,72,127,54,78,24,0.002825147213996392,0.013036522686272508,49,71,22,1,2,2,17,3,20,54,35
86,72,278,61,93,32,138,138,75,75,0,72,80,61,65,4,0.00439089145307873,0.005820484019197386,54,59,5,3,2,2,9,6,31,70,61
87,108,108,79,79,0,60,60,55,55,0,60,60,60,60,0,0.012832295176826986,0.012832295176826986,73,73,0,-1,3,3,5,8,70,8,85
88,161,777,94,100,6,32,32,67,67,0,32,32,68,68,0,0.028728002995336805,0.04162837400864563,90,95,5,2,3,3,2,29,97,1,32
89,0,206,1,89,88,0,13,1,29,28,0,6,1,29,28,0.0,0.000442492937131965,1,33,32,3,-1,4,6,0,71,66,49
90,130,130,82,82,0,128,128,93,93,0,128,128,93,93,0,0.01674665577453283,0.01674665577453283,80,80,0,-1,2,2,5,8,37,20,82
91,100,100,57,57,0,100,100,38,38,0,100,100,57,57,0,0.053609721229449604,0.0544266312672317,99,99,0,2,1,1,16,40,4,3,53
92,0,206,1,91,90,0,30,1,34,33,0,30,1,47,46,0.0,0.006467204465774873,1,56,55,3,-1,4,5,0,52,82,31
93,98,304,72,95,23,80,80,68,68,0,80,80,72,72,0,0.012968446849790666,0.018176248340651485,74,80,6,3,3,3,5,8,88,8,34
94,100,100,63,63,0,100,100,45,45,0,100,100,63,63,0,0.04748289594608394,0.04748289594608394,96,96,0,-1,1,1,11,29,19,11,40
95,146,146,83,83,0,176,176,87,87,0,146,146,83,83,0,0.013853432724054596,0.013853432724054596,77,77,0,-1,2,2,8,9,15,27,97
96,54,260,57,94,37,76,76,57,57,0,54,62,57,58,1,0.007692569522448007,0.008679669151434699,64,65,1,3,3,3,6,4,74,38,83
97,100,100,67,67,0,100,100,74,74,0,100,100,75,75,0,0.06341264168283468,0.06341264168283468,99,99,0,-1,1,1,5,27,63,10,40
98,40,40,57,57,0,28,28,44,44,0,28,28,54,54,0,0.0051397256543789785,0.0051397256543789785,59,59,0,-1,3,3,3,6,76,26,89
99,40,40,47,47,0,108,108,58,58,0,40,40,47,47,0,0.0022465026039007454,0.0022465026039007454,43,43,0,-1,2,2,12,1,2,71,81
100,0,206,1,91,90,0,20,1,33,32,0,8,1,37,36,0.0,0.002995336805200994,1,49,48,3,-1,4,4,0,84,40,29
101,100,100,77,77,0,100,100,96,96,0,100,100,96,96,0,0.08291636883488206,0.08291636883488206,100,100,0,-1,1,1,3,29,82,0,99
102,0,206,1,95,94,0,14,1,31,30,0,6,1,30,29,0.0,0.002723033459273631,1,48,47,3,-1,4,3,0,94,89,90
103,100,100,66,66,0,100,100,49,49,0,100,100,66,66,0,0.03618230709009837,0.03669287586371218,94,95,1,4,1,1,9,16,54,18,74
104,16,118,32,76,44,46,46,31,31,0,16,16,32,32,0,0.0002723033459273631,0.0002723033459273631,31,31,0,4,3,3,14,1,8,65,68
105,22,22,43,43,0,56,56,45,45,0,22,22,43,43,0,0.0021784267674189047,0.0021784267674189047,44,44,0,-1,3,3,6,2,48,52,86
106,100,100,68,68,0,100,100,57,57,0,100,100,68,68,0,0.06807583648184078,0.0697777323938868,100,100,0,3,1,1,8,36,39,2,70
107,125,125,81,81,0,80,80,66,66,0,80,80,68,68,0,0.014432077334150244,0.014432077334150244,78,78,0,-1,3,3,5,15,63,19,84
108,278,478,95,98,3,344,344,93,93,0,278,278,95,95,0,0.02552843868069029,0.026039007454304094,87,87,0,3,2,2,17,15,20,16,42
109,2,618,28,100,72,6,28,31,42,11,2,28,28,49,21,6.807583648184077e-05,0.01334286395044079,30,78,48,2,5,3,3,1,96,95,12
110,100,100,63,63,0,100,100,39,39,0,100,100,63,63,0,0.0283876238129276,0.0283876238129276,90,90,0,-1,1,1,14,12,17,37,98
111,40,656,49,100,51,102,112,56,57,1,40,92,49,60,11,0.003880322679464924,0.011402702610708328,54,69,15,2,3,3,12,6,14,73,20
112,6,622,30,100,70,12,40,30,40,10,6,40,30,53,23,0.00037441710065012424,0.009905034208107831,34,70,36,2,4,3,5,1,80,55,20
113,0,206,1,92,91,0,12,1,32,31,0,6,1,32,31,0.0,0.0012934408931549745,1,41,40,3,-1,4,4,0,78,91,53
114,100,306,67,96,29,104,104,80,80,0,104,104,81,81,0,0.011266550937744648,0.012730181422104225,70,73,3,3,2,2,5,6,63,77,61
115,111,317,77,97,20,180,180,76,76,0,111,125,77,79,2,0.008645631233193778,0.01143674052894925,63,70,7,3,2,2,11,8,19,44,73
116,100,100,60,60,0,100,100,40,40,0,100,100,60,60,0,0.032948704857210936,0.03550154872527996,92,93,1,2,1,1,14,17,25,6,29
117,225,841,94,100,6,152,152,94,94,0,152,152,94,94,0,0.021137547227611558,0.02559651451717213,86,89,3,2,2,2,5,15,52,19,26
118,100,100,72,72,0,100,100,79,79,0,100,100,80,80,0,0.049218829776370876,0.049218829776370876,97,97,0,-1,1,1,5,17,37,6,86
119,0,616,1,100,99,0,80,1,41,40,0,80,1,57,56,0.0,0.01657646618332823,1,81,80,2,-1,3,10,0,36,76,15
120,0,102,1,77,76,0,8,1,30,29,0,2,1,26,25,0.0,0.0017018959120460194,1,42,41,4,-1,5,4,0,79,76,46
121,16,16,44,44,0,38,38,49,49,0,16,16,43,43,0,0.0030974505599237552,0.0030974505599237552,51,51,0,-1,3,3,3,3,87,46,40
122,100,100,70,70,0,100,100,68,68,0,100,100,73,73,0,0.03264236359304265,0.04734674427312026,90,95,5,2,1,1,6,7,48,62,5
123,100,100,70,70,0,100,100,53,53,0,100,100,70,70,0,0.032506211920078965,0.032506211920078965,88,88,0,-1,1,1,9,14,31,14,67
124,278,878,99,100,1,56,56,84,84,0,56,56,85,85,0,0.04554273460635148,0.05320126621055856,97,97,0,2,2,2,2,40,98,3,57
125,0,206,1,96,95,0,14,1,32,31,0,14,1,40,39,0.0,0.002586881786309949,1,47,46,3,-1,4,3,0,75,66,41
126,560,766,100,100,0,272,272,99,99,0,272,272,99,99,0,0.04802750263793867,0.048878450593961675,96,96,0,3,2,2,8,40,15,3,42
127,121,121,79,79,0,154,154,71,71,0,121,121,79,79,0,0.009496579189216788,0.009496579189216788,69,69,0,-1,2,2,10,8,1,44,96
128,24,640,47,100,53,36,46,42,44,2,24,40,47,51,4,0.001497668402600497,0.006126825283365669,42,56,14,2,3,3,5,4,45,64,90
129,68,684,66,100,34,48,48,60,60,0,48,48,63,63,0,0.011709043874876613,0.026004969536063176,69,89,20,2,3,3,3,8,58,20,30
130,0,101,1,77,76,0,5,1,25,24,0,1,1,25,24,0.0,0.0,1,1,0,5,-1,6,5,0,37,99,68
131,100,100,60,60,0,100,100,40,40,0,100,100,60,60,0,0.01933353756084278,0.02049082678103407,79,79,0,2,1,1,14,7,25,48,56
132,176,176,91,91,0,136,136,97,97,0,136,136,97,97,0,0.02668572790088158,0.02668572790088158,88,88,0,-1,2,2,4,9,72,39,79
133,19,1659,49,100,51,18,52,38,80,42,18,52,47,81,34,0.00439089145307873,0.05674120970761428,56,97,41,1,4,2,3,4,81,22,10
134,1,103,25,83,58,2,3,25,26,1,1,3,25,30,5,0.0,0.0007828721195411688,1,36,35,4,6,5,2,1,99,68,78
135,86,86,72,72,0,50,50,45,45,0,50,50,56,56,0,0.008986010415602982,0.008986010415602982,69,69,0,-1,3,3,5,13,45,24,96
136,8,624,34,100,66,36,68,33,41,8,8,68,34,62,28,0.0005786446100956465,0.016338200755641786,37,81,44,2,4,3,8,2,39,63,16
137,44,250,66,100,34,12,12,39,39,0,12,12,44,44,0,0.008203138296061813,0.010926171755335444,66,72,6,3,4,4,2,8,97,8,22
138,110,110,77,77,0,104,104,81,81,0,104,104,84,84,0,0.010211375472276116,0.010211375472276116,70,70,0,-1,2,2,5,7,61,21,76
139,289,389,97,99,2,112,112,96,96,0,112,112,96,96,0,0.03553558664352088,0.039109568058817525,93,93,0,4,2,2,4,29,77,0,31
140,0,616,1,100,99,0,70,1,41,40,0,58,1,55,54,0.0,0.009020048333843901,1,68,67,2,-1,3,9,0,31,80,17
141,280,880,96,100,4,120,120,87,87,0,120,120,88,88,0,0.031314884781646755,0.03332312195786106,92,93,1,2,2,2,6,29,56,0,75
142,220,426,93,100,7,168,168,98,98,0,168,168,98,98,0,0.02474556656114912,0.029306647605432452,87,90,3,3,2,2,6,18,65,30,21
143,0,206,1,93,92,0,20,1,34,33,0,20,1,47,46,0.0,0.006943735321147759,1,60,59,3,-1,4,4,0,73,97,17
144,0,616,1,100,99,0,88,1,46,45,0,88,1,60,59,0.0,0.018142210422410564,1,79,78,2,-1,3,8,0,10,86,9
145,0,206,1,86,85,0,40,1,33,32,0,40,1,46,45,0.0,0.010721944245889922,1,67,66,3,-1,4,8,0,27,40,12
146,0,206,1,94,93,0,18,1,35,34,0,18,1,44,43,0.0,0.004969536063174376,1,55,54,3,-1,4,3,0,66,99,62
147,0,102,1,74,73,0,16,1,26,25,0,2,1,25,24,0.0,0.00013615167296368154,1,29,28,4,-1,5,14,0,16,91,55
148,88,88,61,61,0,104,104,73,73,0,88,88,68,68,0,0.008543517478471017,0.008543517478471017,63,63,0,-1,2,2,5,4,52,72,50
149,195,811,93,100,7,96,96,93,93,0,96,96,93,93,0,0.02644746247319514,0.03097450559923755,89,91,2,2,2,2,3,16,58,12,52
150,16,222,41,94,53,34,34,56,56,0,16,34,42,58,16,0.003948398515946765,0.010926171755335444,52,72,20,3,3,3,3,1,55,90,17
151,0,616,1,100,99,0,46,1,42,41,0,46,1,51,50,0.0,0.017869907076483203,1,82,81,2,-1,3,6,1,65,50,9
152,277,378,98,100,2,112,112,94,94,0,112,112,94,94,0,0.03638653459954389,0.036454610436025735,94,94,0,6,2,2,4,29,78,0,68
153,0,0,1,1,0,0,0,1,1,0,0,0,1,1,0,0.0,0.0,1,1,0,-1,-1,-1,11,0,33,76,87
154,0,616,1,100,99,0,50,1,45,44,0,50,1,52,51,0.0,0.0228734810578985,1,86,85,2,-1,3,5,0,50,93,1
155,25,25,46,46,0,56,56,48,48,0,25,25,46,46,0,0.00442492937131965,0.00442492937131965,51,51,0,-1,3,3,6,6,65,73,50
156,135,751,84,100,16,200,200,74,74,0,135,171,84,88,4,0.008747744987916539,0.012900371013308825,67,72,5,2,2,2,12,8,6,57,28
157,0,0,1,1,0,0,0,1,1,0,0,0,1,1,0,0.0,0.0,1,1,0,-1,-1,-1,9,0,28,96,85
158,0,0,1,1,0,0,0,1,1,0,0,0,1,1,0,0.0,0.0,1,1,0,-1,-1,-1,3,0,66,96,82
159,0,1640,1,100,99,0,48,1,59,58,0,48,1,62,61,0.0,0.036624800027230335,1,95,94,1,-1,2,3,1,58,69,22
160,84,186,76,93,17,56,56,84,84,0,56,56,85,85,0,0.01494264610776405,0.015214949453691413,80,80,0,4,2,2,2,7,98,48,49
161,0,206,1,92,91,0,30,1,33,32,0,12,1,35,34,0.0,0.0016338200755641784,1,42,41,3,-1,4,9,0,35,66,83
162,298,400,96,98,2,176,176,85,85,0,176,176,89,89,0,0.029919330133769018,0.03002144388849178,89,89,0,4,2,2,8,22,30,9,65
163,22,1662,41,100,59,88,112,47,69,22,22,112,41,77,36,0.0012594029749140542,0.02314578440382586,40,86,46,1,3,2,8,2,10,61,33
164,422,422,100,100,0,160,160,93,93,0,160,160,94,94,0,0.048844412675720754,0.048844412675720754,98,98,0,-1,2,2,7,36,62,2,84
165,112,728,76,100,24,144,144,89,89,0,112,144,83,89,6,0.009836958371625992,0.016440314510364547,68,79,11,2,2,2,6,4,40,72,17
166,2,104,26,75,49,9,14,26,27,1,2,5,26,27,1,6.807583648184077e-05,0.0005105687736138058,27,32,5,4,5,5,8,1,27,78,63
167,202,303,93,96,3,120,120,80,80,0,120,120,81,81,0,0.021443888491779844,0.021443888491779844,86,86,0,6,2,2,6,19,34,15,58
168,56,158,63,89,26,48,48,66,66,0,48,48,67,67,0,0.005173763572619898,0.005820484019197386,60,61,1,4,3,3,3,6,76,28,51
169,492,692,99,100,1,392,392,100,100,0,392,392,100,100,0,0.03529732121583444,0.0353994349705572,92,92,0,3,2,2,14,29,8,0,60
170,146,1786,83,100,17,188,212,82,89,7,146,212,83,91,8,0.013513053541645392,0.03458252493277511,74,94,20,1,2,2,10,9,11,27,6
171,84,290,63,95,32,152,152,83,83,0,84,152,63,85,22,0.010619830491167161,0.01933353756084278,68,82,14,3,2,2,8,5,21,25,32
172,234,234,91,91,0,120,120,77,77,0,120,120,84,84,0,0.019571802988529223,0.019571802988529223,83,83,0,-1,2,2,6,16,40,12,91
173,126,126,84,84,0,90,90,69,69,0,90,90,73,73,0,0.013376901868681712,0.013376901868681712,77,77,0,-1,2,2,6,14,32,14,89
174,0,0,1,1,0,0,0,1,1,0,0,0,1,1,0,0.0,0.0,1,1,0,-1,-1,-1,7,0,24,66,80
175,144,760,88,100,12,48,48,62,62,0,48,48,64,64,0,0.017257224548146634,0.020831205963443275,83,85,2,2,3,3,3,18,64,30,52
176,259,859,94,100,6,152,152,99,99,0,152,152,99,99,0,0.031076619353960312,0.039415909322985804,90,94,4,2,2,2,5,19,37,15,20
177,0,0,1,1,0,0,0,1,1,0,0,0,1,1,0,0.0,0.0,1,1,0,-1,-1,-1,3,0,58,40,91
178,118,734,81,100,19,88,88,80,80,0,88,88,80,80,0,0.01763164164879676,0.026821879573845263,81,87,6,2,2,2,4,9,84,39,33
179,482,2122,100,100,0,240,264,98,100,2,240,264,98,100,2,0.046529834235338165,0.05926001565744239,97,99,2,1,2,2,9,40,23,3,94
180,1,617,26,100,74,4,44,26,47,21,1,44,26,53,27,3.4037918240920386e-05,0.010858095918853602,27,71,44,2,6,3,4,1,83,78,17
181,16,632,34,100,66,68,78,41,44,3,16,58,34,52,18,0.002314578440382586,0.009598692943939549,45,66,21,2,3,3,8,2,42,94,77
182,16,222,45,93,48,28,28,46,46,0,16,28,44,50,6,0.001940161339732462,0.00707988699411144,43,61,18,3,3,3,3,1,85,53,21
183,68,68,66,66,0,48,48,60,60,0,48,48,63,63,0,0.011709043874876613,0.011709043874876613,69,69,0,-1,3,3,3,8,58,20,89
184,28,644,46,100,54,90,130,44,62,18,28,130,46,80,34,0.0015657442390823377,0.022294836447802852,42,84,42,2,3,3,10,4,18,64,10
185,0,206,1,92,91,0,24,1,32,31,0,14,1,36,35,0.0,0.0019741992579733825,1,44,43,3,-1,4,8,0,21,97,54
186,0,206,1,89,88,0,26,1,29,28,0,8,1,33,32,0.0,0.0011232513019503727,1,38,37,3,-1,4,12,0,3,84,74
187,226,226,92,92,0,150,150,86,86,0,150,150,86,86,0,0.02386058068688519,0.02386058068688519,86,86,0,-1,2,2,7,18,43,30,80
188,0,0,1,1,0,0,0,1,1,0,0,0,1,1,0,0.0,0.0,1,1,0,-1,-1,-1,4,0,53,86,92
189,0,206,1,91,90,0,19,1,28,27,0,6,1,27,26,0.0,0.0004765308553728854,1,32,31,3,-1,4,9,0,31,96,49
190,96,712,69,100,31,100,100,73,73,0,96,100,72,73,1,0.012049423057285817,0.017291262466387555,70,79,9,2,2,2,6,6,71,34,26
191,100,100,64,64,0,100,100,44,44,0,100,100,64,64,0,0.028047244630518397,0.02808128254875932,90,90,0,5,1,1,13,8,13,8,68
192,0,101,1,81,80,0,3,1,24,23,0,1,1,24,23,0.0,3.4037918240920386e-05,1,28,27,5,-1,6,3,0,96,81,95
193,6,622,28,99,71,39,98,30,34,4,6,45,28,47,19,3.4037918240920386e-05,0.0045270431260424114,26,52,26,2,4,3,17,1,20,60,22
194,6,622,29,100,71,19,68,29,40,11,6,58,29,52,23,0.00017018959120460194,0.007284114503556962,31,61,30,2,4,3,8,1,42,65,21
195,0,616,1,100,99,0,56,1,46,45,0,56,1,59,58,0.0,0.023111746485584943,1,88,87,2,-1,3,6,0,32,80,1
196,100,100,67,67,0,100,100,54,54,0,100,100,67,67,0,0.056843323462337045,0.056843323462337045,99,99,0,-1,1,1,9,29,35,11,87
197,0,206,1,89,88,0,38,1,35,34,0,16,1,35,34,0.0,0.004935498144933456,1,52,51,3,-1,4,7,0,43,93,72
198,166,166,84,84,0,124,124,88,88,0,124,124,89,89,0,0.017393376221110316,0.017393376221110316,79,79,0,-1,2,2,6,8,41,8,97
199,0,206,1,93,92,0,12,1,33,32,0,12,1,40,39,0.0,0.005071649817897137,1,57,56,3,-1,4,4,0,72,82,24
200,6,107,32,84,52,8,8,32,32,0,6,7,32,36,4,0.0004765308553728854,0.0004765308553728854,36,36,0,6,4,4,2,1,98,55,58
201,24,640,49,100,51,58,78,43,48,5,24,78,49,61,12,0.0011232513019503727,0.017529527894074,39,79,40,2,3,3,8,4,21,64,12
202,0,101,1,82,81,0,3,1,25,24,0,1,1,25,24,0.0,3.4037918240920386e-05,1,26,25,6,-1,7,3,1,75,69,58
203,0,0,1,1,0,0,0,1,1,0,0,0,1,1,0,0.0,0.0,1,1,0,-1,-1,-1,7,0,24,76,66
204,490,690,100,100,0,208,208,99,99,0,208,208,99,99,0,0.05340549372000408,0.059532319003369756,99,99,0,3,2,2,7,36,43,2,20
205,1,103,26,72,46,7,13,26,30,4,1,4,26,31,5,0.00010211375472276115,0.0008169100377820892,30,38,8,4,6,5,7,1,46,78,51
206,0,102,1,81,80,0,6,1,28,27,0,4,1,28,27,0.0,0.0012594029749140542,1,38,37,4,-1,5,3,0,82,87,52
207,198,198,95,95,0,22,22,48,48,0,22,22,51,51,0,0.025868817863099493,0.025868817863099493,88,88,0,-1,3,3,2,22,95,9,69
208,101,307,77,98,21,94,94,75,75,0,94,94,75,75,0,0.010313489226998877,0.013819394805813677,68,75,7,3,2,2,5,8,49,44,13
209,44,146,51,84,33,74,74,42,42,0,44,46,51,52,1,0.0036760951700194017,0.003880322679464924,51,51,0,4,3,3,9,6,31,73,4
210,100,100,70,70,0,100,100,73,73,0,100,100,74,74,0,0.024371149460498995,0.032948704857210936,86,94,8,2,1,1,6,1,71,60,17
211,12,12,40,40,0,26,26,36,36,0,12,12,40,40,0,0.0009190237925048504,0.0009190237925048504,38,38,0,-1,4,4,5,3,49,51,40
212,22,638,40,99,59,106,124,55,58,3,22,74,40,54,14,0.0007147962830593281,0.0068075836481840775,35,57,22,2,3,3,17,2,20,56,48
213,100,100,70,70,0,100,100,68,68,0,100,100,73,73,0,0.04877633683923891,0.0494230572858164,96,96,0,3,1,1,6,16,48,18,63
214,40,40,57,57,0,38,38,55,55,0,38,38,58,58,0,0.004969536063174376,0.004969536063174376,58,58,0,-1,3,3,3,6,76,41,91
215,0,206,1,93,92,0,26,1,35,34,0,26,1,51,50,0.0,0.007488342013002485,1,62,61,3,-1,4,5,1,49,45,32
216,14,220,41,94,53,18,18,36,36,0,14,18,41,44,3,0.0011232513019503727,0.003710133088260322,38,51,13,3,4,4,3,4,66,64,41
217,0,1640,1,100,99,0,92,1,50,49,0,80,1,57,56,0.0,0.01923142380612002,1,78,77,1,-1,2,8,0,27,97,21
218,2,103,26,74,48,17,17,27,27,0,2,3,26,28,2,6.807583648184077e-05,0.00010211375472276115,27,27,0,5,5,5,15,2,7,58,78
219,0,1640,1,100,99,0,100,1,65,64,0,100,1,74,73,0.0,0.039313795568263046,1,97,96,1,-1,2,6,0,51,76,7
220,76,692,56,100,44,142,182,62,69,7,76,182,56,88,32,0.005888559855679227,0.029306647605432452,56,90,34,2,2,2,13,6,13,35,10
221,0,1640,1,100,99,0,112,1,72,71,0,112,1,79,78,0.0,0.03271043942952449,1,92,91,1,-1,2,8,0,39,89,1
222,60,260,55,93,38,76,76,54,54,0,60,62,55,55,0,0.008441403723748256,0.009496579189216788,65,70,5,3,3,3,6,5,41,25,83
223,0,0,1,1,0,0,0,1,1,0,0,0,1,1,0,0.0,0.0,1,1,0,-1,-1,-1,12,0,6,98,97
224,222,428,88,99,11,332,332,92,92,0,222,236,88,89,1,0.017903944994724124,0.019129310051397258,83,83,0,3,2,2,16,12,9,37,43
225,44,146,62,89,27,32,32,69,69,0,32,32,69,69,0,0.007590455767725246,0.008271214132543654,67,67,0,4,3,3,2,4,90,72,71
226,102,308,81,98,17,62,62,80,80,0,62,62,80,80,0,0.018006058749446885,0.029510875114877974,81,90,9,3,2,2,3,8,55,57,18
227,22,228,47,93,46,22,22,42,42,0,22,22,46,46,0,0.004016474352428605,0.009326389598012186,54,66,12,3,3,3,2,3,68,29,25
228,244,1844,94,100,6,222,222,90,90,0,222,222,95,95,0,0.021137547227611558,0.046563872153579086,85,96,11,1,2,2,10,18,36,5,0
229,0,616,1,100,99,0,80,1,37,36,0,32,1,47,46,0.0,0.006841621566424997,1,62,61,2,-1,3,13,0,13,36,25
230,0,206,1,89,88,0,20,1,29,28,0,12,1,33,32,0.0,0.0021784267674189047,1,39,38,3,-1,4,6,0,71,82,75
231,256,462,94,100,6,192,192,100,100,0,192,192,100,100,0,0.030804316008032948,0.03526328329759352,90,93,3,3,2,2,6,16,74,18,44
232,100,100,72,72,0,100,100,87,87,0,100,100,87,87,0,0.08938357330065694,0.0896558766465843,100,100,0,4,1,1,4,36,53,2,56
233,0,206,1,88,87,0,48,1,34,33,0,23,1,44,43,0.0,0.003642057251778481,1,53,52,3,-1,4,10,0,11,82,35
234,100,100,73,73,0,100,100,94,94,0,100,100,94,94,0,0.0851628714387828,0.08546921270295109,100,100,0,3,1,1,4,40,67,3,52
235,294,396,96,99,3,144,144,91,91,0,144,144,91,91,0,0.03451444909629327,0.034684638687497875,92,92,0,4,2,2,6,29,74,0,49
236,66,167,57,84,27,112,112,66,66,0,64,65,57,57,0,0.00616086320160659,0.0061949011198475104,58,58,0,6,2,2,8,6,21,41,58
237,175,276,93,97,4,96,96,92,92,0,96,96,92,92,0,0.02831954797644576,0.028421661731168522,89,89,0,6,2,2,3,16,81,12,78
238,154,1794,86,100,14,94,128,68,89,21,94,128,73,89,16,0.014329963579427483,0.04506620375097859,78,97,19,1,2,2,5,14,61,32,30
239,267,883,94,100,6,200,200,94,94,0,200,200,94,94,0,0.0298852922155281,0.036794989618434935,87,92,5,2,2,2,8,15,57,16,77
240,0,206,1,96,95,0,12,1,38,37,0,12,1,44,43,0.0,0.004799346471969774,1,55,54,3,-1,4,2,0,93,85,26
241,136,136,79,79,0,152,152,76,76,0,152,152,85,85,0,0.01684876952925559,0.01684876952925559,80,80,0,-1,2,2,8,12,15,37,96
242,2,104,25,71,46,8,12,26,26,0,2,4,25,26,1,0.0,0.00010211375472276115,1,28,27,4,5,5,6,1,40,68,49
243,94,195,64,90,26,154,154,71,71,0,94,95,64,64,0,0.006603356138738555,0.006671431975220395,59,61,2,5,2,2,10,5,1,47,78
244,188,804,87,100,13,166,166,83,83,0,166,166,88,88,0,0.011164437183021887,0.016542428265087308,73,81,8,2,2,2,8,13,42,24,28
245,0,1640,1,100,99,0,62,1,48,47,0,60,1,59,58,0.0,0.020865243881684196,1,86,85,1,-1,2,6,0,34,81,26
246,62,62,66,66,0,38,38,51,51,0,38,38,54,54,0,0.008169100377820893,0.008169100377820893,63,63,0,-1,3,3,3,8,94,44,93
247,144,760,84,100,16,182,182,88,88,0,144,182,87,91,4,0.013138636440995268,0.026039007454304094,73,89,16,2,2,2,9,6,29,77,30
248,0,206,1,94,93,0,8,1,30,29,0,8,1,35,34,0.0,0.0020763130126961434,1,45,44,3,-1,4,2,0,91,93,75
249,28,129,46,80,34,106,106,58,58,0,28,29,46,46,0,0.002382654276864427,0.002382654276864427,46,46,0,5,3,3,11,3,19,54,58
250,84,700,60,100,40,202,202,74,74,0,84,137,60,85,25,0.006126825283365669,0.01242384015793594,58,73,15,2,2,2,13,5,13,47,57
251,0,206,1,88,87,0,24,1,29,28,0,6,1,28,27,0.0,0.0008169100377820892,1,36,35,3,-1,4,11,0,33,97,42
252,0,102,1,78,77,0,10,1,32,31,0,2,1,28,27,0.0,0.00037441710065012424,1,32,31,4,-1,5,5,0,88,98,42
253,0,206,1,89,88,0,16,1,26,25,0,10,1,32,31,0.0,0.0005105687736138058,1,33,32,3,-1,4,6,0,40,99,64
254,223,423,99,100,1,56,56,93,93,0,56,56,93,93,0,0.03808843051158991,0.04384083869430545,97,97,0,3,2,2,2,30,99,7,14
255,0,206,1,89,88,0,13,1,26,25,0,6,1,26,25,0.0,0.0002723033459273631,1,30,29,3,-1,4,6,0,40,81,4
256,102,718,71,100,29,124,124,85,85,0,102,124,74,88,14,0.00970080669866231,0.029034344259505088,67,91,24,2,2,2,6,7,40,62,0
257,100,100,69,69,0,100,100,76,76,0,100,100,76,76,0,0.045134279587460434,0.045134279587460434,95,95,0,-1,1,1,5,13,80,33,40
258,16,632,38,100,62,44,58,39,43,4,16,58,38,56,18,0.0010892133837094523,0.015385139044896015,38,76,38,2,3,3,7,2,62,42,15
259,100,100,63,63,0,100,100,45,45,0,100,100,63,63,0,0.020456788862793153,0.02382654276864427,81,89,8,3,1,1,11,7,19,62,73
260,110,110,74,74,0,154,154,72,72,0,110,110,74,74,0,0.010517716736444398,0.010517716736444398,66,66,0,-1,2,2,10,7,11,21,91
261,372,578,100,100,0,96,96,87,87,0,96,96,87,87,0,0.05262262160046292,0.059328091493924234,97,97,0,3,2,2,3,36,87,2,27
262,0,206,1,93,92,0,34,1,32,31,0,18,1,40,39,0.0,0.0030634126416828346,1,47,46,3,-1,4,9,0,23,76,35
263,44,244,57,94,37,38,38,56,56,0,38,38,59,59,0,0.0057524081827155455,0.02392865652336703,58,88,30,3,3,3,3,4,58,38,7
264,0,206,1,91,90,0,20,1,34,33,0,24,1,49,48,0.0,0.0048674223084516155,1,55,54,3,-1,4,4,0,83,99,38
265,144,760,89,100,11,56,56,80,80,0,56,56,81,81,0,0.019367575479083698,0.03682902753667586,86,94,8,2,2,2,2,18,91,5,12
266,0,206,1,93,92,0,18,1,39,38,0,18,1,45,44,0.0,0.01320671227747711,1,77,76,3,-1,4,3,0,55,66,30
267,122,224,81,92,11,78,78,73,73,0,78,78,73,73,0,0.018176248340651485,0.018380475850097007,84,84,0,4,2,2,4,9,79,39,56
268,62,678,56,100,44,132,152,64,66,2,62,152,56,86,30,0.0042547397801150485,0.009836958371625992,55,67,12,2,3,3,12,6,14,35,57
269,0,0,1,1,0,0,0,1,1,0,0,0,1,1,0,0.0,0.0,1,1,0,-1,-1,-1,9,0,35,86,67
270,0,616,1,100,99,0,58,1,36,35,0,16,1,33,32,0.0,0.0035059055788147996,1,51,50,2,-1,3,12,0,2,66,90
271,176,176,86,86,0,176,176,90,90,0,176,176,91,91,0,0.016338200755641786,0.016338200755641786,77,77,0,-1,2,2,8,13,21,33,76
272,16,117,41,77,36,24,24,37,37,0,16,24,41,49,8,0.0034037918240920387,0.003437829742332959,51,51,0,5,4,4,4,6,83,73,58
273,2,208,28,92,64,6,10,30,31,1,2,10,28,39,11,0.0,0.001157289220191293,1,39,38,3,5,4,3,1,76,95,43
274,0,616,1,100,99,0,24,1,42,41,0,24,1,48,47,0.0,0.006875659484665918,1,61,60,2,-1,3,3,0,58,79,26
275,87,187,65,87,22,66,66,47,47,0,66,66,55,55,0,0.006433166547533953,0.006433166547533953,55,55,0,6,3,3,6,8,71,57,78
276,332,332,95,95,0,168,168,96,96,0,168,168,96,96,0,0.03240409816535621,0.03240409816535621,91,91,0,-1,2,2,6,22,40,9,92
277,0,206,1,96,95,0,14,1,32,31,0,9,1,36,35,0.0,0.0019741992579733825,1,44,43,3,-1,4,3,0,75,76,70
278,212,314,93,99,6,88,88,84,84,0,88,88,84,84,0,0.025085945743558324,0.025119983661799246,88,88,0,4,2,2,4,19,67,15,88
279,622,828,100,100,0,344,344,100,100,0,344,344,100,100,0,0.048878450593961675,0.050444194833044013,96,99,3,3,2,2,11,40,33,3,94
280,0,0,1,1,0,0,0,1,1,0,0,0,1,1,0,0.0,0.0,1,1,0,-1,-1,-1,5,0,37,82,92
281,1,1,26,26,0,2,2,26,26,0,1,1,26,26,0,3.4037918240920386e-05,3.4037918240920386e-05,26,26,0,-1,6,6,2,2,68,58,92
282,156,257,84,94,10,140,140,88,88,0,140,140,89,89,0,0.019844106334456584,0.019912182170938427,81,81,0,5,2,2,7,9,62,39,95
283,100,100,61,61,0,100,100,44,44,0,100,100,61,61,0,0.06443377923006229,0.06443377923006229,100,100,0,-1,1,1,12,36,6,2,97
284,370,472,97,100,3,176,176,98,98,0,176,176,98,98,0,0.03859899928520372,0.039824364341876854,92,93,1,4,2,2,5,27,61,10,43
285,91,297,68,95,27,80,80,65,65,0,80,80,68,68,0,0.009054086252084823,0.014227849824704722,67,77,10,3,2,2,6,8,69,44,24
286,397,597,97,100,3,184,184,94,94,0,184,184,94,94,0,0.035603662480002726,0.03788420300214439,92,94,2,3,2,2,7,30,43,7,29
287,1,617,26,100,74,5,40,26,44,18,1,40,26,51,25,0.00010211375472276115,0.01245787807617686,28,74,46,2,6,3,5,2,37,58,30
288,0,1640,1,100,99,0,112,1,68,67,0,112,1,78,77,0.0,0.03352734946730658,1,93,92,1,-1,2,8,0,57,67,1
289,220,1860,93,100,7,168,192,98,98,0,168,192,98,98,0,0.02474556656114912,0.06283399707273903,87,98,11,1,2,2,6,18,65,30,3
290,0,616,1,100,99,0,76,1,40,39,0,76,1,59,58,0.0,0.013955546478777357,1,77,76,2,-1,3,10,0,11,91,18
291,0,206,1,90,89,0,70,1,35,34,0,20,1,42,41,0.0,0.006433166547533953,1,59,58,3,-1,4,13,0,13,89,62
292,0,0,1,1,0,0,0,1,1,0,0,0,1,1,0,0.0,0.0,1,1,0,-1,-1,-1,3,1,60,69,66
293,0,616,1,100,99,0,44,1,49,48,0,44,1,56,55,0.0,0.02236291228428469,1,85,84,2,-1,3,4,0,84,96,11
294,22,638,41,100,59,78,92,37,41,4,22,74,41,56,15,0.0009190237925048504,0.008577555396711936,37,62,25,2,3,3,12,2,14,74,20
295,0,101,1,78,77,0,4,1,25,24,0,1,1,25,24,0.0,3.4037918240920386e-05,1,25,24,6,-1,7,4,0,47,99,68
296,134,734,80,100,20,166,166,88,88,0,134,166,83,90,7,0.013751318969331836,0.01855066544130161,75,80,5,2,2,2,8,6,21,77,26
297,0,616,1,100,99,0,28,1,43,42,0,28,1,53,52,0.0,0.015419176963136935,1,77,76,2,-1,3,3,0,76,89,23
298,2,1642,28,100,72,5,68,28,76,48,2,68,28,78,50,0.0,0.037373634228530586,1,94,93,1,5,2,4,1,72,95,37
299,2,1642,26,100,74,7,80,26,54,28,2,80,26,65,39,6.807583648184077e-05,0.036454610436025735,27,94,67,1,5,2,6,1,59,78,0
300,184,184,84,84,0,166,166,84,84,0,166,166,85,85,0,0.011947309302563056,0.011947309302563056,69,69,0,-1,2,2,8,13,27,24,50
301,0,206,1,92,91,0,14,1,34,33,0,14,1,42,41,0.0,0.007318152421797883,1,62,61,3,-1,4,3,0,76,82,27
302,38,654,52,100,48,38,48,51,62,11,38,48,54,63,9,0.0028932230504782326,0.03083835392627387,50,91,41,2,3,3,3,6,82,70,3
303,22,22,41,41,0,76,76,39,39,0,22,22,41,41,0,0.0019061234214915416,0.0019061234214915416,42,42,0,-1,3,3,11,2,33,83,92
304,0,616,1,100,99,0,56,1,45,44,0,56,1,57,56,0.0,0.018278362095374246,1,79,78,2,-1,3,6,0,74,80,16
305,0,616,1,100,99,0,24,1,41,40,0,16,1,40,39,0.0,0.004935498144933456,1,52,51,2,-1,3,3,0,60,99,46
306,70,172,57,89,32,130,130,65,65,0,70,72,57,57,0,0.005718370264474625,0.005888559855679227,56,56,0,4,3,3,10,5,36,47,55
307,126,726,81,100,19,120,120,85,85,0,120,120,85,85,0,0.018312400013615168,0.02236291228428469,83,85,2,2,2,2,6,12,48,37,57
308,0,0,1,1,0,0,0,1,1,0,0,0,1,1,0,0.0,0.0,1,1,0,-1,-1,-1,3,0,55,76,93
309,184,390,91,100,9,100,100,77,77,0,100,100,77,77,0,0.023894618605126112,0.028693965077095884,84,88,4,3,2,2,6,16,69,12,21
310,24,125,45,81,36,40,40,40,40,0,24,25,45,45,0,0.001157289220191293,0.001157289220191293,39,39,0,5,3,3,5,4,50,64,68
311,100,100,72,72,0,100,100,71,71,0,100,100,75,75,0,0.05228224241805371,0.05357568331120869,98,98,0,3,1,1,6,29,32,11,61
312,0,0,1,1,0,0,0,1,1,0,0,0,1,1,0,0.0,0.0,1,1,0,-1,-1,-1,5,0,50,67,76
313,174,174,87,87,0,196,196,94,94,0,174,174,91,91,0,0.014908608189523128,0.014908608189523128,75,75,0,-1,2,2,9,8,23,17,80
314,0,206,1,87,86,0,35,1,29,28,0,6,1,27,26,0.0,0.0008169100377820892,1,36,35,3,-1,4,16,0,9,87,71
315,56,672,66,100,34,22,22,52,52,0,22,22,54,54,0,0.008509479560230097,0.020661016372238675,65,86,21,2,3,3,2,9,86,31,34
316,420,620,99,100,1,288,288,99,99,0,288,288,99,99,0,0.035025017869907075,0.036965179209639536,93,93,0,3,2,2,9,29,28,0,73
317,38,638,49,100,51,90,90,45,45,0,38,47,49,52,3,0.0024507301133462676,0.0053099152455835805,47,56,9,2,3,3,10,3,22,54,41
318,91,297,76,99,23,38,38,56,56,0,38,38,57,57,0,0.015248987371932332,0.018142210422410564,80,84,4,3,3,3,3,12,60,37,22
319,0,1640,1,100,99,0,53,1,43,42,0,48,1,49,48,0.0,0.018959120460192654,1,84,83,1,-1,2,6,0,56,67,43
320,32,238,50,94,44,72,72,49,49,0,32,38,50,50,0,0.004186663943633207,0.0048674223084516155,51,52,1,3,3,3,7,3,62,29,71
321,0,1640,1,100,99,0,58,1,62,61,0,58,1,62,61,0.0,0.03710133088260322,1,92,91,1,-1,2,4,0,79,66,18
322,0,206,1,97,96,0,12,1,38,37,0,12,1,43,42,0.0,0.020014295925661188,1,83,82,3,-1,4,2,0,97,81,11
323,0,0,1,1,0,0,0,1,1,0,0,0,1,1,0,0.0,0.0,1,1,0,-1,-1,-1,6,0,32,66,96
324,6,107,30,74,44,12,12,30,30,0,6,7,30,36,6,0.00017018959120460194,0.00037441710065012424,30,32,2,5,4,4,4,1,83,60,55
325,186,392,90,100,10,112,112,94,94,0,112,112,94,94,0,0.022737329384934817,0.024098846114571634,84,85,1,3,2,2,4,15,78,19,52
326,6,1646,31,100,69,16,110,33,80,47,6,110,31,84,53,0.0002382654276864427,0.042104904864018515,32,94,62,1,4,2,6,1,32,4,0
327,0,616,1,100,99,0,28,1,41,40,0,28,1,50,49,0.0,0.015997821573232582,1,79,78,2,-1,3,3,1,64,45,15
328,0,206,1,89,88,0,24,1,30,29,0,24,1,43,42,0.0,0.005412029000306341,1,53,52,3,-1,4,6,0,71,66,48
329,0,102,1,78,77,0,9,1,29,28,0,3,1,32,31,0.0,0.00088498587426393,1,38,37,4,-1,5,5,0,88,96,74
330,100,100,62,62,0,100,100,45,45,0,100,100,62,62,0,0.042683549474114166,0.04731270635487934,96,97,1,2,1,1,12,20,3,23,26
331,110,110,74,74,0,158,158,74,74,0,110,110,74,74,0,0.01157289220191293,0.01157289220191293,74,74,0,-1,2,2,9,6,28,77,91
332,0,206,1,91,90,0,12,1,31,30,0,8,1,37,36,0.0,0.0018040096667687805,1,43,42,3,-1,4,4,0,84,97,75
333,0,0,1,1,0,0,0,1,1,0,0,0,1,1,0,0.0,0.0,1,1,0,-1,-1,-1,8,0,10,76,50
334,111,317,78,96,18,152,152,80,80,0,111,118,78,79,1,0.00891793457912114,0.009939072126348753,67,69,2,3,2,2,8,8,30,44,51
335,0,616,1,100,99,0,106,1,56,55,0,92,1,57,56,0.0,0.013104598522754349,1,72,71,2,-1,3,15,0,7,86,6
336,6,107,34,87,53,7,7,34,34,0,6,7,34,40,6,0.00010211375472276115,0.0002723033459273631,29,33,4,5,4,4,2,1,97,4,60
337,228,428,100,100,0,56,56,92,92,0,56,56,92,92,0,0.054154327921304334,0.0676333435447088,98,98,0,3,2,2,2,36,97,2,1
338,34,240,49,93,44,106,106,58,58,0,34,66,49,55,6,0.0013274788113958951,0.007998910786616291,40,62,22,3,3,3,11,4,19,64,34
339,0,206,1,92,91,0,10,1,31,30,0,6,1,31,30,0.0,0.0013274788113958951,1,39,38,3,-1,4,3,0,76,36,53
340,0,0,1,1,0,0,0,1,1,0,0,0,1,1,0,0.0,0.0,1,1,0,-1,-1,-1,6,1,56,50,40
341,16,118,41,82,41,28,28,42,42,0,16,18,41,46,5,0.002212464685659825,0.0024166921951053475,47,48,1,4,3,3,3,2,64,94,88
342,0,616,1,100,99,0,62,1,42,41,0,62,1,57,56,0.0,0.021443888491779844,1,84,83,2,-1,3,7,0,24,80,11
343,0,102,1,82,81,0,5,1,28,27,0,2,1,26,25,0.0,0.00037441710065012424,1,33,32,4,-1,5,3,0,85,67,42
344,128,128,80,80,0,120,120,78,78,0,120,120,78,78,0,0.012559991830899623,0.012559991830899623,72,72,0,-1,2,2,6,9,41,27,59
345,0,206,1,92,91,0,18,1,37,36,0,18,1,46,45,0.0,0.007284114503556962,1,61,60,3,-1,4,3,0,85,99,20
346,0,616,1,100,99,0,56,1,43,42,0,56,1,57,56,0.0,0.013615167296368155,1,74,73,2,-1,3,6,0,34,92,37
347,100,100,69,69,0,100,100,69,69,0,100,100,71,71,0,0.07331767589094251,0.07331767589094251,99,99,0,-1,1,1,6,40,34,3,97
348,78,694,61,100,39,100,124,55,74,19,78,124,61,83,22,0.006637394056979475,0.03437829742332959,62,94,32,2,3,3,9,8,23,57,3
349,80,696,60,100,40,164,164,71,71,0,80,98,60,64,4,0.005582218591510943,0.007352190340038803,56,61,5,2,2,2,11,2,33,75,74
350,0,1640,1,100,99,0,118,1,59,58,0,92,1,61,60,0.0,0.0160318594914735,1,77,76,1,-1,2,12,0,3,96,17
351,146,762,90,100,10,80,80,94,94,0,80,80,94,94,0,0.02573266619013581,0.04319411824772797,89,98,9,2,2,2,2,13,91,33,16
352,6,212,31,92,61,66,66,37,37,0,6,12,31,35,4,0.001055175465468532,0.001599782157323258,39,40,1,3,4,4,11,1,19,71,42
353,405,611,98,100,2,190,190,91,91,0,190,190,91,91,0,0.036590762108989414,0.038905340549372,96,97,1,3,2,2,8,29,27,1,90
354,0,0,1,1,0,0,0,1,1,0,0,0,1,1,0,0.0,0.0,1,1,0,-1,-1,-1,14,0,17,99,59
355,86,292,63,94,31,92,92,62,62,0,86,92,66,67,1,0.00789679703189353,0.008101024541339052,63,63,0,3,3,3,7,7,62,21,4
356,0,206,1,91,90,0,30,1,34,33,0,22,1,44,43,0.0,0.00439089145307873,1,53,52,3,-1,4,7,0,62,84,26
357,0,616,1,100,99,0,38,1,60,59,0,38,1,62,61,0.0,0.018176248340651485,1,82,81,2,-1,3,3,0,81,97,12
358,78,78,57,57,0,104,104,73,73,0,78,78,58,58,0,0.009292351679771264,0.009292351679771264,65,65,0,-1,2,2,5,4,52,38,36
359,319,935,96,100,4,144,144,92,92,0,144,144,92,92,0,0.03264236359304265,0.037645937574457944,90,93,3,2,2,2,6,29,48,11,57
360,66,66,56,56,0,122,122,60,60,0,64,64,56,56,0,0.0040845501889104465,0.0040845501889104465,53,53,0,-1,2,2,12,6,3,41,81
361,0,0,1,1,0,0,0,1,1,0,0,0,1,1,0,0.0,0.0,1,1,0,-1,-1,-1,11,0,19,80,50
362,6,622,32,100,68,18,28,35,44,9,6,28,32,49,17,0.0016338200755641784,0.009598692943939549,43,65,22,2,4,3,3,1,58,53,48
363,6,212,27,90,63,24,32,30,33,3,6,18,27,37,10,0.0009190237925048504,0.002723033459273631,35,41,6,3,4,4,6,2,51,42,52
364,0,616,1,100,99,0,58,1,38,37,0,34,1,45,44,0.0,0.005480104836788182,1,57,56,2,-1,3,8,0,42,98,38
365,0,616,1,100,99,0,66,1,36,35,0,34,1,47,46,0.0,0.007216038667075122,1,61,60,2,-1,3,10,0,22,97,62
366,12,218,35,93,58,18,18,36,36,0,12,18,35,44,9,0.0019061234214915416,0.004731270635487933,43,56,13,3,4,4,3,2,82,52,73
367,16,222,41,91,50,30,34,42,42,0,16,34,41,51,10,0.0004765308553728854,0.01157289220191293,36,70,34,3,3,3,4,1,83,4,37
368,94,196,73,92,19,28,28,40,40,0,28,28,49,49,0,0.010041185881071514,0.010109261717553355,73,73,0,4,3,3,3,14,82,32,65
369,100,100,67,67,0,100,100,55,55,0,100,100,67,67,0,0.05122706695258518,0.05122706695258518,98,98,0,5,1,1,9,27,23,10,68
370,0,616,1,100,99,0,28,1,45,44,0,28,1,52,51,0.0,0.0228734810578985,1,85,84,2,-1,3,3,0,81,93,0
371,46,252,57,97,40,62,62,80,80,0,46,62,71,80,9,0.008373327887266415,0.013955546478777357,64,76,12,3,2,2,3,3,94,29,31
372,6,6,30,30,0,12,12,30,30,0,6,6,30,30,0,0.0004084550188910446,0.0004084550188910446,33,33,0,-1,4,4,4,1,83,88,85
373,142,142,80,80,0,270,270,79,79,0,142,142,80,80,0,0.011164437183021887,0.011164437183021887,62,62,0,-1,2,2,16,9,9,27,80
374,88,88,73,73,0,64,64,68,68,0,64,64,71,71,0,0.01245787807617686,0.01245787807617686,74,74,0,-1,3,3,4,13,72,33,99
375,0,206,1,93,92,0,10,1,30,29,0,8,1,34,33,0.0,0.0026889955410327104,1,46,45,3,-1,4,3,0,92,99,83
376,58,674,61,100,39,94,94,72,72,0,58,76,61,68,7,0.005514142755029102,0.00789679703189353,59,63,4,2,2,2,5,6,80,70,43
377,120,326,78,96,18,238,238,79,79,0,120,136,78,81,3,0.00970080669866231,0.012389802239695021,66,71,5,3,2,2,14,7,16,21,41
378,0,616,1,100,99,0,18,1,46,45,0,17,1,49,48,0.0,0.006943735321147759,1,64,63,2,-1,3,2,0,89,92,74
379,0,0,1,1,0,0,0,1,1,0,0,0,1,1,0,0.0,0.0,1,1,0,-1,-1,-1,17,0,20,86,93
380,172,372,87,98,11,110,110,83,83,0,110,110,83,83,0,0.022601177711971135,0.027026107083290785,84,88,4,3,2,2,6,18,71,30,44
381,70,276,60,96,36,86,86,56,56,0,70,86,59,65,6,0.005820484019197386,0.011300588855985567,56,71,15,3,3,3,6,6,59,26,21
382,6,6,30,30,0,15,15,30,30,0,6,6,30,30,0,0.00013615167296368154,0.00013615167296368154,29,29,0,-1,4,4,6,1,65,60,69
383,135,341,83,98,15,232,232,76,76,0,135,141,83,84,1,0.008373327887266415,0.010517716736444398,64,67,3,3,2,2,14,8,8,57,46
384,84,700,58,100,42,126,126,77,77,0,84,126,59,83,24,0.010994247591817285,0.03846284761224004,73,92,19,2,2,2,7,5,46,25,3
385,6,6,28,28,0,32,32,35,35,0,6,6,28,28,0,0.0005446066918547262,0.0005446066918547262,34,34,0,-1,4,4,6,1,56,49,91
386,0,102,1,73,72,0,10,1,28,27,0,6,1,28,27,0.0,0.0026889955410327104,1,49,48,4,-1,5,5,0,61,82,73
387,0,616,1,99,98,0,82,1,40,39,0,82,1,60,59,0.0,0.012594029749140543,1,72,71,2,-1,3,11,0,33,99,30
388,139,241,85,95,10,64,64,68,68,0,64,64,70,70,0,0.016712617856291908,0.01783586915824228,80,80,0,4,3,3,4,18,78,5,64
389,0,206,1,93,92,0,26,1,35,34,0,26,1,48,47,0.0,0.010415602981721638,1,73,72,3,-1,4,5,0,45,80,12
390,325,426,95,98,3,120,120,78,78,0,120,120,78,78,0,0.03264236359304265,0.03264236359304265,91,91,0,5,2,2,6,29,41,11,58
391,6,107,29,75,46,22,22,35,35,0,6,7,29,35,6,0.00034037918240920387,0.00037441710065012424,34,35,1,5,4,4,5,1,61,88,58
392,100,100,73,73,0,100,100,96,96,0,100,100,96,96,0,0.07644916436910719,0.07695973314272099,99,99,0,4,1,1,3,15,64,16,51
393,0,102,1,75,74,0,10,1,26,25,0,2,1,25,24,0.0,0.00010211375472276115,1,29,28,4,-1,5,8,0,15,79,60
394,278,484,95,98,3,344,344,93,93,0,278,344,95,98,3,0.02552843868069029,0.0265495762279179,87,87,0,3,2,2,17,15,20,16,43
395,0,206,1,92,91,0,16,1,32,31,0,16,1,44,43,0.0,0.003165526396405596,1,50,49,3,-1,4,4,1,78,50,26
396,73,673,64,100,36,84,84,74,74,0,73,84,73,74,1,0.008645631233193778,0.02307770856734402,67,87,20,2,2,2,5,4,45,22,16
397,76,282,71,98,27,38,38,52,52,0,38,38,55,55,0,0.00891793457912114,0.013581129378127233,69,79,10,3,3,3,3,13,66,24,62
398,2,103,27,83,56,4,4,29,29,0,2,2,27,27,0,0.00010211375472276115,0.00034037918240920387,29,31,2,5,5,5,2,1,99,65,60
399,0,206,1,93,92,0,14,1,33,32,0,10,1,38,37,0.0,0.002280540522141666,1,47,46,3,-1,4,5,1,49,45,41
400,64,166,57,86,29,66,66,50,50,0,64,66,59,60,1,0.006297014874570271,0.006671431975220395,57,57,0,4,3,3,6,4,56,72,42
401,64,64,64,64,0,60,60,55,55,0,60,60,60,60,0,0.008203138296061813,0.008203138296061813,67,67,0,-1,3,3,5,7,70,48,97
402,2,208,26,88,62,8,18,26,30,4,2,8,26,33,7,6.807583648184077e-05,0.0006126825283365669,27,36,9,3,5,4,7,1,24,78,42
403,22,228,40,92,52,94,94,49,49,0,22,41,40,50,10,0.0020082371762143027,0.004935498144933456,44,56,12,3,3,3,9,2,31,61,35
404,240,856,90,100,10,300,300,91,91,0,240,300,90,94,4,0.011845195547840293,0.02736648626569999,68,90,22,2,2,2,14,9,25,31,15
405,0,206,1,95,94,0,8,1,32,31,0,8,1,37,36,0.0,0.0030634126416828346,1,50,49,3,-1,4,2,1,89,45,26
406,316,1956,99,100,1,342,366,95,97,2,316,366,99,99,0,0.02413288403281255,0.058647333129105826,88,100,12,1,2,2,16,15,9,16,2
407,345,961,98,100,2,128,128,90,90,0,128,128,90,90,0,0.0370672929643623,0.04418121787671466,94,96,2,2,2,2,5,29,63,1,24
408,87,293,64,94,30,76,76,54,54,0,76,76,60,60,0,0.00789679703189353,0.011777119711358454,63,71,8,3,3,3,6,8,41,44,28
409,0,206,1,86,85,0,25,1,29,28,0,6,1,28,27,0.0,0.0009190237925048504,1,37,36,3,-1,4,11,0,5,98,71
410,22,228,40,92,52,76,76,37,37,0,22,30,40,45,5,0.00037441710065012424,0.0008509479560230097,32,36,4,3,3,3,12,2,3,56,63
411,6,622,29,100,71,14,28,32,39,7,6,28,29,48,19,0.000442492937131965,0.01684876952925559,34,81,47,2,4,3,3,1,82,49,23
412,0,206,1,89,88,0,13,1,28,27,0,6,1,28,27,0.0,0.0007147962830593281,1,37,36,3,-1,4,5,1,61,50,71
413,0,102,1,74,73,0,16,1,26,25,0,2,1,25,24,0.0,0.00013615167296368154,1,29,28,4,-1,5,14,0,16,67,55
414,0,206,1,89,88,0,48,1,34,33,0,12,1,32,31,0.0,0.0030974505599237552,1,48,47,3,-1,4,10,0,12,79,29
415,150,356,85,95,10,182,182,87,87,0,150,182,85,90,5,0.01501072194424589,0.019571802988529223,76,82,6,3,2,2,9,8,31,17,57
416,276,476,98,100,2,72,72,87,87,0,72,72,87,87,0,0.04084550188910446,0.04846999557507063,94,96,2,3,2,2,3,29,55,1,14
417,0,616,1,99,98,0,92,1,40,39,0,52,1,53,52,0.0,0.008441403723748256,1,65,64,2,-1,3,12,0,6,98,77
418,2,102,27,76,49,16,16,29,29,0,2,3,27,28,1,3.4037918240920386e-05,0.0002382654276864427,27,31,4,4,5,5,9,1,23,95,56
419,88,704,60,100,40,196,196,72,72,0,88,196,60,87,27,0.007590455767725246,0.028557813404132205,61,90,29,2,2,2,12,7,14,62,10
420,36,242,51,94,43,38,38,59,59,0,38,38,62,62,0,0.004799346471969774,0.011913271384322134,52,73,21,3,3,3,3,6,92,41,8
421,0,616,1,100,99,0,18,1,50,49,0,18,1,53,52,0.0,0.008441403723748256,1,65,64,2,-1,3,2,0,86,76,57
422,8,214,34,96,62,10,18,31,34,3,8,18,34,45,11,0.000442492937131965,0.009292351679771264,33,68,35,3,4,4,3,2,94,63,32
423,184,800,87,100,13,144,144,88,88,0,144,144,88,88,0,0.013410939786922631,0.02723033459273631,76,88,12,2,2,2,6,13,44,24,15
424,210,826,90,100,10,256,256,94,94,0,210,256,91,95,4,0.018176248340651485,0.03934783348650397,79,96,17,2,2,2,10,9,11,39,7
425,329,529,96,100,4,128,128,92,92,0,128,128,92,92,0,0.035910003744171005,0.03655672419074849,93,93,0,3,2,2,5,29,50,11,64
426,0,0,1,1,0,0,0,1,1,0,0,0,1,1,0,0.0,0.0,1,1,0,-1,-1,-1,3,0,81,76,40
427,97,303,80,98,18,32,32,63,63,0,32,32,64,64,0,0.01861874127778345,0.03720344463732598,83,96,13,3,3,3,2,12,86,37,10
428,230,331,94,99,5,120,120,100,100,0,120,120,100,100,0,0.03359542530378842,0.03362946322202934,91,91,0,5,2,2,3,16,85,12,60
429,163,264,87,95,8,112,112,92,92,0,112,112,92,92,0,0.019367575479083698,0.01940161339732462,84,84,0,5,2,2,4,15,53,19,78
430,158,358,94,100,6,46,46,83,83,0,46,46,83,83,0,0.02917049593246877,0.03563770039824364,94,96,2,3,2,2,2,22,99,9,14
431,16,222,34,89,55,40,76,33,38,5,16,76,34,57,23,0.0002042275094455223,0.012491915994417782,33,72,39,3,3,3,11,1,33,4,18
432,32,32,44,44,0,102,102,56,56,0,32,32,44,44,0,0.0025188059498281084,0.0025188059498281084,45,45,0,-1,3,3,12,2,2,52,36
433,0,102,1,74,73,0,16,1,26,25,0,2,1,25,24,0.0,0.00013615167296368154,1,29,28,4,-1,5,14,1,16,45,55
434,0,0,1,1,0,0,0,1,1,0,0,0,1,1,0,0.0,0.0,1,1,0,-1,-1,-1,9,0,23,82,66
435,0,101,1,72,71,0,8,1,25,24,0,1,1,25,24,0.0,0.0,1,1,0,5,-1,6,8,0,42,87,68
436,70,686,59,100,41,82,82,56,56,0,70,82,60,64,4,0.005956635692161067,0.014738418598318526,56,76,20,2,3,3,7,5,62,47,14
437,0,1640,1,100,99,0,192,1,73,72,0,192,1,88,87,0.0,0.030736240171551108,1,91,90,1,-1,2,13,0,13,76,11
438,74,176,60,87,27,100,100,66,66,0,68,70,58,59,1,0.006024711528642908,0.006262976956329351,55,55,0,4,2,2,6,6,51,41,88
439,295,911,96,100,4,112,112,93,93,0,112,112,93,93,0,0.03550154872527996,0.04152626025392287,92,93,1,2,2,2,4,29,79,11,62
440,100,100,70,70,0,100,100,53,53,0,100,100,70,70,0,0.03887130263113108,0.039313795568263046,93,93,0,3,1,1,9,18,31,30,49
441,0,0,1,1,0,0,0,1,1,0,0,0,1,1,0,0.0,0.0,1,1,0,-1,-1,-1,4,1,53,45,96
442,80,286,64,95,31,80,80,65,65,0,80,80,68,68,0,0.007182000748834201,0.010721944245889922,59,70,11,3,2,2,6,6,69,28,22
443,2,104,28,81,53,6,6,30,30,0,2,4,28,31,3,0.0,0.00030634126416828345,1,34,33,4,5,5,3,1,76,95,49
444,207,413,93,100,7,96,96,89,89,0,96,96,89,89,0,0.02569862827189489,0.029510875114877974,89,90,1,3,2,2,3,17,64,6,38
445,0,616,1,100,99,0,42,1,31,30,0,17,1,38,37,0.0,0.0004765308553728854,1,34,33,2,-1,3,16,0,9,91,56
446,0,1640,1,100,99,0,166,1,64,63,0,142,1,80,79,0.0,0.017155110793423873,1,79,78,1,-1,2,17,0,20,36,5
447,50,256,57,92,35,70,70,59,59,0,50,70,57,65,8,0.005446066918547262,0.006501242384015794,58,60,2,3,3,3,5,6,80,26,74
448,0,616,1,100,99,0,18,1,47,46,0,18,1,48,47,0.0,0.009462541270975866,1,68,67,2,-1,3,2,0,93,66,64
449,91,297,76,99,23,38,38,56,56,0,38,38,57,57,0,0.015248987371932332,0.027128220838013545,80,87,7,3,3,3,3,12,60,37,6
450,6,622,30,100,70,19,50,30,36,6,6,50,30,55,25,0.00017018959120460194,0.007454304094761564,30,61,31,2,4,3,8,1,21,60,31
451,0,616,1,100,99,0,38,1,50,49,0,38,1,53,52,0.0,0.02831954797644576,1,89,88,2,-1,3,3,0,82,79,3
452,22,638,42,100,58,34,44,39,48,9,22,44,42,53,11,0.0018380475850097008,0.01678069369277375,44,78,34,2,3,3,4,2,53,61,37
453,12,628,37,100,63,20,30,32,39,7,12,29,37,47,10,0.00034037918240920387,0.004050512270669526,33,50,17,2,4,3,6,2,69,56,54
454,118,734,77,100,23,272,272,87,87,0,118,140,77,84,7,0.010517716736444398,0.01409169815174104,67,72,5,2,2,2,14,5,8,25,29
455,0,0,1,1,0,0,0,1,1,0,0,0,1,1,0,0.0,0.0,1,1,0,-1,-1,-1,7,0,43,79,98
456,0,102,1,78,77,0,7,1,28,27,0,4,1,32,31,0.0,0.001497668402600497,1,43,42,4,-1,5,4,0,47,96,83
457,0,616,1,100,99,0,74,1,33,32,0,38,1,47,46,0.0,0.005514142755029102,1,55,54,2,-1,3,14,0,16,66,34
458,0,101,1,73,72,0,16,1,25,24,0,1,1,25,24,0.0,3.4037918240920386e-05,1,25,24,5,-1,6,16,0,4,97,68
459,0,206,1,91,90,0,11,1,27,26,0,9,1,31,30,0.0,0.0010892133837094523,1,35,34,3,-1,4,4,0,67,81,43
460,200,406,88,98,10,118,118,66,66,0,118,118,80,80,0,0.01763164164879676,0.019367575479083698,80,81,1,3,3,3,8,16,30,12,53
461,0,616,1,100,99,0,118,1,54,53,0,92,1,55,54,0.0,0.012389802239695021,1,74,73,2,-1,3,16,0,4,40,30
462,375,575,98,100,2,104,104,82,82,0,104,104,82,82,0,0.0425814357193914,0.043874876612546375,94,94,0,3,2,2,5,40,80,3,53
463,236,436,94,100,6,120,120,86,86,0,120,120,86,86,0,0.027536675856904592,0.034854828278702475,89,93,4,3,2,2,6,22,65,9,14
464,62,62,54,54,0,144,144,63,63,0,62,62,54,54,0,0.004799346471969774,0.004799346471969774,55,55,0,-1,3,3,14,6,17,35,93
465,32,32,47,47,0,80,80,45,45,0,32,32,47,47,0,0.0019741992579733825,0.0019741992579733825,45,45,0,-1,3,3,9,3,28,51,92
466,0,616,1,100,99,0,34,1,38,37,0,34,1,45,44,0.0,0.016236087000919025,1,79,78,2,-1,3,4,0,67,84,16
467,0,616,1,99,98,0,102,1,52,51,0,57,1,51,50,0.0,0.005684332346233704,1,53,52,2,-1,3,17,1,20,69,57
468,91,297,76,99,23,32,32,70,70,0,32,32,70,70,0,0.012253650566731339,0.018482589604819768,74,81,7,3,3,3,2,14,95,32,24
469,334,334,95,95,0,208,208,97,97,0,208,208,97,97,0,0.02750263793866367,0.02750263793866367,88,88,0,-1,2,2,7,19,24,15,45
470,0,102,1,75,74,0,7,1,27,26,0,2,1,27,26,0.0,0.0,1,1,0,4,-1,5,6,0,44,40,95
471,100,100,59,59,0,100,100,40,40,0,100,100,59,59,0,0.018312400013615168,0.027264372510977228,81,89,8,2,1,1,15,6,7,26,14
472,12,628,34,100,66,42,52,37,40,3,12,52,34,50,16,0.001940161339732462,0.006977773239388679,43,56,13,2,4,3,7,2,46,75,13
473,100,100,69,69,0,100,100,55,55,0,100,100,69,69,0,0.06225535246264338,0.06225535246264338,100,100,0,-1,1,1,9,40,26,3,59
474,100,716,79,100,21,56,56,76,76,0,56,56,77,77,0,0.013989584397018279,0.033935804486197624,77,93,16,2,2,2,2,13,68,24,11
475,0,0,1,1,0,0,0,1,1,0,0,0,1,1,0,0.0,0.0,1,1,0,-1,-1,-1,3,0,96,91,82
476,6,212,27,89,62,16,20,27,27,0,6,16,27,32,5,6.807583648184077e-05,0.0006467204465774873,28,34,6,3,4,4,6,1,40,95,64
477,8,624,38,100,62,8,22,33,46,13,8,22,38,51,13,0.0004084550188910446,0.011913271384322134,36,72,36,2,4,3,2,2,89,56,17
478,169,169,92,92,0,72,72,80,80,0,72,72,80,80,0,0.023588277340957826,0.023588277340957826,89,89,0,-1,2,2,3,16,87,12,81
479,155,155,92,92,0,72,72,85,85,0,72,72,85,85,0,0.02277136730317574,0.02277136730317574,88,88,0,-1,2,2,3,13,94,33,79
480,91,707,75,100,25,48,48,66,66,0,48,48,67,67,0,0.017291262466387555,0.031621226045815035,81,89,8,2,3,3,3,12,76,37,23
481,6,108,33,83,50,24,24,38,38,0,6,10,33,38,5,0.0028591851322373124,0.0034037918240920387,50,50,0,4,4,4,4,1,73,90,74
482,100,100,76,76,0,100,100,96,96,0,100,100,96,96,0,0.08356308928145954,0.08356308928145954,100,100,0,-1,1,1,3,22,87,9,89
483,18,224,44,95,51,42,42,41,41,0,18,27,44,50,6,0.0020422750944552232,0.0034037918240920387,45,50,5,3,3,3,6,2,32,83,43
484,0,206,1,92,91,0,18,1,34,33,0,18,1,47,46,0.0,0.004663194799006093,1,54,53,3,-1,4,3,0,87,86,72
485,52,258,58,97,39,48,48,67,67,0,48,48,70,70,0,0.008986010415602982,0.012049423057285817,66,75,9,3,3,3,3,5,96,25,73
486,80,286,55,94,39,222,222,74,74,0,80,92,55,57,2,0.0051397256543789785,0.00704584907587052,55,57,2,3,2,2,14,3,16,29,61
487,16,222,40,92,52,46,46,46,46,0,16,22,40,44,4,0.0035059055788147996,0.005071649817897137,49,54,5,3,3,3,5,1,88,90,94
488,0,102,1,77,76,0,8,1,28,27,0,3,1,29,28,0.0,0.0004084550188910446,1,34,33,4,-1,5,4,0,53,97,56
489,0,101,1,81,80,0,3,1,24,23,0,1,1,24,23,0.0,0.0002382654276864427,1,31,30,5,-1,6,3,1,82,50,55
490,49,255,53,95,42,76,76,52,52,0,49,76,54,61,7,0.005105687736138058,0.00878178290615746,54,66,12,3,3,3,6,4,65,22,35
491,114,730,77,100,23,162,162,83,83,0,114,134,77,83,6,0.00803294870485721,0.009632730862180468,62,67,5,2,2,2,9,6,29,28,43
492,0,616,1,100,99,0,28,1,37,36,0,18,1,42,41,0.0,0.0024507301133462676,1,47,46,2,-1,3,5,0,37,85,52
493,0,206,1,91,90,0,18,1,31,30,0,18,1,41,40,0.0,0.0029612988869600733,1,48,47,3,-1,4,5,0,52,93,35
494,0,0,1,1,0,0,0,1,1,0,0,0,1,1,0,0.0,0.0,1,1,0,-1,-1,-1,4,0,73,92,50
495,176,376,86,98,12,142,142,78,78,0,142,142,84,84,0,0.01596378365499166,0.01929949964260186,76,82,6,3,2,2,8,14,21,14,28
496,0,102,1,73,72,0,18,1,28,27,0,2,1,25,24,0.0,0.00030634126416828345,1,32,31,4,-1,5,10,0,22,80,49
497,0,616,1,100,99,0,46,1,44,43,0,46,1,54,53,0.0,0.011640968038394772,1,75,74,2,-1,3,5,0,45,91,39
498,6,1646,29,100,71,13,94,29,67,38,6,94,29,72,43,0.00013615167296368154,0.03802035467510807,31,92,61,1,4,2,5,1,61,65,9
499,0,1640,1,100,99,0,44,1,71,70,0,44,1,72,71,0.0,0.036760951700194014,1,93,92,1,-1,2,3,0,60,66,73
500,134,134,83,83,0,240,240,89,89,0,134,134,83,83,0,0.011640968038394772,0.011640968038394772,71,71,0,-1,2,2,12,6,6,77,59
501,1,207,26,91,65,7,21,26,32,6,1,7,26,34,8,0.0,0.0019741992579733825,1,44,43,3,6,4,7,2,62,58,46
502,98,304,74,98,24,48,48,65,65,0,48,48,68,68,0,0.012662105585622384,0.013785356887572755,77,79,2,3,3,3,3,9,66,27,54
503,38,38,46,46,0,100,100,45,45,0,38,38,46,46,0,0.0012594029749140542,0.0012594029749140542,39,39,0,-1,3,3,10,4,0,64,92
504,6,622,29,99,70,27,78,30,36,6,6,53,29,54,25,0.0002382654276864427,0.00793083495013445,31,61,30,2,4,3,12,1,14,65,27
505,100,100,64,64,0,100,100,57,57,0,100,100,65,65,0,0.032880629020729094,0.032880629020729094,90,90,0,-1,1,1,8,8,10,20,67
506,54,260,65,97,32,38,38,61,61,0,38,38,63,63,0,0.006501242384015794,0.02032063718982947,63,85,22,3,3,3,3,4,81,38,16
507,100,100,62,62,0,100,100,43,43,0,100,100,62,62,0,0.016372238673882704,0.016372238673882704,78,78,0,-1,1,1,12,6,14,70,45
508,40,246,51,91,40,102,102,66,66,0,40,50,51,54,3,0.004288777698355968,0.006467204465774873,53,58,5,3,2,2,8,2,10,94,70
509,28,644,46,100,54,86,110,42,60,18,28,84,46,59,13,0.0016678579938050988,0.00881582082439838,43,69,26,2,3,3,10,3,1,54,21
510,175,381,90,99,9,142,142,98,98,0,142,142,98,98,0,0.020763130126961436,0.025051907825317403,85,87,2,3,2,2,5,9,37,39,57
511,318,318,94,94,0,152,152,96,96,0,152,152,96,96,0,0.038394771775758195,0.038394771775758195,91,91,0,-1,2,2,5,29,61,0,36
512,68,274,56,93,37,80,80,62,62,0,68,74,59,59,0,0.006399128629293032,0.008305252050784574,54,63,9,3,2,2,6,4,71,72,90
513,0,101,1,74,73,0,12,1,25,24,0,1,1,25,24,0.0,3.4037918240920386e-05,1,25,24,5,-1,6,12,0,3,97,58
514,8,214,38,95,57,8,12,33,36,3,8,12,38,40,2,0.0004084550188910446,0.0035739814152966403,36,52,16,3,4,4,2,2,89,56,90
515,0,616,1,100,99,0,76,1,40,39,0,76,1,59,58,0.0,0.00891793457912114,1,65,64,2,-1,3,10,0,11,89,14
516,67,683,62,100,38,98,108,52,68,16,67,108,62,76,14,0.006705469893461316,0.015657442390823378,63,78,15,2,3,3,8,8,39,57,77
517,140,756,84,100,16,198,198,86,86,0,140,198,84,91,7,0.01330882603219987,0.019265461724360937,75,82,7,2,2,2,10,8,1,17,34
518,324,530,98,100,2,144,144,91,91,0,144,144,91,91,0,0.036590762108989414,0.03866707512168556,95,95,0,3,2,2,6,27,74,10,22
519,30,646,47,100,53,58,68,38,39,1,30,68,47,58,11,0.004356853534837809,0.011947309302563056,54,72,18,2,3,3,8,6,15,73,20
520,100,100,77,77,0,100,100,96,96,0,100,100,96,96,0,0.06399128629293033,0.06981177031212771,98,98,0,3,1,1,3,15,76,19,25
521,6,6,29,29,0,29,29,31,31,0,6,6,29,29,0,6.807583648184077e-05,6.807583648184077e-05,27,27,0,-1,4,4,12,1,3,60,85
522,0,206,1,90,89,0,20,1,33,32,0,20,1,45,44,0.0,0.004731270635487933,1,54,53,3,-1,4,4,1,79,50,13
523,56,262,61,97,36,38,38,51,51,0,38,38,54,54,0,0.009632730862180468,0.012151536812008578,68,71,3,3,3,3,3,7,94,21,41
524,72,173,70,90,20,64,64,68,68,0,64,64,71,71,0,0.013444977705163553,0.013444977705163553,77,77,0,5,3,3,4,8,72,20,95
525,16,222,48,97,49,18,22,51,51,0,16,22,51,54,3,0.0011913271384322134,0.0026209197045508697,39,47,8,3,3,3,2,2,98,42,52
526,34,240,49,93,44,94,94,51,51,0,34,40,49,50,1,0.0033016780693692774,0.003880322679464924,47,49,2,3,3,3,9,6,26,70,42
527,214,830,93,100,7,136,136,81,81,0,136,136,88,88,0,0.017597603730555838,0.028149358385241158,83,90,7,2,2,2,7,16,46,12,20
528,22,1662,41,100,59,92,148,36,63,27,22,148,41,82,41,0.001157289220191293,0.02314578440382586,37,85,48,1,3,2,14,3,16,51,15
529,159,159,91,91,0,72,72,79,79,0,72,72,80,80,0,0.02484768031587188,0.02484768031587188,90,90,0,-1,2,2,3,16,75,18,66
530,100,100,60,60,0,100,100,40,40,0,100,100,60,60,0,0.04350045951189625,0.04350045951189625,97,97,0,-1,1,1,14,22,25,9,82
531,86,292,54,95,41,210,210,72,72,0,86,94,54,55,1,0.00803294870485721,0.009122162088566664,62,64,2,3,2,2,16,6,4,34,61
532,24,125,48,87,39,28,28,44,44,0,24,28,49,50,1,0.0016678579938050988,0.0016678579938050988,42,42,0,5,3,3,3,4,92,64,55
533,0,206,1,95,94,0,12,1,36,35,0,12,1,40,39,0.0,0.013649205214609075,1,75,74,3,-1,4,2,1,89,45,6
534,0,206,1,92,91,0,18,1,35,34,0,18,1,44,43,0.0,0.006841621566424997,1,63,62,3,-1,4,3,0,82,84,24
535,132,132,80,80,0,86,86,56,56,0,86,86,66,66,0,0.013887470642295518,0.013887470642295518,76,76,0,-1,3,3,6,13,59,33,67
536,523,729,100,100,0,216,216,99,99,0,216,216,99,99,0,0.054528745021954456,0.06188093536199326,97,100,3,3,2,2,6,36,48,2,14
537,28,234,44,91,47,88,88,47,47,0,28,88,44,60,16,0.0030293747234419145,0.008305252050784574,48,65,17,3,3,3,8,6,10,70,24
538,493,1093,99,100,1,208,208,99,99,0,208,208,99,99,0,0.049763436468225605,0.06252765580857075,96,100,4,2,2,2,7,36,46,2,23
539,0,206,1,91,90,0,16,1,32,31,0,8,1,36,35,0.0,0.0006807583648184077,1,36,35,3,-1,4,4,0,83,98,56
540,0,616,1,100,99,0,42,1,36,35,0,42,1,50,49,0.0,0.011334626774226489,1,69,68,2,-1,3,6,0,71,76,39
541,154,154,88,88,0,88,88,82,82,0,88,88,82,82,0,0.024166921951053473,0.024166921951053473,86,86,0,-1,2,2,4,20,78,23,89
542,2,208,28,93,65,10,20,30,31,1,2,8,28,34,6,0.0002382654276864427,0.001599782157323258,31,42,11,3,5,4,6,1,69,60,53
543,80,80,78,78,0,32,32,67,67,0,32,32,68,68,0,0.017018959120460194,0.017018959120460194,80,80,0,-1,3,3,2,9,97,39,66
544,0,1640,1,100,99,0,120,1,64,63,0,120,1,78,77,0.0,0.020014295925661188,1,80,79,1,-1,2,10,0,11,81,19
545,301,917,96,100,4,96,96,74,74,0,96,96,74,74,0,0.029919330133769018,0.035603662480002726,90,93,3,2,3,3,6,29,69,1,44
546,16,632,35,100,65,110,110,59,59,0,16,48,35,51,16,0.003437829742332959,0.010279451308757957,52,68,16,2,3,3,10,1,18,90,25
547,443,649,100,100,0,200,200,100,100,0,200,200,100,100,0,0.045304469178665034,0.05119302903434426,96,99,3,3,2,2,5,29,61,1,34
548,8,109,39,84,45,12,12,35,35,0,8,12,39,42,3,0.002314578440382586,0.002314578440382586,49,49,0,5,4,4,2,2,86,83,95
549,86,292,59,94,35,126,126,69,69,0,86,126,59,77,18,0.009632730862180468,0.012117498893767658,66,73,7,3,2,2,7,6,24,34,73
550,18,224,44,95,51,66,66,49,49,0,18,32,44,50,6,0.00176997174852786,0.004356853534837809,43,53,10,3,3,3,6,2,32,61,41
551,122,738,76,100,24,104,104,73,73,0,104,104,79,79,0,0.012151536812008578,0.02100139555464788,75,87,12,2,2,2,5,9,52,27,21
552,0,206,1,92,91,0,16,1,29,28,0,8,1,33,32,0.0,0.0017359338302869397,1,43,42,3,-1,4,6,0,59,93,83
553,18,224,46,97,51,18,18,35,35,0,18,18,46,46,0,0.002110350930937064,0.002995336805200994,43,48,5,3,4,4,3,6,94,70,74
554,248,848,92,100,8,128,128,90,90,0,128,128,90,90,0,0.023350011913271386,0.028013206712277475,86,87,1,2,2,2,5,19,61,15,57
555,80,286,55,96,41,188,188,80,80,0,80,94,55,58,3,0.005990673610401988,0.006943735321147759,55,57,2,3,2,2,10,3,0,29,64
556,2,208,26,92,66,7,32,26,34,8,2,26,26,48,22,0.0,0.005037611899656217,1,53,52,3,5,4,6,1,59,68,72
557,6,622,28,100,72,43,70,30,32,2,6,30,28,42,14,0.00017018959120460194,0.0018380475850097008,29,40,11,2,4,3,16,1,4,60,54
558,0,101,1,78,77,0,6,1,24,23,0,1,1,24,23,0.0,0.0,1,1,0,6,-1,7,6,0,69,87,68
559,100,100,59,59,0,100,100,46,46,0,100,100,59,59,0,0.050444194833044013,0.06790564689063616,100,100,0,2,1,1,11,29,5,11,9
560,0,0,1,1,0,0,0,1,1,0,0,0,1,1,0,0.0,0.0,1,1,0,-1,-1,-1,5,1,52,69,36
561,39,655,53,100,47,60,60,51,51,0,39,60,52,61,9,0.0045270431260424114,0.012730181422104225,56,74,18,2,3,3,5,4,80,22,32
562,100,100,63,63,0,100,100,47,47,0,100,100,63,63,0,0.04516831750570135,0.04516831750570135,95,95,0,-1,1,1,10,20,36,23,92
563,0,616,1,100,99,0,42,1,39,38,0,34,1,51,50,0.0,0.005718370264474625,1,58,57,2,-1,3,6,0,44,81,38
564,34,34,54,54,0,34,34,47,47,0,34,34,55,55,0,0.0030293747234419145,0.0030293747234419145,49,49,0,-1,3,3,4,6,77,70,79
565,12,218,37,92,55,22,26,34,34,0,12,18,37,44,7,0.0006807583648184077,0.0028932230504782326,36,47,11,3,4,4,5,2,88,56,90
566,6,212,29,92,63,23,27,29,31,2,6,12,29,32,3,0.0,0.0002042275094455223,1,31,30,3,4,4,10,1,0,95,4
567,164,780,82,100,18,214,214,74,74,0,164,214,82,89,7,0.00881582082439838,0.0317233398005378,62,92,30,2,2,2,15,13,7,24,1
568,0,616,1,100,99,0,60,1,38,37,0,60,1,57,56,0.0,0.012832295176826986,1,72,71,2,-1,3,9,0,23,67,5
569,376,376,99,99,0,256,256,97,97,0,256,256,98,98,0,0.03362946322202934,0.03362946322202934,92,92,0,-1,2,2,10,22,22,9,36
570,6,107,31,79,48,15,15,31,31,0,6,6,31,31,0,0.00017018959120460194,0.00017018959120460194,31,31,0,5,4,4,6,1,32,60,68
571,92,708,66,100,34,118,128,69,75,6,92,128,66,80,14,0.013104598522754349,0.03465060076925695,76,89,13,2,3,3,8,8,57,20,9
572,58,158,54,80,26,186,186,71,71,0,58,58,54,54,0,0.00527587732734266,0.005514142755029102,55,55,0,4,3,3,16,6,9,35,88
573,212,212,87,87,0,252,252,85,85,0,212,212,87,87,0,0.016712617856291908,0.016712617856291908,73,73,0,-1,2,2,14,15,25,19,96
574,40,40,48,48,0,76,76,54,54,0,40,40,48,48,0,0.005922597773920147,0.005922597773920147,55,55,0,-1,2,2,6,1,56,90,93
575,107,723,79,100,21,48,48,62,62,0,48,48,64,64,0,0.013036522686272508,0.02236291228428469,75,86,11,2,3,3,3,13,64,33,32
576,176,1776,89,100,11,136,136,100,100,0,136,136,100,100,0,0.022396950202525613,0.07018618741277784,88,98,10,1,2,2,4,9,53,39,3
577,66,66,61,61,0,32,32,58,58,0,32,32,59,59,0,0.006535280302256714,0.006535280302256714,59,59,0,-1,3,3,2,6,68,13,50
578,0,616,1,100,99,0,42,1,36,35,0,42,1,50,49,0.0,0.009973110044589673,1,63,62,2,-1,3,6,0,71,97,32
579,37,243,60,100,40,12,12,39,39,0,12,12,44,44,0,0.007760645358929848,0.029340685523673374,65,92,27,3,4,4,2,9,97,31,0
580,166,782,84,100,16,208,208,85,85,0,166,208,84,90,6,0.014874570271282209,0.018278362095374246,76,79,3,2,2,2,10,9,18,39,28
581,344,344,96,96,0,320,320,95,95,0,320,320,96,96,0,0.024507301133462677,0.024507301133462677,87,87,0,-1,2,2,14,19,17,15,59
582,100,100,65,65,0,100,100,45,45,0,100,100,65,65,0,0.045474658769869634,0.06045134279587461,96,100,4,1,1,1,10,22,12,9,27
583,16,632,40,100,60,28,40,40,42,2,16,40,40,51,11,0.0006467204465774873,0.021137547227611558,36,85,49,2,3,3,5,1,45,88,1
584,0,0,1,1,0,0,0,1,1,0,0,0,1,1,0,0.0,0.0,1,1,0,-1,-1,-1,11,0,5,86,45
585,0,0,1,1,0,0,0,1,1,0,0,0,1,1,0,0.0,0.0,1,1,0,-1,-1,-1,10,0,0,79,81
586,188,788,90,100,10,144,144,95,95,0,144,144,95,95,0,0.025868817863099493,0.03618230709009837,88,95,7,2,2,2,6,15,65,19,5
587,214,1854,90,100,10,142,166,72,82,10,142,166,83,87,4,0.02130773681881616,0.04346642159365533,85,96,11,1,2,2,8,16,42,18,6
588,236,852,94,100,6,120,120,86,86,0,120,120,86,86,0,0.027536675856904592,0.03264236359304265,89,92,3,2,2,2,6,22,65,9,44
589,0,0,1,1,0,0,0,1,1,0,0,0,1,1,0,0.0,0.0,1,1,0,-1,-1,-1,12,0,3,99,92
590,0,616,1,100,99,0,42,1,35,34,0,32,1,40,39,0.0,0.004663194799006093,1,52,51,2,-1,3,6,0,51,79,26
591,0,0,1,1,0,0,0,1,1,0,0,0,1,1,0,0.0,0.0,1,1,0,-1,-1,-1,8,0,42,66,86
592,24,230,44,93,49,68,68,42,42,0,24,68,44,62,18,0.0013274788113958951,0.010109261717553355,40,69,29,3,3,3,8,4,39,64,33
593,112,213,84,93,9,78,78,75,75,0,78,78,76,76,0,0.016270124919159943,0.016338200755641786,80,80,0,6,2,2,4,8,73,8,78
594,0,206,1,93,92,0,20,1,31,30,0,19,1,40,39,0.0,0.002825147213996392,1,47,46,3,-1,4,6,0,34,87,22
595,269,885,95,100,5,316,316,92,92,0,269,287,95,95,0,0.015589366554341537,0.017052997038701112,77,77,0,2,2,2,15,15,7,19,52
596,6,108,32,82,50,14,14,32,32,0,6,10,32,35,3,0.00030634126416828345,0.0011913271384322134,33,40,7,4,4,4,3,1,96,4,74
597,80,696,61,100,39,104,124,73,87,14,80,124,62,88,26,0.008951972497362062,0.03791824092038531,69,93,24,2,2,2,6,2,41,75,10
598,16,16,41,41,0,24,24,43,43,0,16,16,42,42,0,0.0007488342013002485,0.0007488342013002485,36,36,0,-1,3,3,3,1,55,49,79
599,135,751,78,100,22,228,258,77,82,5,135,193,78,86,8,0.008271214132543654,0.014840532353041287,61,74,13,2,2,2,15,8,7,57,34
600,322,528,95,100,5,168,168,93,93,0,168,168,94,94,0,0.03352734946730658,0.044419483304401104,91,95,4,3,2,2,6,22,44,9,37
601,0,206,1,90,89,0,26,1,34,33,0,26,1,47,46,0.0,0.0053439531638245,1,58,57,3,-1,4,5,0,80,98,34
602,176,176,90,90,0,232,232,95,95,0,176,176,90,90,0,0.01763164164879676,0.01763164164879676,83,83,0,-1,2,2,10,9,36,39,98
603,0,102,1,70,69,0,10,1,25,24,0,2,1,25,24,0.0,6.807583648184077e-05,1,28,27,4,-1,5,9,0,28,92,60
604,145,745,82,100,18,198,198,83,83,0,145,198,82,87,5,0.010687906327649,0.018210286258892407,67,79,12,2,2,2,10,8,11,44,20
605,63,165,58,87,29,94,94,68,68,0,63,65,59,59,0,0.006569318220497634,0.006705469893461316,58,58,0,4,2,2,5,4,61,22,55
606,100,100,65,65,0,100,100,45,45,0,100,100,65,65,0,0.050784574015453214,0.050818611933694136,99,99,0,6,1,1,10,27,12,10,78
607,22,22,41,41,0,62,62,37,37,0,22,22,41,41,0,0.0012253650566731338,0.0012253650566731338,41,41,0,-1,3,3,10,3,18,51,82
608,34,240,50,92,42,60,60,49,49,0,34,60,50,58,8,0.0030634126416828346,0.008203138296061813,48,63,15,3,3,3,5,6,88,70,44
609,12,218,40,92,52,18,18,38,38,0,12,18,40,46,6,0.0010892133837094523,0.007250076585316042,39,62,23,3,4,4,3,3,76,51,31
610,0,616,1,99,98,0,98,1,44,43,0,98,1,62,61,0.0,0.015555328636100617,1,77,76,2,-1,3,11,0,19,67,12
611,100,100,62,62,0,100,100,45,45,0,100,100,62,62,0,0.02290751897613942,0.02825147213996392,84,87,3,2,1,1,12,7,3,48,72
612,100,100,69,69,0,100,100,71,71,0,100,100,72,72,0,0.06845025358249089,0.0722965383437149,99,100,1,3,1,1,6,36,56,2,24
613,76,76,69,69,0,38,38,46,46,0,38,38,51,51,0,0.010109261717553355,0.010109261717553355,73,73,0,-1,3,3,3,6,96,77,69
614,0,206,1,96,95,0,8,1,33,32,0,8,1,39,38,0.0,0.003437829742332959,1,50,49,3,-1,4,2,0,93,59,47
615,56,672,53,100,47,86,104,47,59,12,56,104,53,76,23,0.0012253650566731338,0.012900371013308825,40,74,34,2,2,2,9,2,54,56,30
616,0,101,1,75,74,0,14,1,25,24,0,1,1,25,24,0.0,0.0,1,1,0,5,-1,6,14,0,25,59,78
617,0,616,1,100,99,0,24,1,43,42,0,24,1,48,47,0.0,0.013479015623404473,1,75,74,2,-1,3,3,0,92,84,19
618,156,258,85,92,7,214,214,86,86,0,156,158,85,85,0,0.01756356581231492,0.01773375540351952,80,80,0,4,2,2,11,9,33,39,60
619,42,248,59,94,35,48,48,66,66,0,48,48,67,67,0,0.00970080669866231,0.015419176963136935,70,77,7,3,3,3,3,5,76,25,31
620,431,637,100,100,0,224,224,98,98,0,224,224,98,98,0,0.038530923448721874,0.03900745430409476,95,95,0,3,2,2,8,30,21,7,49
621,291,497,99,100,1,96,96,94,94,0,96,96,94,94,0,0.044453521222642026,0.04853807141155247,94,96,2,3,2,2,3,29,92,11,31
622,94,300,57,95,38,220,220,72,72,0,94,106,57,74,17,0.0068075836481840775,0.008986010415602982,56,59,3,3,2,2,16,6,9,26,75
623,100,100,76,76,0,100,100,90,90,0,100,100,90,90,0,0.06283399707273903,0.07066271826815072,99,99,0,2,1,1,4,20,72,23,48
624,0,616,1,100,99,0,19,1,43,42,0,16,1,42,41,0.0,0.004595118962524252,1,51,50,2,-1,3,3,0,92,81,88
625,16,222,43,97,54,28,28,46,46,0,16,28,43,52,9,0.001497668402600497,0.007420266176520644,41,67,26,3,3,3,3,1,81,71,25
626,112,728,86,100,14,32,32,70,70,0,32,32,70,70,0,0.019707954661492902,0.029647026787841656,84,92,8,2,3,3,2,18,95,30,17
627,125,1725,76,100,24,204,204,79,79,0,125,204,76,87,11,0.00891793457912114,0.024575376969944517,61,85,24,1,2,2,11,8,5,57,17
628,56,1656,52,100,48,76,76,54,54,0,56,76,52,65,13,0.005548180673270023,0.024439225296980838,53,87,34,1,2,2,6,2,56,75,31
629,132,1772,89,100,11,72,96,86,93,7,72,96,86,93,7,0.019980258007420267,0.05323530412879948,83,99,16,1,2,2,3,14,92,14,45
630,0,1640,1,100,99,0,186,1,67,66,0,186,1,86,85,0.0,0.023384049831512304,1,85,84,1,-1,2,17,0,20,89,9
631,100,100,66,66,0,100,100,43,43,0,100,100,66,66,0,0.05218012866333095,0.06300418666394364,100,100,0,1,1,1,11,29,33,1,28
632,0,616,1,100,99,0,46,1,38,37,0,22,1,41,40,0.0,0.003710133088260322,1,49,48,2,-1,3,8,0,39,92,29
633,57,673,65,100,35,38,38,55,55,0,38,38,58,58,0,0.006399128629293032,0.026651689982640663,62,88,26,2,3,3,3,8,76,44,10
634,46,252,60,97,37,28,28,46,46,0,28,28,51,51,0,0.005616256509751864,0.008271214132543654,58,65,7,3,3,3,3,6,85,13,41
635,0,0,1,1,0,0,0,1,1,0,0,0,1,1,0,0.0,0.0,1,1,0,-1,-1,-1,10,0,12,66,59
636,0,206,1,88,87,0,44,1,34,33,0,26,1,45,44,0.0,0.003165526396405596,1,51,50,3,-1,4,10,0,11,96,28
637,14,116,46,87,41,12,12,39,39,0,12,12,44,44,0,0.0025188059498281084,0.005616256509751864,47,60,13,4,4,4,2,6,97,70,13
638,0,1640,1,100,99,0,134,1,60,59,0,134,1,77,76,0.0,0.023418087749753225,1,86,85,1,-1,2,10,0,0,98,5
639,12,218,39,93,54,20,20,35,35,0,12,20,39,47,8,0.0012253650566731338,0.0061949011198475104,41,57,16,3,4,4,4,3,73,51,62
640,116,322,76,94,18,120,120,78,78,0,120,120,78,78,0,0.014432077334150244,0.017972020831205963,75,80,5,3,2,2,6,8,41,20,62
641,10,10,37,37,0,46,46,39,39,0,10,10,37,37,0,0.0011232513019503727,0.0011232513019503727,39,39,0,-1,4,4,9,3,26,43,82
642,18,18,47,47,0,22,22,47,47,0,18,18,50,50,0,0.003267640151128357,0.003267640151128357,52,52,0,-1,3,3,2,2,89,75,92
643,6,108,33,84,51,12,12,37,37,0,6,8,33,37,4,0.0002042275094455223,0.0007147962830593281,31,37,6,4,4,4,2,1,89,4,42
644,54,54,65,65,0,38,38,61,61,0,38,38,63,63,0,0.006501242384015794,0.006501242384015794,63,63,0,-1,3,3,3,4,81,38,89
645,210,1810,90,100,10,152,152,82,82,0,152,152,86,86,0,0.02042275094455223,0.03798631675686715,82,95,13,1,2,2,8,17,10,6,20
646,8,110,41,87,46,8,8,35,35,0,8,8,41,41,0,0.0013615167296368155,0.003948398515946765,42,51,9,4,4,4,2,3,97,51,35
647,100,100,61,61,0,100,100,43,43,0,100,100,61,61,0,0.03281255318424725,0.03281255318424725,91,91,0,-1,1,1,12,18,2,30,99
648,226,842,91,100,9,144,144,92,92,0,144,144,92,92,0,0.021443888491779844,0.034718676605738796,83,91,8,2,2,2,6,18,41,5,15
649,0,1640,1,100,99,0,51,1,37,36,0,42,1,50,49,0.0,0.016270124919159943,1,78,77,1,-1,2,7,0,43,40,74
650,232,232,88,88,0,258,258,94,94,0,232,232,88,88,0,0.011981347220803976,0.011981347220803976,69,69,0,-1,2,2,12,13,2,24,67
651,1,1,25,25,0,6,6,25,25,0,1,1,25,25,0,0.0,0.0,1,1,0,-1,6,6,6,2,69,58,67
652,0,206,1,92,91,0,14,1,31,30,0,14,1,38,37,0.0,0.002110350930937064,1,45,44,3,-1,4,3,0,82,99,70
653,100,100,65,65,0,100,100,75,75,0,100,100,77,77,0,0.04625753088941081,0.04625753088941081,97,97,0,-1,1,1,5,16,61,12,79
654,0,206,1,89,88,0,26,1,29,28,0,6,1,28,27,0.0,0.0006467204465774873,1,35,34,3,-1,4,10,0,18,59,49
655,2,618,28,100,72,7,30,29,45,16,2,30,28,54,26,0.00010211375472276115,0.008271214132543654,30,65,35,2,5,3,4,1,78,65,8
656,0,0,1,1,0,0,0,1,1,0,0,0,1,1,0,0.0,0.0,1,1,0,-1,-1,-1,3,1,66,69,86
657,0,0,1,1,0,0,0,1,1,0,0,0,1,1,0,0.0,0.0,1,1,0,-1,-1,-1,5,0,49,59,92
658,339,939,98,100,2,152,152,98,98,0,152,152,98,98,0,0.04360257326661901,0.05561795840566391,96,97,1,2,2,2,5,29,45,11,6
659,34,240,53,94,41,28,28,45,45,0,28,28,50,50,0,0.005922597773920147,0.012730181422104225,59,74,15,3,3,3,3,4,58,72,34
660,110,212,75,89,14,148,148,76,76,0,110,112,75,76,1,0.00796487286837537,0.00803294870485721,61,62,1,4,2,2,9,6,29,13,60
661,324,530,98,100,2,144,144,91,91,0,144,144,91,91,0,0.036590762108989414,0.041219918989754585,95,96,1,3,2,2,6,27,74,10,21
662,0,616,1,100,99,0,32,1,35,34,0,16,1,35,34,0.0,0.003267640151128357,1,47,46,2,-1,3,7,0,43,96,94
663,0,616,1,100,99,0,52,1,37,36,0,39,1,47,46,0.0,0.006773545729943157,1,60,59,2,-1,3,9,0,54,59,44
664,0,0,1,1,0,0,0,1,1,0,0,0,1,1,0,0.0,0.0,1,1,0,-1,-1,-1,4,0,72,87,45
665,101,307,76,97,21,164,164,77,77,0,101,164,76,86,10,0.008271214132543654,0.011606930120153852,64,72,8,3,2,2,10,8,36,57,47
666,475,577,99,100,1,216,216,99,99,0,216,216,99,99,0,0.04697232717247013,0.0482657680656251,95,95,0,4,2,2,6,40,48,3,83
667,0,616,1,99,98,0,58,1,34,33,0,16,1,33,32,0.0,0.0018380475850097008,1,42,41,2,-1,3,12,0,14,67,53
668,22,638,49,100,51,22,22,47,47,0,22,22,52,52,0,0.002144388849177984,0.017597603730555838,45,82,37,2,3,3,2,2,89,52,37
669,16,16,38,38,0,114,114,61,61,0,16,16,38,38,0,0.0020422750944552232,0.0020422750944552232,43,43,0,-1,3,3,9,1,54,53,80
670,16,632,40,100,60,46,60,46,48,2,16,32,40,48,8,0.0035059055788147996,0.006977773239388679,49,59,10,2,3,3,5,1,88,90,46
671,94,300,67,95,28,110,110,78,78,0,94,100,72,74,2,0.007250076585316042,0.007522379931243405,58,59,1,3,2,2,6,5,51,47,65
672,12,218,37,96,59,14,14,33,33,0,12,18,37,44,7,0.0005786446100956465,0.0010211375472276116,35,39,4,3,4,4,3,2,75,63,88
673,16,16,35,35,0,68,68,37,37,0,16,16,35,35,0,0.0009190237925048504,0.0009190237925048504,39,39,0,-1,3,3,10,2,1,42,91
674,95,711,77,100,23,32,32,64,64,0,32,32,64,64,0,0.019061234214915415,0.031655263964055956,82,94,12,2,3,3,2,16,89,18,32
675,274,890,94,100,6,232,232,92,92,0,232,232,94,94,0,0.02021852343510671,0.023996732359848873,80,86,6,2,2,2,10,18,11,5,22
676,2,618,26,100,74,12,66,28,41,13,2,34,26,48,22,6.807583648184077e-05,0.0042547397801150485,29,53,24,2,5,3,9,1,28,78,29
677,100,100,67,67,0,100,100,74,74,0,100,100,75,75,0,0.062357466217366146,0.06950542904795942,98,99,1,3,1,1,5,29,63,0,8
678,86,286,65,95,30,86,86,62,62,0,86,86,65,65,0,0.007454304094761564,0.014908608189523128,63,78,15,3,3,3,6,7,74,21,8
679,0,616,1,100,99,0,42,1,35,34,0,42,1,50,49,0.0,0.008747744987916539,1,66,65,2,-1,3,6,0,51,84,24
680,413,413,99,99,0,152,152,94,94,0,152,152,94,94,0,0.03720344463732598,0.03720344463732598,93,93,0,-1,2,2,5,29,52,1,98
681,100,100,77,77,0,100,100,96,96,0,100,100,96,96,0,0.08291636883488206,0.09374042683549474,100,100,0,2,1,1,3,29,82,0,6
682,88,1728,61,100,39,196,220,77,83,6,88,220,61,91,30,0.008373327887266415,0.03526328329759352,66,93,27,1,2,2,12,7,3,62,23
683,6,108,29,74,45,22,22,31,31,0,6,8,29,33,4,0.00010211375472276115,0.0002723033459273631,29,32,3,4,4,4,7,1,24,4,60
684,100,100,60,60,0,100,100,40,40,0,100,100,60,60,0,0.021682153919466287,0.02811532046700024,84,90,6,2,1,1,14,13,25,24,77
685,0,206,1,89,88,0,34,1,33,32,0,6,1,32,31,0.0,0.001599782157323258,1,41,40,3,-1,4,9,0,26,84,53
686,1,102,26,78,52,4,4,26,26,0,1,2,26,28,2,3.4037918240920386e-05,3.4037918240920386e-05,26,26,0,5,6,6,4,1,47,78,60
687,338,1938,96,100,4,256,256,95,95,0,256,256,95,95,0,0.02661765206439974,0.0494230572858164,88,97,9,1,2,2,10,19,18,15,16
688,353,953,97,100,3,128,128,92,92,0,128,128,92,92,0,0.037509785901494265,0.041083767316790906,94,94,0,2,2,2,5,30,50,7,29
689,84,1724,56,100,44,184,208,78,87,9,84,124,56,76,20,0.009190237925048503,0.021852343510670887,67,86,19,1,2,2,10,5,0,25,46
690,100,100,72,72,0,100,100,87,87,0,100,100,87,87,0,0.06188093536199326,0.07192212124306477,97,98,1,2,1,1,4,15,53,16,18
691,0,1640,1,100,99,0,46,1,86,85,0,46,1,87,86,0.0,0.05480104836788182,1,98,97,1,-1,2,2,0,97,80,62
692,235,835,94,100,6,56,56,76,76,0,56,56,77,77,0,0.033969842404438545,0.039620136832431326,93,96,3,2,2,2,2,29,68,0,24
693,88,188,71,91,20,72,72,77,77,0,72,72,77,77,0,0.013751318969331836,0.014670342761836687,78,78,0,4,2,2,3,9,82,27,51
694,0,102,1,80,79,0,6,1,29,28,0,4,1,31,30,0.0,0.0009190237925048504,1,37,36,4,-1,5,3,0,76,99,51
695,32,238,44,88,44,64,64,40,40,0,32,45,44,49,5,0.0012253650566731338,0.002280540522141666,37,42,5,3,3,3,8,2,27,74,64
696,80,696,72,100,28,48,48,66,66,0,48,48,67,67,0,0.009292351679771264,0.0348888661969434,69,93,24,2,3,3,3,9,76,31,3
697,121,121,79,79,0,154,154,71,71,0,121,121,79,79,0,0.009496579189216788,0.009496579189216788,69,69,0,-1,2,2,10,8,1,44,81
698,32,648,46,100,54,152,152,67,67,0,32,64,46,56,10,0.004833384390210695,0.010926171755335444,56,68,12,2,3,3,12,3,14,29,25
699,0,206,1,92,91,0,14,1,31,30,0,14,1,38,37,0.0,0.0032336022328874367,1,50,49,3,-1,4,3,0,82,79,41
700,6,212,29,89,60,13,30,29,35,6,6,30,29,51,22,0.0002723033459273631,0.00616086320160659,33,57,24,3,4,4,5,1,61,55,31
701,0,206,1,89,88,0,20,1,27,26,0,8,1,31,30,0.0,0.0015317063208414173,1,38,37,3,-1,4,6,1,40,69,83
702,6,6,32,32,0,20,20,34,34,0,6,6,32,32,0,0.0012253650566731338,0.0012253650566731338,41,41,0,-1,4,4,4,1,79,71,97
703,16,222,40,95,55,60,60,52,52,0,16,60,40,61,21,0.002757071377514551,0.009870996289866912,49,69,20,3,3,3,5,2,45,94,27
704,0,206,1,91,90,0,12,1,29,28,0,6,1,29,28,0.0,0.0022465026039007454,1,47,46,3,-1,4,4,0,83,98,46
705,146,146,83,83,0,96,96,67,67,0,96,96,68,68,0,0.014023622315259198,0.014023622315259198,75,75,0,-1,3,3,6,13,74,33,79
706,50,256,62,95,33,28,28,44,44,0,28,28,51,51,0,0.005446066918547262,0.00878178290615746,54,69,15,3,3,3,3,5,92,47,90
707,12,1652,34,100,66,66,148,35,62,27,12,148,34,85,51,0.0012934408931549745,0.02379250485040335,38,84,46,1,4,2,13,3,13,51,15
708,86,702,61,100,39,166,166,72,72,0,86,132,61,81,20,0.00966676878042139,0.014227849824704722,69,73,4,2,3,3,11,6,33,77,47
709,48,254,69,100,31,46,46,87,87,0,46,46,88,88,0,0.0176997174852786,0.023554239422716908,82,86,4,3,2,2,2,6,97,73,34
710,138,754,84,100,16,216,216,83,83,0,138,216,84,91,7,0.016440314510364547,0.02209060893835733,79,85,6,2,2,2,12,9,14,39,57
711,100,100,76,76,0,100,100,96,96,0,100,100,96,96,0,0.07073079410463257,0.07073079410463257,100,100,0,-1,1,1,3,20,58,23,85
712,16,632,37,100,63,88,98,52,54,2,16,98,37,66,29,0.0024166921951053475,0.012730181422104225,48,74,26,2,3,3,8,1,21,53,19
713,70,70,58,58,0,140,140,69,69,0,70,70,58,58,0,0.00616086320160659,0.00616086320160659,58,58,0,-1,3,3,10,5,22,47,84
714,40,246,57,94,37,78,78,72,72,0,40,48,57,57,0,0.004595118962524252,0.006058749446883829,56,57,1,3,2,2,4,1,47,53,52
715,32,134,52,87,35,38,38,56,56,0,32,34,58,58,0,0.003165526396405596,0.003369753905851118,48,50,2,4,3,3,3,2,58,75,88
716,0,206,1,92,91,0,14,1,35,34,0,14,1,42,41,0.0,0.0045270431260424114,1,55,54,3,-1,4,3,1,85,45,57
717,0,206,1,89,88,0,24,1,30,29,0,14,1,32,31,0.0,0.002144388849177984,1,43,42,3,-1,4,6,0,40,97,70
718,16,118,35,73,38,132,132,63,63,0,16,18,35,40,5,0.0030974505599237552,0.0031314884781646754,50,50,0,4,3,3,11,3,5,46,55
719,140,756,81,100,19,112,112,92,92,0,112,112,92,92,0,0.019197385887879097,0.03948398515946765,82,96,14,2,2,2,4,8,53,20,11
720,68,684,76,100,24,32,32,67,67,0,32,32,68,68,0,0.014534191088873005,0.04700636509071105,78,96,18,2,3,3,2,8,97,20,2
721,24,126,52,91,39,18,18,53,53,0,18,18,54,54,0,0.002280540522141666,0.005377991082065421,46,58,12,4,3,3,2,3,97,54,13
722,12,12,40,40,0,24,24,37,37,0,12,12,40,40,0,0.00037441710065012424,0.00037441710065012424,35,35,0,-1,4,4,4,2,77,63,93
723,6,622,29,100,71,18,36,33,37,4,6,40,29,52,23,0.00034037918240920387,0.005990673610401988,34,58,24,2,4,3,5,1,61,49,72
724,363,963,97,100,3,168,168,96,96,0,168,168,96,96,0,0.036624800027230335,0.039620136832431326,92,93,1,2,2,2,6,30,48,7,47
725,2,2,26,26,0,9,9,26,26,0,2,2,26,26,0,3.4037918240920386e-05,3.4037918240920386e-05,27,27,0,-1,5,5,8,2,10,58,82
726,22,638,50,100,50,38,38,55,55,0,22,38,50,57,7,0.004731270635487933,0.0141938119064638,56,77,21,2,3,3,3,3,76,29,17
727,112,728,76,100,24,146,146,80,80,0,112,146,78,85,7,0.008169100377820893,0.015997821573232582,65,78,13,2,2,2,8,4,10,72,77
728,122,738,80,100,20,118,128,70,71,1,122,128,80,82,2,0.011879233466081215,0.017189148711664794,72,78,6,2,2,2,9,8,35,8,47
729,22,638,48,100,52,40,50,42,48,6,22,50,48,54,6,0.0017018959120460194,0.0156914803090643,43,81,38,2,3,3,5,2,61,52,5
730,100,100,73,73,0,100,100,88,88,0,100,100,88,88,0,0.0567752476258552,0.08822628408046564,100,100,0,1,1,1,4,19,84,15,6
731,6,6,30,30,0,29,29,30,30,0,6,6,30,30,0,0.00030634126416828345,0.00030634126416828345,34,34,0,-1,4,4,11,1,38,55,50
732,126,742,83,100,17,212,222,78,82,4,126,222,83,89,6,0.00976888253514415,0.04053916062493618,67,94,27,2,2,2,13,7,13,48,2
733,24,24,45,45,0,64,64,39,39,0,24,24,45,45,0,0.0017018959120460194,0.0017018959120460194,44,44,0,-1,3,3,9,3,23,43,66
734,0,616,1,99,98,0,92,1,40,39,0,92,1,64,63,0.0,0.012662105585622384,1,71,70,2,-1,3,11,0,33,82,12
735,72,278,69,96,27,64,64,64,64,0,64,64,67,67,0,0.01320671227747711,0.014738418598318526,75,78,3,3,3,3,4,8,77,20,46
736,0,206,1,93,92,0,8,1,31,30,0,8,1,35,34,0.0,0.0014295925661186562,1,42,41,3,-1,4,2,0,68,99,54
737,87,87,64,64,0,76,76,54,54,0,76,76,60,60,0,0.00789679703189353,0.00789679703189353,63,63,0,-1,3,3,6,8,41,44,86
738,256,872,93,100,7,200,200,93,93,0,200,200,93,93,0,0.021137547227611558,0.027638789611627353,82,87,5,2,2,2,8,18,27,5,34
739,2,103,28,72,44,13,13,31,31,0,2,3,28,31,3,0.0002382654276864427,0.0002382654276864427,32,32,0,6,5,5,7,1,46,55,68
740,2,208,29,96,67,6,10,29,32,3,2,8,29,35,6,3.4037918240920386e-05,0.0004765308553728854,27,34,7,3,5,4,3,1,75,95,88
741,0,0,1,1,0,0,0,1,1,0,0,0,1,1,0,0.0,0.0,1,1,0,-1,-1,-1,4,0,47,91,66
742,40,40,52,52,0,80,80,65,65,0,40,40,52,52,0,0.006467204465774873,0.006467204465774873,60,60,0,-1,2,2,5,1,37,90,97
743,50,152,64,90,26,28,28,46,46,0,28,28,53,53,0,0.005820484019197386,0.006977773239388679,60,64,4,4,3,3,3,5,81,47,52
744,16,117,32,76,44,48,48,32,32,0,16,17,32,39,7,0.0002723033459273631,0.00030634126416828345,33,33,0,5,3,3,17,1,20,55,68
745,6,1646,29,100,71,26,140,30,64,34,6,140,29,81,52,0.00010211375472276115,0.027979168794036557,28,89,61,1,4,2,11,1,33,65,9
746,0,206,1,90,89,0,30,1,34,33,0,30,1,47,46,0.0,0.006467204465774873,1,57,56,3,-1,4,5,0,50,98,24
747,34,34,52,52,0,56,56,45,45,0,34,34,52,52,0,0.00176997174852786,0.00176997174852786,43,43,0,-1,3,3,6,4,44,64,84
748,100,300,76,99,23,88,88,82,82,0,88,88,82,82,0,0.013955546478777357,0.017087034956942034,78,82,4,3,2,2,4,6,72,77,35
749,22,228,41,89,48,72,72,37,37,0,22,28,41,44,3,0.0018380475850097008,0.002757071377514551,43,49,6,3,3,3,11,2,5,83,71
750,40,1680,51,100,49,108,132,61,68,7,40,132,51,79,28,0.002586881786309949,0.020456788862793153,49,84,35,1,2,2,9,1,28,53,14
751,180,180,86,86,0,102,102,64,64,0,102,102,72,72,0,0.019367575479083698,0.019367575479083698,84,84,0,-1,3,3,7,17,24,6,98
752,2,618,27,100,73,14,126,28,62,34,2,126,27,81,54,6.807583648184077e-05,0.020048333843902106,28,82,54,2,5,3,11,1,38,68,9
753,206,412,94,100,6,152,152,98,98,0,152,152,98,98,0,0.02818339630348208,0.03972225058715409,90,94,4,3,2,2,5,20,45,23,12
754,0,616,1,99,98,0,98,1,41,40,0,78,1,57,56,0.0,0.010075223799312433,1,67,66,2,-1,3,12,0,14,97,33
755,236,236,93,93,0,144,144,95,95,0,144,144,95,95,0,0.023179822322066782,0.023179822322066782,87,87,0,-1,2,2,6,19,56,15,69
756,2,618,26,100,74,10,72,28,44,16,2,72,26,58,32,0.00010211375472276115,0.008951972497362062,29,65,36,2,5,3,7,1,24,68,27
757,196,796,87,100,13,224,224,76,76,0,196,224,87,91,4,0.014295925661186561,0.01855066544130161,73,81,8,2,2,2,15,14,7,14,28
758,16,632,36,100,64,36,36,38,38,0,16,36,36,52,16,0.0009530617107457708,0.007828721195411689,38,63,25,2,3,3,5,1,61,71,25
759,134,134,80,80,0,176,176,85,85,0,134,134,80,80,0,0.008747744987916539,0.008747744987916539,64,64,0,-1,2,2,8,6,42,13,40
760,100,100,64,64,0,100,100,45,45,0,100,100,64,64,0,0.03175737771877872,0.03175737771877872,90,90,0,5,1,1,10,8,18,8,68
761,80,696,56,100,44,100,110,59,71,12,80,110,57,75,18,0.00789679703189353,0.02375846693216243,62,85,23,2,2,2,6,6,40,28,16
762,0,206,1,90,89,0,24,1,29,28,0,6,1,26,25,0.0,0.0028591851322373124,1,43,42,3,-1,4,6,1,51,69,90
763,88,190,61,90,29,184,184,83,83,0,88,90,61,63,2,0.007352190340038803,0.007556417849484326,62,62,0,4,2,2,10,7,1,62,60
764,6,622,29,100,71,22,58,33,40,7,6,58,29,56,27,0.00017018959120460194,0.015146873617209572,32,77,45,2,4,3,7,1,43,4,12
765,0,206,1,90,89,0,36,1,33,32,0,6,1,28,27,0.0,0.0016338200755641784,1,42,41,3,-1,4,10,0,1,67,94
766,72,278,69,98,29,56,56,86,86,0,56,56,86,86,0,0.02658361414615882,0.029851254297287178,89,93,4,3,2,2,2,6,95,35,13
767,403,609,100,100,0,120,120,100,100,0,120,120,100,100,0,0.06031519112291092,0.06460396882126689,97,97,0,3,2,2,3,36,66,2,72
768,98,199,72,90,18,54,54,53,53,0,54,54,57,57,0,0.012389802239695021,0.01245787807617686,75,75,0,6,3,3,4,9,79,27,68
769,150,356,80,97,17,278,278,86,86,0,150,162,80,81,1,0.00966676878042139,0.011130399264780965,63,66,3,3,2,2,15,7,7,48,75
770,118,220,80,93,13,148,148,79,79,0,118,148,80,85,5,0.01507879778072773,0.01684876952925559,75,80,5,4,2,2,9,9,26,39,75
771,6,6,29,29,0,16,16,30,30,0,6,6,29,29,0,6.807583648184077e-05,6.807583648184077e-05,27,27,0,-1,4,4,6,1,59,65,76
772,0,206,1,93,92,0,10,1,31,30,0,10,1,37,36,0.0,0.0053439531638245,1,54,53,3,-1,4,3,0,60,87,44
773,0,102,1,74,73,0,19,1,26,25,0,2,1,25,24,0.0,0.00013615167296368154,1,27,26,4,-1,5,16,1,4,50,60
774,6,6,29,29,0,24,24,30,30,0,6,6,29,29,0,0.0002042275094455223,0.0002042275094455223,32,32,0,-1,4,4,8,1,15,65,84
775,16,16,39,39,0,56,56,49,49,0,16,16,39,39,0,0.0034718676605738795,0.0034718676605738795,50,50,0,-1,3,3,6,3,69,46,67
776,0,206,1,86,85,0,13,1,27,26,0,6,1,27,26,0.0,0.00034037918240920387,1,29,28,3,-1,4,8,0,27,93,68
777,0,0,1,1,0,0,0,1,1,0,0,0,1,1,0,0.0,0.0,1,1,0,-1,-1,-1,8,0,30,93,36
778,100,100,80,80,0,100,100,98,98,0,100,100,98,98,0,0.12634875251029648,0.12634875251029648,100,100,0,-1,1,1,2,40,89,3,67
779,100,100,59,59,0,100,100,40,40,0,100,100,59,59,0,0.018312400013615168,0.01855066544130161,81,82,1,3,1,1,15,6,7,26,4
780,56,56,50,50,0,180,180,64,64,0,56,56,50,50,0,0.004186663943633207,0.004186663943633207,53,53,0,-1,2,2,16,2,4,75,80
781,204,804,90,100,10,136,136,81,81,0,136,136,82,82,0,0.021818305592429966,0.03529732121583444,84,93,9,2,2,2,7,16,43,18,30
782,0,0,1,1,0,0,0,1,1,0,0,0,1,1,0,0.0,0.0,1,1,0,-1,-1,-1,10,1,1,45,89
783,146,247,83,92,9,188,188,82,82,0,146,147,83,83,0,0.013513053541645392,0.013581129378127233,74,74,0,5,2,2,10,9,11,27,78
784,14,630,40,100,60,26,50,37,49,12,14,50,40,54,14,0.001497668402600497,0.020695054290479593,42,82,40,2,4,3,5,3,70,43,16
785,128,1768,79,100,21,290,324,83,89,6,128,324,79,97,18,0.008713707069675619,0.02920453385070969,60,90,30,1,2,2,17,6,20,26,18
786,135,751,84,100,16,128,128,90,90,0,128,128,90,90,0,0.01242384015793594,0.02130773681881616,73,85,12,2,2,2,5,8,63,44,32
787,100,100,70,70,0,100,100,73,73,0,100,100,74,74,0,0.059702508594574356,0.0597705844310562,100,100,0,6,1,1,6,30,71,7,78
788,125,226,83,94,11,60,60,53,53,0,60,60,60,60,0,0.014329963579427483,0.014500153170632085,76,78,2,5,3,3,5,15,49,19,55
789,14,220,36,94,58,32,32,35,35,0,14,32,36,49,13,0.0014636304843595766,0.0063650907110521125,41,60,19,3,4,4,6,3,59,43,72
790,221,323,93,98,5,72,72,80,80,0,72,72,80,80,0,0.03359542530378842,0.03451444909629327,91,91,0,4,2,2,3,29,76,0,51
791,0,0,1,1,0,0,0,1,1,0,0,0,1,1,0,0.0,0.0,1,1,0,-1,-1,-1,3,1,94,69,50
792,67,683,58,100,42,88,108,49,65,16,67,108,58,77,19,0.005377991082065421,0.011232513019503728,57,72,15,2,3,3,8,6,30,35,57
793,0,102,1,75,74,0,10,1,28,27,0,2,1,25,24,0.0,0.0002382654276864427,1,32,31,4,-1,5,8,0,21,36,4
794,0,206,1,92,91,0,14,1,33,32,0,14,1,38,37,0.0,0.004935498144933456,1,56,55,3,-1,4,3,0,64,87,34
795,0,1640,1,100,99,0,114,1,64,63,0,114,1,76,75,0.0,0.02566459035365397,1,88,87,1,-1,2,9,0,29,98,12
796,178,178,88,88,0,144,144,91,91,0,144,144,92,92,0,0.02556247659893121,0.02556247659893121,86,86,0,-1,2,2,6,12,51,37,80
797,100,100,64,64,0,100,100,49,49,0,100,100,64,64,0,0.0657952959596991,0.0669525851798904,100,100,0,3,1,1,8,36,42,2,53
798,6,108,32,83,51,12,12,41,41,0,6,12,32,40,8,0.0007828721195411688,0.002757071377514551,36,47,11,4,4,4,2,2,95,42,70
799,88,704,59,100,41,196,196,79,79,0,88,162,59,83,24,0.008441403723748256,0.017052997038701112,61,75,14,2,2,2,12,4,2,72,8
800,96,302,69,97,28,100,100,73,73,0,96,100,72,73,1,0.012049423057285817,0.019810068416215663,70,80,10,3,2,2,6,6,71,34,27
801,0,616,1,100,99,0,44,1,33,32,0,50,1,51,50,0.0,0.00796487286837537,1,62,61,2,-1,3,9,0,29,81,8
802,174,790,87,100,13,184,184,97,97,0,174,184,97,97,0,0.015725518227305217,0.018380475850097007,78,79,1,2,2,2,7,8,62,17,54
803,0,206,1,91,90,0,56,1,33,32,0,56,1,51,50,0.0,0.006092787365124749,1,56,55,3,-1,4,10,0,0,84,32
804,0,206,1,94,93,0,10,1,31,30,0,8,1,36,35,0.0,0.002144388849177984,1,46,45,3,-1,4,3,0,81,86,75
805,0,616,1,99,98,0,82,1,40,39,0,53,1,54,53,0.0,0.010926171755335444,1,70,69,2,-1,3,12,0,14,99,39
806,8,110,37,81,44,24,24,37,37,0,8,12,37,39,2,0.001055175465468532,0.0020422750944552232,39,47,8,4,4,4,4,2,77,74,51
807,138,138,84,84,0,100,100,66,66,0,100,100,72,72,0,0.010041185881071514,0.010041185881071514,68,68,0,-1,2,2,6,9,44,31,87
808,0,102,1,84,83,0,4,1,28,27,0,4,1,31,30,0.0,0.0028591851322373124,1,51,50,4,-1,5,2,0,98,66,28
809,146,352,83,98,15,270,270,78,78,0,146,161,83,84,1,0.0088498587426393,0.012185574730249497,61,69,8,3,2,2,17,8,20,57,73
810,22,22,45,45,0,86,86,57,57,0,22,22,45,45,0,0.004186663943633207,0.004186663943633207,54,54,0,-1,3,3,6,3,44,29,85
811,582,782,100,100,0,368,368,98,98,0,368,368,98,98,0,0.04789135096497498,0.04894652643044351,99,99,0,3,2,2,14,36,17,2,94
812,0,616,1,100,99,0,56,1,46,45,0,56,1,59,58,0.0,0.014840532353041287,1,81,80,2,-1,3,6,0,32,66,18
813,128,128,79,79,0,146,146,80,80,0,128,128,80,80,0,0.008101024541339052,0.008101024541339052,63,63,0,-1,2,2,8,5,10,47,50
814,16,16,32,32,0,124,124,60,60,0,16,16,32,32,0,0.004016474352428605,0.004016474352428605,53,53,0,-1,3,3,14,1,17,90,59
815,60,60,68,68,0,38,38,56,56,0,38,38,57,57,0,0.005650294427992784,0.005650294427992784,55,55,0,-1,3,3,3,5,60,47,81
816,206,412,89,97,8,128,128,67,67,0,128,128,79,79,0,0.01783586915824228,0.018891044623710815,81,81,0,3,3,3,8,16,15,12,51
817,60,60,61,61,0,80,80,70,70,0,60,60,62,62,0,0.010619830491167161,0.010619830491167161,72,72,0,-1,3,3,5,5,45,25,50
818,0,1640,1,100,99,0,82,1,44,43,0,67,1,57,56,0.0,0.01507879778072773,1,78,77,1,-1,2,10,0,11,89,57
819,302,918,100,100,0,72,72,85,85,0,72,72,85,85,0,0.04704040300895197,0.05058034650600769,97,97,0,2,2,2,3,40,94,3,55
820,18,224,44,95,51,42,42,41,41,0,18,24,44,47,3,0.0020422750944552232,0.0026209197045508697,45,48,3,3,3,3,6,2,32,83,88
821,0,206,1,97,96,0,12,1,38,37,0,12,1,43,42,0.0,0.0088498587426393,1,68,67,3,-1,4,2,1,97,45,14
822,102,102,73,73,0,166,166,83,83,0,102,102,73,73,0,0.009462541270975866,0.009462541270975866,68,68,0,-1,2,2,8,7,42,62,59
823,425,1041,99,100,1,168,168,96,96,0,168,168,96,96,0,0.037645937574457944,0.04350045951189625,93,96,3,2,2,2,6,30,40,7,57
824,422,1038,99,100,1,144,144,91,91,0,144,144,92,92,0,0.047993464719697745,0.05235031825453555,99,99,0,2,2,2,6,36,51,2,41
825,231,431,94,100,6,72,72,86,86,0,72,72,86,86,0,0.03761189965621702,0.046189455052928964,92,96,4,3,2,2,3,29,92,0,12
826,56,56,52,52,0,76,76,54,54,0,56,56,52,52,0,0.004595118962524252,0.004595118962524252,50,50,0,-1,2,2,6,2,56,74,36
827,275,1915,94,100,6,246,280,95,99,4,246,280,96,99,3,0.018857006705469893,0.057183702644746245,79,98,19,1,2,2,10,15,22,19,3
828,24,230,48,95,47,28,28,45,45,0,24,28,48,48,0,0.0028591851322373124,0.0061949011198475104,49,56,7,3,3,3,3,6,60,70,35
829,100,100,69,69,0,100,100,66,66,0,100,100,72,72,0,0.02910242009598693,0.05565199632390483,89,99,10,2,1,1,6,4,44,22,0
830,19,120,50,87,37,18,18,47,47,0,18,18,50,50,0,0.0011913271384322134,0.0011913271384322134,38,38,0,6,3,3,2,4,95,64,78
831,0,1640,1,100,99,0,90,1,43,42,0,70,1,57,56,0.0,0.016542428265087308,1,77,76,1,-1,2,9,0,29,98,26
832,37,137,60,92,32,12,12,39,39,0,12,12,44,44,0,0.007760645358929848,0.00793083495013445,65,65,0,5,4,4,2,9,97,31,56
833,1,617,25,100,75,2,22,25,41,16,1,22,25,44,19,3.4037918240920386e-05,0.027638789611627353,26,89,63,2,6,3,2,2,91,58,2
834,124,124,78,78,0,130,130,80,80,0,124,124,80,80,0,0.0088498587426393,0.0088498587426393,64,64,0,-1,2,2,7,6,43,13,85
835,0,0,1,1,0,0,0,1,1,0,0,0,1,1,0,0.0,0.0,1,1,0,-1,-1,-1,15,0,7,82,67
836,0,102,1,79,78,0,6,1,28,27,0,4,1,30,29,0.0,0.001055175465468532,1,35,34,4,-1,5,3,0,94,66,52
837,2,104,28,83,55,4,5,28,28,0,2,5,28,30,2,3.4037918240920386e-05,0.0009530617107457708,26,38,12,4,5,5,3,1,55,95,64
838,100,100,60,60,0,100,100,50,50,0,100,100,60,60,0,0.029647026787841656,0.05956635692161068,91,99,8,2,1,1,9,8,28,20,3
839,166,372,84,96,12,136,136,77,77,0,136,136,83,83,0,0.01592974573675074,0.026107083290785937,77,87,10,3,2,2,7,13,24,33,6
840,0,206,1,89,88,0,28,1,33,32,0,28,1,43,42,0.0,0.006773545729943157,1,57,56,3,-1,4,6,1,71,69,77
841,0,0,1,1,0,0,0,1,1,0,0,0,1,1,0,0.0,0.0,1,1,0,-1,-1,-1,5,0,52,85,84
842,0,616,1,100,99,0,78,1,46,45,0,78,1,62,61,0.0,0.01844855168657885,1,81,80,2,-1,3,8,0,57,66,16
843,409,509,100,100,0,136,136,99,99,0,136,136,99,99,0,0.05439259334899078,0.05439259334899078,98,98,0,5,2,2,4,36,84,2,65
844,6,6,29,29,0,42,42,31,31,0,6,6,29,29,0,0.00017018959120460194,0.00017018959120460194,31,31,0,-1,4,4,14,1,16,65,80
845,66,272,68,98,30,44,44,59,59,0,44,44,63,63,0,0.007828721195411689,0.009530617107457708,66,67,1,3,3,3,4,7,72,21,51
846,56,1696,61,100,39,118,142,69,78,9,56,142,61,84,23,0.005207801490860819,0.028625889240614044,57,87,30,1,3,2,8,6,57,28,19
847,56,262,52,94,42,76,80,54,60,6,56,80,52,66,14,0.005548180673270023,0.018176248340651485,53,81,28,3,2,2,6,2,56,75,12
848,52,258,58,97,39,48,48,67,67,0,48,48,70,70,0,0.008986010415602982,0.010517716736444398,66,74,8,3,3,3,3,5,96,25,61
849,6,212,31,95,64,14,18,32,34,2,6,18,31,45,14,0.00030634126416828345,0.007284114503556962,31,63,32,3,4,4,3,1,94,65,20
850,0,616,1,100,99,0,30,1,44,43,0,26,1,54,53,0.0,0.006297014874570271,1,59,58,2,-1,3,4,0,77,92,72
851,0,0,1,1,0,0,0,1,1,0,0,0,1,1,0,0.0,0.0,1,1,0,-1,-1,-1,4,0,47,93,97
852,46,46,52,52,0,110,110,57,57,0,46,46,52,52,0,0.0013274788113958951,0.0013274788113958951,39,39,0,-1,2,2,16,2,9,63,93
853,2,2,28,28,0,4,4,30,30,0,2,2,28,28,0,0.0002723033459273631,0.0002723033459273631,31,31,0,-1,5,5,2,1,68,55,85
854,0,616,1,100,99,0,52,1,40,39,0,52,1,52,51,0.0,0.01147077844719017,1,72,71,2,-1,3,6,0,40,91,19
855,46,662,48,100,52,120,170,61,72,11,46,170,48,86,38,0.003165526396405596,0.03175737771877872,48,91,43,2,2,2,11,2,33,52,3
856,16,16,43,43,0,30,30,43,43,0,16,16,43,43,0,0.0006467204465774873,0.0006467204465774873,36,36,0,-1,3,3,4,1,47,49,87
857,118,324,77,98,21,272,272,87,87,0,118,128,77,79,2,0.010517716736444398,0.011640968038394772,67,71,4,3,2,2,14,5,8,25,54
858,0,1640,1,100,99,0,178,1,68,67,0,178,1,84,83,0.0,0.03100854351747847,1,92,91,1,-1,2,14,0,25,85,1
859,6,212,29,89,60,52,52,35,35,0,6,16,29,34,5,0.0008169100377820892,0.0020422750944552232,36,43,7,3,4,4,10,2,18,42,64
860,87,87,65,65,0,66,66,47,47,0,66,66,55,55,0,0.006433166547533953,0.006433166547533953,55,55,0,-1,3,3,6,8,71,57,66
861,0,206,1,87,86,0,42,1,30,29,0,6,1,28,27,0.0,0.0007147962830593281,1,35,34,3,-1,4,14,0,16,80,71
862,42,1682,52,100,48,118,170,62,68,6,42,170,53,86,33,0.0014636304843595766,0.01865277919602437,41,82,41,1,2,2,12,2,14,56,19
863,0,0,1,1,0,0,0,1,1,0,0,0,1,1,0,0.0,0.0,1,1,0,-1,-1,-1,3,0,60,59,36
864,125,741,88,100,12,46,46,82,82,0,46,46,82,82,0,0.019639878825011062,0.04190067735457299,83,97,14,2,2,2,2,17,95,6,1
865,255,871,95,100,5,288,288,95,95,0,288,288,95,95,0,0.017393376221110316,0.0265495762279179,80,89,9,2,2,2,12,15,6,19,33
866,100,100,66,66,0,100,100,52,52,0,100,100,66,66,0,0.040505122706695255,0.041253956907995507,94,95,1,3,1,1,8,16,15,18,74
867,1,617,26,100,74,4,30,26,42,16,1,30,26,50,24,6.807583648184077e-05,0.007386228258279724,27,63,36,2,6,3,4,1,73,68,38
868,97,97,79,79,0,32,32,64,64,0,32,32,64,64,0,0.013819394805813677,0.013819394805813677,76,76,0,-1,3,3,2,15,89,19,40
869,82,82,61,61,0,66,66,47,47,0,66,66,55,55,0,0.008373327887266415,0.008373327887266415,63,63,0,-1,3,3,6,7,71,48,36
870,22,22,40,40,0,46,46,38,38,0,22,22,40,40,0,0.003437829742332959,0.003437829742332959,44,44,0,-1,3,3,6,2,71,83,99
871,100,100,63,63,0,100,100,47,47,0,100,100,63,63,0,0.024200959869294394,0.03642057251778481,85,95,10,2,1,1,10,13,22,24,5
872,2,104,27,82,55,6,6,29,29,0,2,5,27,30,3,0.0002042275094455223,0.00034037918240920387,31,33,2,4,5,5,3,1,66,65,63
873,35,651,50,100,50,96,116,43,61,18,35,67,50,55,5,0.004220701861874128,0.0068075836481840775,54,59,5,2,3,3,11,6,19,73,70
874,18,634,40,100,60,62,76,36,38,2,18,82,40,58,18,0.0011913271384322134,0.010245413390517035,38,69,31,2,3,3,10,2,36,74,27
875,6,6,31,31,0,8,8,33,33,0,6,6,31,31,0,0.0025188059498281084,0.0025188059498281084,46,46,0,-1,4,4,2,3,99,46,89
876,42,242,62,100,38,22,22,55,55,0,22,22,57,57,0,0.008441403723748256,0.02226079852956193,67,85,18,3,3,3,2,7,97,21,9
877,0,102,1,77,76,0,10,1,26,25,0,2,1,25,24,0.0,0.00013615167296368154,1,29,28,4,-1,5,8,0,30,98,60
878,0,616,1,100,99,0,84,1,41,40,0,84,1,57,56,0.0,0.014874570271282209,1,76,75,2,-1,3,9,0,29,82,16
879,0,616,1,100,99,0,38,1,35,34,0,38,1,46,45,0.0,0.006399128629293032,1,57,56,2,-1,3,6,0,56,36,44
880,0,206,1,96,95,0,8,1,31,30,0,8,1,37,36,0.0,0.0048674223084516155,1,57,56,3,-1,4,2,0,98,36,44
881,36,137,53,88,35,28,28,43,43,0,28,28,50,50,0,0.0038462847612240037,0.003880322679464924,52,52,0,6,3,3,3,6,66,41,58
882,22,228,40,92,52,66,66,47,47,0,22,30,40,43,3,0.0035059055788147996,0.0048674223084516155,46,51,5,3,3,3,6,3,71,29,52
883,0,616,1,100,99,0,76,1,40,39,0,56,1,53,52,0.0,0.004663194799006093,1,55,54,2,-1,3,10,0,1,99,13
884,68,169,65,90,25,64,64,64,64,0,64,64,67,67,0,0.010517716736444398,0.01055175465468532,70,70,0,6,3,3,4,8,77,17,68
885,100,100,63,63,0,100,100,39,39,0,100,100,63,63,0,0.054222403757786176,0.06708873685285408,100,100,0,1,1,1,14,40,17,3,33
886,0,0,1,1,0,0,0,1,1,0,0,0,1,1,0,0.0,0.0,1,1,0,-1,-1,-1,6,0,40,87,81
887,20,20,46,46,0,34,34,43,43,0,20,20,46,46,0,0.0011232513019503727,0.0011232513019503727,39,39,0,-1,3,3,4,3,79,43,82
888,0,616,1,100,99,0,42,1,39,38,0,42,1,53,52,0.0,0.010041185881071514,1,67,66,2,-1,3,6,0,74,98,14
889,94,300,79,99,20,48,48,73,73,0,48,48,75,75,0,0.014772456516559448,0.01940161339732462,77,82,5,3,3,3,3,13,92,33,72
890,22,124,47,81,34,34,34,43,43,0,22,25,47,49,2,0.001157289220191293,0.0026889955410327104,40,47,7,4,3,3,4,2,79,74,83
891,0,0,1,1,0,0,0,1,1,0,0,0,1,1,0,0.0,0.0,1,1,0,-1,-1,-1,8,0,42,98,69
892,232,848,93,100,7,176,176,85,85,0,176,176,89,89,0,0.02209060893835733,0.02736648626569999,84,88,4,2,2,2,8,17,30,6,57
893,76,282,70,95,25,48,48,66,66,0,48,48,67,67,0,0.008271214132543654,0.009292351679771264,66,68,2,3,3,3,3,7,76,21,43
894,208,208,89,89,0,202,202,87,87,0,208,208,90,90,0,0.012287688484972258,0.012287688484972258,72,72,0,-1,2,2,10,13,11,24,82
895,331,331,99,99,0,96,96,93,93,0,96,96,93,93,0,0.04571292419755608,0.04571292419755608,96,96,0,-1,2,2,3,40,66,3,97
896,40,40,51,51,0,92,92,51,51,0,40,40,51,51,0,0.0053099152455835805,0.0053099152455835805,56,56,0,-1,2,2,8,1,30,90,66
897,0,616,1,100,99,0,92,1,40,39,0,92,1,60,59,0.0,0.01606589740971442,1,75,74,2,-1,3,12,0,2,93,16
898,46,46,51,51,0,84,84,59,59,0,46,46,51,51,0,0.003369753905851118,0.003369753905851118,50,50,0,-1,2,2,5,2,52,61,59
899,0,616,1,100,99,0,28,1,44,43,0,28,1,51,50,0.0,0.024064808196330712,1,91,90,2,-1,3,3,0,94,89,7
900,100,100,61,61,0,100,100,40,40,0,100,100,61,61,0,0.04738078219136117,0.060587494468838286,98,100,2,2,1,1,14,30,8,7,18
901,40,246,52,96,44,62,62,82,82,0,40,62,72,83,11,0.007318152421797883,0.013376901868681712,62,77,15,3,2,2,3,3,60,46,27
902,88,294,61,93,32,196,196,77,77,0,88,100,61,61,0,0.008373327887266415,0.010449640899962559,66,71,5,3,2,2,12,7,3,62,83
903,6,622,29,100,71,15,42,29,38,9,6,42,29,50,21,0.00017018959120460194,0.006773545729943157,31,62,31,2,4,3,6,1,59,55,44
904,40,142,61,93,32,22,22,55,55,0,22,22,57,57,0,0.005548180673270023,0.006705469893461316,58,62,4,4,3,3,2,6,97,41,61
905,16,16,40,40,0,46,46,46,46,0,16,16,40,40,0,0.0035059055788147996,0.0035059055788147996,49,49,0,-1,3,3,5,1,88,90,79
906,2,208,29,97,68,3,12,29,38,9,2,12,29,43,14,0.0002382654276864427,0.00796487286837537,33,66,33,3,5,4,2,1,97,55,17
907,100,100,69,69,0,100,100,55,55,0,100,100,69,69,0,0.03179141563701964,0.042070866945777594,91,95,4,2,1,1,8,8,30,17,39
908,0,206,1,90,89,0,14,1,29,28,0,8,1,34,33,0.0,0.0008509479560230097,1,38,37,3,-1,4,6,0,74,76,51
909,258,874,94,100,6,250,260,89,92,3,250,260,93,94,1,0.019810068416215663,0.03182545355526056,81,91,10,2,2,2,13,16,13,12,37
910,70,276,63,96,33,108,108,69,69,0,70,76,63,64,1,0.005820484019197386,0.00888389666088022,59,68,9,3,3,3,8,5,39,47,90
911,260,260,94,94,0,224,224,98,98,0,224,224,98,98,0,0.021648116001225366,0.021648116001225366,84,84,0,-1,2,2,8,18,10,5,79
912,6,212,32,94,62,10,14,32,36,4,6,14,32,42,10,0.0002382654276864427,0.003812246842983083,31,51,20,3,4,4,3,1,81,65,47
913,166,267,84,93,9,134,134,89,89,0,134,134,90,90,0,0.014908608189523128,0.014908608189523128,76,76,0,5,2,2,6,13,41,33,58
914,277,877,96,100,4,192,192,99,99,0,192,192,99,99,0,0.03226794649239253,0.05592429966983219,92,98,6,2,2,2,6,15,65,16,7
915,6,1646,32,100,68,28,90,36,70,34,6,79,32,67,35,0.00088498587426393,0.027128220838013545,39,88,49,1,4,2,6,1,69,71,73
916,100,100,59,59,0,100,100,40,40,0,100,100,59,59,0,0.03478675244222063,0.03478675244222063,93,93,0,-1,1,1,15,15,7,16,80
917,100,100,58,58,0,100,100,38,38,0,100,100,58,58,0,0.05905578814799687,0.06885870860138193,100,100,0,1,1,1,16,36,9,2,57
918,150,150,83,83,0,144,144,88,88,0,144,144,89,89,0,0.014806494434800367,0.014806494434800367,75,75,0,-1,2,2,6,8,34,17,81
919,112,318,76,96,20,86,86,56,56,0,86,86,62,62,0,0.011606930120153852,0.011879233466081215,70,70,0,3,3,3,6,8,51,17,65
920,66,66,64,64,0,48,48,60,60,0,48,48,63,63,0,0.011164437183021887,0.011164437183021887,68,68,0,-1,3,3,3,5,58,25,86
921,30,30,48,48,0,36,36,36,36,0,30,30,48,48,0,0.003914360597705844,0.003914360597705844,49,49,0,-1,3,3,5,6,50,73,85
922,56,56,61,61,0,48,48,59,59,0,48,48,63,63,0,0.006399128629293032,0.006399128629293032,59,59,0,-1,3,3,3,6,75,13,87
923,0,616,1,100,99,0,46,1,30,29,0,16,1,31,30,0.0,0.0013274788113958951,1,40,39,2,-1,3,14,0,8,93,71
924,71,71,56,56,0,110,110,61,61,0,71,71,56,56,0,0.005854521937438306,0.005854521937438306,58,58,0,-1,2,2,11,6,19,35,97
925,0,616,1,100,99,0,68,1,39,38,0,54,1,55,54,0.0,0.008986010415602982,1,65,64,2,-1,3,10,0,11,67,20
926,0,616,1,100,99,0,78,1,43,42,0,78,1,57,56,0.0,0.0228734810578985,1,87,86,2,-1,3,8,1,27,50,7
927,86,702,60,100,40,142,152,66,69,3,86,152,60,85,25,0.009122162088566664,0.02219272269308009,69,81,12,2,3,3,12,6,3,34,30
928,0,102,1,80,79,0,5,1,26,25,0,2,1,26,25,0.0,3.4037918240920386e-05,1,27,26,4,-1,5,3,0,87,92,95
929,0,206,1,92,91,0,12,1,33,32,0,12,1,39,38,0.0,0.004901460226692535,1,56,55,3,-1,4,4,1,77,50,48
930,22,22,40,40,0,70,70,35,35,0,22,22,40,40,0,0.0017018959120460194,0.0017018959120460194,41,41,0,-1,3,3,12,3,3,51,66
931,8,624,35,100,65,20,38,32,40,8,8,26,35,47,12,0.0008169100377820892,0.006671431975220395,38,57,19,2,4,3,6,2,69,74,83
932,244,860,97,100,3,96,96,90,90,0,96,96,90,90,0,0.033935804486197624,0.03955206099594949,94,95,1,2,2,2,3,22,75,9,90
933,100,100,63,63,0,100,100,47,47,0,100,100,63,63,0,0.025119983661799246,0.025119983661799246,86,86,0,-1,1,1,10,9,22,31,91
934,94,300,64,96,32,152,152,76,76,0,94,100,64,65,1,0.006943735321147759,0.007692569522448007,60,61,1,3,2,2,8,5,15,47,71
935,0,0,1,1,0,0,0,1,1,0,0,0,1,1,0,0.0,0.0,1,1,0,-1,-1,-1,11,1,5,45,86
936,2,208,29,90,61,14,46,29,38,9,2,46,29,51,22,0.00013615167296368154,0.011845195547840293,30,71,41,3,5,4,9,1,26,65,12
937,98,200,81,96,15,32,32,63,63,0,32,32,65,65,0,0.017018959120460194,0.017801831240001363,82,83,1,4,3,3,2,12,98,37,74
938,16,632,34,100,66,76,98,38,41,3,16,62,34,54,20,0.0007488342013002485,0.004799346471969774,37,54,17,2,3,3,12,1,2,49,13
939,0,102,1,76,75,0,13,1,26,25,0,2,1,26,25,0.0,0.0002042275094455223,1,31,30,4,-1,5,11,0,38,59,55
940,292,1932,95,100,5,252,286,94,97,3,252,286,94,97,3,0.02294155689438034,0.049218829776370876,86,98,12,1,2,2,11,16,19,12,9
941,91,707,72,100,28,48,48,60,60,0,48,48,63,63,0,0.012525953912658701,0.027808979202831954,72,90,18,2,3,3,3,13,58,33,16
942,136,136,79,79,0,216,216,93,93,0,136,136,80,80,0,0.011368664692467409,0.011368664692467409,73,73,0,-1,2,2,9,7,28,62,96
943,1,103,23,79,56,4,5,23,24,1,1,3,23,26,3,0.00010211375472276115,0.00030634126416828345,27,28,1,4,6,5,4,1,67,78,88
944,234,440,93,100,7,156,156,87,87,0,156,156,89,89,0,0.022499063957248374,0.023418087749753225,85,85,0,3,2,2,8,16,21,12,74
945,54,654,52,100,48,134,134,69,69,0,54,134,52,80,28,0.006909697402906838,0.025902855781340415,59,86,27,2,3,3,9,4,54,72,7
946,134,134,82,82,0,272,272,87,87,0,134,134,82,82,0,0.011640968038394772,0.011640968038394772,71,71,0,-1,2,2,14,6,8,77,79
947,150,356,86,97,11,240,240,89,89,0,150,158,86,87,1,0.01412573606998196,0.01507879778072773,73,76,3,3,2,2,12,8,6,17,51
948,276,482,93,98,5,248,248,89,89,0,248,248,92,92,0,0.019707954661492902,0.020558902617515914,83,84,1,3,2,2,11,17,5,6,43
949,100,100,62,62,0,100,100,45,45,0,100,100,62,62,0,0.042683549474114166,0.055958337588073115,96,100,4,2,1,1,12,20,3,23,15
950,0,102,1,77,76,0,10,1,26,25,0,2,1,25,24,0.0,3.4037918240920386e-05,1,26,25,4,-1,5,8,0,30,79,95
951,0,0,1,1,0,0,0,1,1,0,0,0,1,1,0,0.0,0.0,1,1,0,-1,-1,-1,2,0,93,81,82
952,2,208,26,87,61,16,49,26,32,6,2,8,26,32,6,3.4037918240920386e-05,0.0018720855032506212,26,42,16,3,5,4,15,1,7,78,94
953,100,100,63,63,0,100,100,47,47,0,100,100,63,63,0,0.05262262160046292,0.05262262160046292,98,98,0,-1,1,1,10,29,22,1,66
954,100,100,63,63,0,100,100,39,39,0,100,100,63,63,0,0.021137547227611558,0.022499063957248374,83,84,1,3,1,1,14,9,17,27,61
955,332,538,97,100,3,168,168,98,98,0,168,168,98,98,0,0.03761189965621702,0.038564961366962795,95,95,0,3,2,2,6,29,34,0,64
956,214,420,93,97,4,150,150,85,85,0,150,150,89,89,0,0.025766704108376733,0.03100854351747847,89,90,1,3,2,2,7,15,46,16,27
957,100,100,59,59,0,100,100,45,45,0,100,100,59,59,0,0.05262262160046292,0.05919193982096055,98,98,0,2,1,1,10,30,0,7,48
958,6,212,34,97,63,12,12,39,39,0,6,12,34,43,9,0.0020422750944552232,0.012764219340345145,45,76,31,3,4,4,2,2,97,94,18
959,166,268,95,100,5,32,32,67,67,0,32,32,68,68,0,0.03185949147350148,0.03185949147350148,94,94,0,4,3,3,2,29,97,0,4
960,100,306,65,93,28,104,104,81,81,0,104,104,84,84,0,0.00803294870485721,0.009054086252084823,64,65,1,3,2,2,5,6,61,13,83
961,0,616,1,100,99,0,86,1,38,37,0,52,1,50,49,0.0,0.007794683277170768,1,62,61,2,-1,3,14,0,25,40,17
962,376,376,98,98,0,270,270,99,99,0,270,270,99,99,0,0.03114469519044215,0.03114469519044215,89,89,0,-1,2,2,10,22,36,9,97
963,0,206,1,90,89,0,11,1,27,26,0,6,1,27,26,0.0,0.0005446066918547262,1,34,33,3,-1,4,5,0,50,84,88
964,198,198,91,91,0,248,248,90,90,0,198,198,90,90,0,0.019095272133156337,0.019095272133156337,80,80,0,-1,2,2,11,12,38,37,45
965,100,100,69,69,0,100,100,57,57,0,100,100,69,69,0,0.05395010041185881,0.05721774056298717,98,99,1,3,1,1,8,29,57,1,90
966,16,118,35,78,43,90,90,43,43,0,16,18,35,40,5,0.0011232513019503727,0.0011913271384322134,40,40,0,4,3,3,10,1,1,71,4
967,100,100,63,63,0,100,100,39,39,0,100,100,63,63,0,0.018176248340651485,0.018176248340651485,78,78,0,-1,1,1,14,8,17,44,81
968,0,616,1,99,98,0,70,1,36,35,0,38,1,44,43,0.0,0.004901460226692535,1,54,53,2,-1,3,11,0,33,66,26
969,1,103,26,78,52,4,7,26,28,2,1,5,26,32,6,3.4037918240920386e-05,0.0015317063208414173,26,43,17,4,6,5,4,1,47,78,83
970,1,207,26,92,66,7,17,26,31,5,1,9,26,33,7,0.0,0.0009190237925048504,1,38,37,3,6,4,7,1,46,68,74
971,24,230,50,98,48,32,32,64,64,0,32,32,64,64,0,0.002723033459273631,0.005037611899656217,47,57,10,3,3,3,2,3,89,54,94
972,0,206,1,96,95,0,7,1,30,29,0,7,1,37,36,0.0,0.0009870996289866913,1,36,35,3,-1,4,2,1,99,69,61
973,200,301,88,97,9,304,304,87,87,0,200,201,88,88,0,0.01415977398822288,0.0141938119064638,73,73,0,5,2,2,17,8,20,8,68
974,0,0,1,1,0,0,0,1,1,0,0,0,1,1,0,0.0,0.0,1,1,0,-1,-1,-1,16,0,4,93,99
975,6,212,32,93,61,10,18,32,35,3,6,18,32,46,14,0.00030634126416828345,0.01317267435923619,33,75,42,3,4,4,3,1,64,65,37
976,0,616,1,100,99,0,46,1,33,32,0,16,1,34,33,0.0,0.0027911092957554717,1,48,47,2,-1,3,10,0,12,91,46
977,307,409,97,100,3,104,104,86,86,0,104,104,86,86,0,0.03311889444841554,0.03461656285101603,91,93,2,4,2,2,5,29,45,1,75
978,0,0,1,1,0,0,0,1,1,0,0,0,1,1,0,0.0,0.0,1,1,0,-1,-1,-1,11,0,19,98,99
979,84,700,64,100,36,104,104,80,80,0,84,104,71,80,9,0.009394465434494027,0.021818305592429966,68,86,18,2,2,2,5,6,63,26,6
980,112,728,77,100,23,264,294,81,86,5,112,294,77,95,18,0.009122162088566664,0.03264236359304265,65,92,27,2,2,2,16,7,4,62,10
981,0,206,1,91,90,0,16,1,30,29,0,6,1,30,29,0.0,0.0006807583648184077,1,37,36,3,-1,4,7,1,62,69,42
982,82,184,76,93,17,32,32,69,69,0,32,32,69,69,0,0.012832295176826986,0.01324075019571803,75,78,3,4,3,3,2,8,90,20,88
983,16,222,35,93,58,21,34,34,38,4,16,34,35,45,10,0.0004765308553728854,0.013581129378127233,32,74,42,3,3,3,4,1,67,60,6
984,0,102,1,83,82,0,3,1,28,27,0,2,1,28,27,0.0,0.000442492937131965,1,35,34,4,-1,5,2,0,90,99,88
985,226,432,92,96,4,246,246,87,87,0,226,246,91,92,1,0.019129310051397258,0.020082371762143027,80,81,1,3,2,2,13,18,13,30,71
986,64,166,62,88,26,54,54,52,52,0,64,54,63,55,-8,0.007862759113652609,0.008169100377820893,64,65,1,4,3,3,4,4,83,38,63
987,0,0,1,1,0,0,0,1,1,0,0,0,1,1,0,0.0,0.0,1,1,0,-1,-1,-1,10,0,12,89,93
988,16,222,39,93,54,38,38,51,51,0,16,38,39,53,14,0.0024507301133462676,0.008543517478471017,48,67,19,3,3,3,3,1,82,53,77
989,100,100,65,65,0,100,100,45,45,0,100,100,65,65,0,0.027094182919772627,0.04465774873208755,91,94,3,1,1,1,10,9,12,27,77
990,39,39,53,53,0,60,60,51,51,0,39,39,52,52,0,0.0045270431260424114,0.0045270431260424114,56,56,0,-1,3,3,5,4,80,22,82
991,52,153,61,89,28,48,48,65,65,0,48,48,68,68,0,0.009598692943939549,0.00966676878042139,71,71,0,6,3,3,3,5,66,25,68
992,0,206,1,90,89,0,32,1,33,32,0,32,1,40,39,0.0,0.006943735321147759,1,57,56,3,-1,4,6,0,51,82,44
993,28,234,49,93,44,72,72,49,49,0,28,36,49,50,1,0.0012253650566731338,0.0026549576227917903,40,47,7,3,3,3,7,4,62,64,83
994,158,364,84,98,14,246,246,74,74,0,158,166,84,84,0,0.009394465434494027,0.00980292045338507,65,65,0,3,2,2,17,9,20,31,63
995,101,1741,70,100,30,138,172,69,80,11,101,172,70,87,17,0.007658531604207087,0.025154021580040164,62,88,26,1,2,2,9,8,28,57,20
996,164,370,89,99,10,96,96,90,90,0,96,96,90,90,0,0.02831954797644576,0.03597807958065285,90,92,2,3,2,2,3,16,82,18,8
997,12,1652,35,100,65,28,80,35,57,22,12,80,35,61,26,0.0008509479560230097,0.03281255318424725,38,91,53,1,4,2,6,2,41,74,18
998,58,58,62,62,0,54,54,60,60,0,54,54,62,62,0,0.00980292045338507,0.00980292045338507,69,69,0,-1,3,3,4,6,78,77,93
999,102,308,81,98,17,62,62,80,80,0,62,62,80,80,0,0.01494264610776405,0.023418087749753225,78,88,10,3,2,2,3,13,55,33,14
