,FreeNet_pre_score,FreeNet_post_score,FreeNet_pre_rank,FreeNet_post_rank,FreeNet_delta_ranks,Reversed_pre_score,Reversed_post_score,Reversed_pre_rank,Reversed_post_rank,Reversed_delta_ranks,Independent_pre_score,Independent_post_score,Independent_pre_rank,Independent_post_rank,Independent_delta_ranks,Random_pre_score,Random_post_score,Random_pre_rank,Random_post_rank,Random_delta_ranks,dist_victim_relayer,dist_victim_vilain_pre,dist_victim_vilain_post,out_deg_victim,in_deg_villain,victim,villain,relayer
0,96,196,62,88,26,118,118,71,71,0,96,98,63,63,0,0.010449640899962559,0.01058579257292624,69,70,1,4,2,2,8,6,10,34,63
1,0,616,1,100,99,0,46,1,33,32,0,22,1,42,41,0.0,0.0038462847612240037,1,49,48,2,-1,3,10,0,12,81,75
2,0,616,1,100,99,0,26,1,37,36,0,16,1,37,36,0.0,0.005207801490860819,1,55,54,2,-1,3,4,1,53,50,90
3,100,100,58,58,0,100,100,35,35,0,100,100,59,59,0,0.027843017121072875,0.027843017121072875,89,89,0,-1,1,1,17,18,20,5,50
4,44,660,56,100,44,64,64,64,64,0,44,64,58,66,8,0.007182000748834201,0.022430988120766535,61,85,24,2,3,3,4,7,77,62,23
5,6,212,30,92,62,36,36,36,36,0,6,36,30,50,20,0.002382654276864427,0.007828721195411689,44,63,19,3,4,4,6,3,65,46,21
6,100,100,67,67,0,100,100,66,66,0,100,100,72,72,0,0.06719085060757685,0.06719085060757685,99,99,0,-1,1,1,6,40,59,3,86
7,16,616,40,100,60,28,28,45,45,0,16,28,40,51,11,0.002314578440382586,0.024371149460498995,46,91,45,2,3,3,3,1,94,53,7
8,92,92,64,64,0,114,114,67,67,0,92,92,64,64,0,0.00789679703189353,0.00789679703189353,63,63,0,-1,3,3,9,7,35,48,80
9,255,871,95,100,5,288,288,95,95,0,288,288,95,95,0,0.017393376221110316,0.021239660982334322,80,83,3,2,2,2,12,15,6,19,28
10,0,101,1,74,73,0,8,1,25,24,0,1,1,25,24,0.0,3.4037918240920386e-05,1,26,25,5,-1,6,8,0,10,99,58
11,47,663,56,100,44,66,66,54,54,0,47,66,56,61,5,0.005820484019197386,0.017972020831205963,54,79,25,2,3,3,6,6,69,35,5
12,16,16,40,40,0,28,28,45,45,0,16,16,40,40,0,0.002314578440382586,0.002314578440382586,46,46,0,-1,3,3,3,1,94,53,80
13,0,206,1,93,92,0,12,1,35,34,0,12,1,36,35,0.0,0.006671431975220395,1,58,57,3,-1,4,2,0,68,80,44
14,44,1688,60,100,40,12,46,37,80,43,12,46,41,81,40,0.009156200006807584,0.06314033833690731,69,98,29,1,4,2,2,8,89,8,62
15,0,1640,1,100,99,0,148,1,70,69,0,148,1,84,83,0.0,0.038394771775758195,1,93,92,1,-1,2,9,0,28,67,2
16,6,622,29,100,71,29,53,31,34,3,6,30,29,45,16,0.0002042275094455223,0.0030634126416828346,31,49,18,2,4,3,12,1,3,65,41
17,16,16,38,38,0,114,114,61,61,0,16,16,38,38,0,0.0020422750944552232,0.0020422750944552232,43,43,0,-1,3,3,9,1,54,53,87
18,90,90,74,74,0,56,56,76,76,0,56,56,77,77,0,0.014023622315259198,0.014023622315259198,78,78,0,-1,2,2,2,7,68,21,50
19,100,100,59,59,0,100,100,45,45,0,100,100,59,59,0,0.03761189965621702,0.03778208924742163,95,95,0,3,1,1,10,20,0,23,56
20,40,656,44,100,56,168,178,68,69,1,40,84,44,56,12,0.002484768031587188,0.008169100377820893,47,63,16,2,2,2,14,1,8,53,72
21,76,76,69,69,0,38,38,57,57,0,38,38,59,59,0,0.008101024541339052,0.008101024541339052,62,62,0,-1,3,3,3,13,55,24,89
22,2,2,27,27,0,7,7,27,27,0,2,2,27,27,0,0.00010211375472276115,0.00010211375472276115,29,29,0,-1,5,5,6,1,41,68,81
23,210,416,89,97,8,182,182,83,83,0,182,182,86,86,0,0.014023622315259198,0.014772456516559448,75,75,0,3,2,2,9,14,54,14,71
24,144,144,82,82,0,112,112,92,92,0,112,112,92,92,0,0.012049423057285817,0.012049423057285817,72,72,0,-1,2,2,4,6,83,13,69
25,214,830,93,100,7,150,150,85,85,0,150,150,89,89,0,0.025766704108376733,0.035569624561761805,89,91,2,2,2,2,7,15,46,16,20
26,0,102,1,74,73,0,16,1,25,24,0,2,1,25,24,0.0,6.807583648184077e-05,1,26,25,4,-1,5,15,0,7,84,55
27,32,134,47,81,34,94,94,51,51,0,32,36,47,50,3,0.004629156880765172,0.00622893903808843,52,57,5,4,3,3,9,3,26,29,75
28,0,206,1,92,91,0,14,1,35,34,0,14,1,42,41,0.0,0.00442492937131965,1,54,53,3,-1,4,3,1,85,50,57
29,0,0,1,1,0,0,0,1,1,0,0,0,1,1,0,0.0,0.0,1,1,0,-1,-1,-1,6,1,74,50,85
30,0,0,1,1,0,0,0,1,1,0,0,0,1,1,0,0.0,0.0,1,1,0,-1,-1,-1,6,0,69,85,81
31,62,268,54,93,39,92,92,51,51,0,62,68,55,55,0,0.00439089145307873,0.005888559855679227,50,56,6,3,2,2,8,3,27,43,53
32,98,98,74,74,0,48,48,65,65,0,48,48,68,68,0,0.012662105585622384,0.012662105585622384,77,77,0,-1,3,3,3,9,66,27,99
33,0,616,1,100,99,0,94,1,36,35,0,34,1,44,43,0.0,0.005548180673270023,1,55,54,2,-1,3,16,0,9,59,62
34,101,717,78,100,22,100,110,68,79,11,100,110,73,82,9,0.008101024541339052,0.038564961366962795,65,93,28,2,2,2,6,8,48,57,3
35,329,431,99,100,1,56,56,76,76,0,56,56,77,77,0,0.04765308553728854,0.049389019367575476,97,97,0,4,2,2,2,36,68,2,75
36,14,220,43,93,50,18,18,38,38,0,14,18,43,46,3,0.002552843868069029,0.021682153919466287,47,85,38,3,4,4,3,6,85,70,11
37,266,1866,97,100,3,288,288,95,95,0,288,288,95,95,0,0.022839443139657578,0.03638653459954389,84,92,8,1,2,2,12,16,6,18,21
38,42,1682,51,100,49,94,138,45,74,29,40,138,47,85,38,0.004152626025392287,0.04053916062493618,51,96,45,1,3,2,9,6,29,41,7
39,26,642,56,100,44,12,22,35,51,16,12,22,42,54,12,0.0045270431260424114,0.021035433472888797,55,86,31,2,4,3,2,6,98,28,12
40,278,278,96,96,0,224,224,98,98,0,224,224,98,98,0,0.027264372510977228,0.027264372510977228,88,88,0,-1,2,2,8,15,10,16,82
41,149,251,90,95,5,62,62,82,82,0,62,62,82,82,0,0.02209060893835733,0.022703291466693896,86,87,1,4,2,2,3,15,92,19,74
42,6,212,30,94,64,23,32,32,36,4,6,32,30,49,19,0.0002042275094455223,0.00445896728956057,31,54,23,3,4,4,6,1,34,65,57
43,0,206,1,91,90,0,12,1,27,26,0,6,1,26,25,0.0,0.0013955546478777359,1,37,36,3,-1,4,4,0,67,36,94
44,6,212,32,93,61,8,8,32,32,0,6,12,32,36,4,0.00030634126416828345,0.002144388849177984,33,46,13,3,4,4,2,1,68,4,46
45,6,622,32,100,68,18,38,35,55,20,6,38,32,58,26,0.0016338200755641784,0.018993158378433576,43,84,41,2,4,3,3,1,58,53,12
46,104,104,71,71,0,148,148,71,71,0,104,104,71,71,0,0.00704584907587052,0.00704584907587052,61,61,0,-1,2,2,9,6,28,26,82
47,0,0,1,1,0,0,0,1,1,0,0,0,1,1,0,0.0,0.0,1,1,0,-1,-1,-1,2,0,68,89,86
48,145,345,83,95,12,64,64,60,60,0,64,64,63,63,0,0.01943565131556554,0.023520201504475986,83,86,3,3,3,3,4,20,83,23,72
49,48,664,64,100,36,12,22,40,48,8,12,22,42,52,10,0.009020048333843901,0.03359542530378842,70,93,23,2,4,3,2,8,90,8,7
50,0,616,1,100,99,0,22,1,47,46,0,22,1,50,49,0.0,0.01494264610776405,1,76,75,2,-1,3,2,0,95,59,12
51,420,1020,100,100,0,176,176,100,100,0,176,176,100,100,0,0.04380680077606454,0.04670002382654277,96,97,1,2,2,2,5,27,50,10,28
52,22,638,40,100,60,48,82,38,47,9,22,82,40,58,18,0.0012934408931549745,0.009122162088566664,39,64,25,2,3,3,7,2,46,74,28
53,100,100,66,66,0,100,100,52,52,0,100,100,66,66,0,0.040505122706695255,0.043568535348378096,94,95,1,2,1,1,8,16,15,18,22
54,102,718,74,100,26,118,118,88,88,0,102,118,83,88,5,0.01242384015793594,0.01501072194424589,73,80,7,2,2,2,5,7,61,62,70
55,0,1640,1,100,99,0,52,1,54,53,0,52,1,54,53,0.0,0.024575376969944517,1,85,84,1,-1,2,5,0,70,87,34
56,32,32,47,47,0,80,80,45,45,0,32,32,47,47,0,0.0019741992579733825,0.0019741992579733825,45,45,0,-1,3,3,9,3,28,51,45
57,100,100,69,69,0,100,100,66,66,0,100,100,72,72,0,0.04520235542394227,0.07256884168964226,95,100,5,2,1,1,6,14,44,14,3
58,16,222,43,93,50,30,34,43,45,2,16,25,43,50,7,0.00088498587426393,0.0027911092957554717,38,49,11,3,3,3,4,2,73,42,54
59,0,616,1,100,99,0,94,1,44,43,0,94,1,59,58,0.0,0.0283876238129276,1,90,89,2,-1,3,9,0,29,96,3
60,256,256,97,97,0,86,86,94,94,0,86,86,94,94,0,0.03887130263113108,0.03887130263113108,93,93,0,-1,2,2,3,27,55,10,79
61,100,100,71,71,0,100,100,76,76,0,100,100,77,77,0,0.059838660267538035,0.06981177031212771,98,99,1,2,1,1,5,22,50,9,33
62,70,686,59,100,41,126,146,63,67,4,70,146,59,85,26,0.004901460226692535,0.01858470335954253,58,79,21,2,3,3,11,6,38,28,37
63,100,100,73,73,0,100,100,88,88,0,100,100,88,88,0,0.040505122706695255,0.0479253888832159,94,96,2,2,1,1,4,6,84,70,14
64,268,268,92,92,0,254,254,93,93,0,254,254,94,94,0,0.022805405221416657,0.022805405221416657,82,82,0,-1,2,2,12,17,2,6,82
65,6,212,32,94,62,14,14,32,32,0,6,14,32,40,8,0.0009190237925048504,0.0123557643214541,37,76,39,3,4,4,3,1,96,71,18
66,28,28,47,47,0,36,36,41,41,0,28,28,47,47,0,0.0013955546478777359,0.0013955546478777359,42,42,0,-1,3,3,5,4,88,64,92
67,0,206,1,88,87,0,17,1,29,28,0,8,1,33,32,0.0,0.0007147962830593281,1,36,35,3,-1,4,7,0,24,96,74
68,64,1704,58,100,42,104,128,66,78,12,64,120,58,80,22,0.006773545729943157,0.021614078082984444,59,81,22,1,3,2,9,7,26,62,28
69,80,696,59,100,41,140,150,69,72,3,80,150,59,84,25,0.006569318220497634,0.02920453385070969,59,90,31,2,3,3,10,6,22,26,11
70,0,102,1,75,74,0,12,1,27,26,0,2,1,25,24,0.0,0.000442492937131965,1,31,30,4,-1,5,8,0,27,85,42
71,1,101,25,74,49,6,6,25,25,0,1,1,25,25,0,6.807583648184077e-05,6.807583648184077e-05,27,27,0,5,6,6,6,2,59,58,95
72,100,100,63,63,0,100,100,47,47,0,100,100,63,63,0,0.037850165083903466,0.05919193982096055,96,99,3,2,1,1,10,16,22,18,10
73,0,0,1,1,0,0,0,1,1,0,0,0,1,1,0,0.0,0.0,1,1,0,-1,-1,-1,5,0,37,79,85
74,100,100,63,63,0,100,100,47,47,0,100,100,63,63,0,0.05262262160046292,0.05262262160046292,98,98,0,5,1,1,10,29,22,1,68
75,0,616,1,100,99,0,38,1,38,37,0,36,1,53,52,0.0,0.004356853534837809,1,55,54,2,-1,3,6,0,44,99,47
76,2,2,26,26,0,11,11,26,26,0,2,2,26,26,0,0.0,0.0,1,1,0,-1,5,5,10,1,0,68,36
77,142,348,92,100,8,22,22,54,54,0,22,22,54,54,0,0.019946220089179345,0.02413288403281255,84,89,5,3,3,3,2,17,99,6,62
78,6,212,29,88,59,22,38,31,34,3,6,38,29,49,20,0.00010211375472276115,0.012219612648490419,29,73,44,3,4,4,7,1,24,4,6
79,24,24,48,48,0,38,38,47,47,0,24,24,48,48,0,0.0027911092957554717,0.0027911092957554717,49,49,0,-1,3,3,3,3,75,54,59
80,100,100,62,62,0,100,100,45,45,0,100,100,62,62,0,0.047448858027843016,0.0477551992920113,98,98,0,3,1,1,12,30,3,7,49
81,0,102,1,77,76,0,7,1,27,26,0,3,1,31,30,0.0,0.0006126825283365669,1,37,36,4,-1,5,4,0,84,96,51
82,1,207,26,90,64,8,32,26,31,5,1,8,26,33,7,6.807583648184077e-05,0.001157289220191293,27,38,11,3,6,4,8,2,39,58,61
83,86,187,64,87,23,96,96,60,60,0,86,96,64,68,4,0.00803294870485721,0.008203138296061813,64,64,0,5,3,3,6,6,44,34,55
84,0,616,1,100,99,0,60,1,48,47,0,60,1,53,52,0.0,0.027945130875795636,1,89,88,2,-1,3,5,0,52,98,3
85,86,292,59,94,35,126,126,69,69,0,86,126,59,77,18,0.009632730862180468,0.00976888253514415,66,68,2,3,2,2,7,6,24,34,56
86,64,166,62,88,26,54,54,52,52,0,64,54,63,55,-8,0.007862759113652609,0.008135062459579971,64,65,1,4,3,3,4,4,83,38,88
87,100,100,71,71,0,100,100,80,80,0,100,100,81,81,0,0.0318935293917424,0.04493005207801491,91,96,5,2,1,1,5,2,49,63,39
88,8,110,37,81,44,18,18,35,35,0,8,18,37,47,10,0.0015657442390823377,0.0025188059498281084,43,49,6,4,4,4,3,2,87,83,43
89,60,266,55,93,38,76,76,54,54,0,60,76,55,59,4,0.008441403723748256,0.013376901868681712,65,74,9,3,3,3,6,5,41,25,34
90,114,320,76,94,18,96,96,60,60,0,96,96,69,69,0,0.010858095918853602,0.018686817114265293,71,81,10,3,3,3,6,9,44,27,20
91,190,190,90,90,0,158,158,80,80,0,158,158,86,86,0,0.02042275094455223,0.02042275094455223,84,84,0,-1,2,2,9,17,23,6,96
92,94,294,67,95,28,86,86,65,65,0,86,86,68,68,0,0.011640968038394772,0.016542428265087308,69,79,10,3,3,3,6,9,71,27,25
93,1,103,25,81,56,3,4,25,26,1,1,3,25,30,5,3.4037918240920386e-05,0.00017018959120460194,27,30,3,4,6,5,3,2,81,58,88
94,48,664,56,100,44,64,104,58,81,23,48,104,56,81,25,0.003880322679464924,0.032063718982947,52,89,37,2,2,2,5,3,80,43,1
95,130,336,85,96,11,100,100,71,71,0,100,100,75,75,0,0.010211375472276116,0.01157289220191293,71,72,1,3,2,2,6,13,32,24,53
96,100,100,82,82,0,100,100,98,98,0,100,100,98,98,0,0.10075223799312434,0.10238605806868852,99,100,1,4,1,1,2,20,98,23,83
97,0,0,1,1,0,0,0,1,1,0,0,0,1,1,0,0.0,0.0,1,1,0,-1,-1,-1,12,0,6,59,91
98,210,210,90,90,0,220,220,85,85,0,210,210,91,91,0,0.014364001497668403,0.014364001497668403,77,77,0,-1,2,2,12,14,3,14,86
99,0,616,1,100,99,0,62,1,34,33,0,26,1,41,40,0.0,0.003948398515946765,1,53,52,2,-1,3,14,0,25,59,41
100,358,460,98,98,0,312,312,98,98,0,312,312,98,98,0,0.02491575615235372,0.02501786990707648,88,88,0,4,2,2,12,19,6,15,55
101,0,616,1,99,98,0,82,1,40,39,0,60,1,53,52,0.0,0.011334626774226489,1,71,70,2,-1,3,11,0,33,91,39
102,2,104,28,84,56,4,4,30,30,0,2,4,28,32,4,0.0002723033459273631,0.0004765308553728854,34,36,2,4,5,5,2,1,89,60,49
103,96,712,56,100,44,190,190,69,69,0,96,143,56,84,28,0.007011811157629599,0.012696143503863304,59,72,13,2,2,2,16,6,4,35,44
104,184,390,84,97,13,166,166,84,84,0,166,166,85,85,0,0.011947309302563056,0.013581129378127233,69,72,3,3,2,2,8,13,27,24,53
105,0,616,1,100,99,0,46,1,38,37,0,46,1,52,51,0.0,0.007488342013002485,1,63,62,2,-1,3,6,0,41,80,17
106,258,1898,95,100,5,198,222,83,91,8,198,222,91,94,3,0.019265461724360937,0.03168930188229688,83,89,6,1,2,2,10,16,0,12,46
107,66,682,62,100,38,54,54,54,54,0,54,54,58,58,0,0.005037611899656217,0.008611593314952858,57,64,7,2,3,3,4,6,47,28,53
108,0,616,1,99,98,0,40,1,33,32,0,28,1,45,44,0.0,0.0034718676605738795,1,50,49,2,-1,3,11,0,19,99,35
109,16,1656,34,100,66,102,156,57,65,8,16,156,34,87,53,0.001497668402600497,0.029340685523673374,40,90,50,1,3,2,12,1,6,71,10
110,100,100,66,66,0,100,100,43,43,0,100,100,66,66,0,0.015180911535450491,0.01865277919602437,74,80,6,3,1,1,11,3,33,43,29
111,34,650,53,100,47,54,54,55,55,0,34,54,53,59,6,0.007488342013002485,0.022499063957248374,62,84,22,2,3,3,4,7,84,62,16
112,0,616,1,99,98,0,124,1,58,57,0,74,1,54,53,0.0,0.011504816365431091,1,68,67,2,-1,3,17,0,20,40,39
113,36,242,49,92,43,110,110,59,59,0,36,44,49,51,2,0.00439089145307873,0.005037611899656217,54,55,1,3,3,3,10,6,18,73,56
114,8,214,31,93,62,20,20,30,30,0,8,20,31,40,9,0.00037441710065012424,0.004935498144933456,31,49,18,3,4,4,4,2,67,56,38
115,0,1640,1,100,99,0,122,1,67,66,0,122,1,81,80,0.0,0.04060723646141802,1,95,94,1,-1,2,8,0,30,66,1
116,100,716,79,100,21,56,56,80,80,0,56,56,81,81,0,0.014840532353041287,0.03934783348650397,79,95,16,2,2,2,2,13,91,24,0
117,0,616,1,100,99,0,126,1,58,57,0,82,1,56,55,0.0,0.008679669151434699,1,62,61,2,-1,3,15,0,7,59,17
118,0,616,1,100,99,0,22,1,46,45,0,22,1,51,50,0.0,0.021546002246502605,1,86,85,2,-1,3,2,0,89,67,7
119,423,1023,98,100,2,184,184,96,96,0,184,184,96,96,0,0.03516116954287076,0.040198781442526976,91,94,3,2,2,2,7,29,46,1,25
120,0,0,1,1,0,0,0,1,1,0,0,0,1,1,0,0.0,0.0,1,1,0,-1,-1,-1,3,0,94,96,87
121,24,126,47,82,35,50,50,45,45,0,24,28,47,48,1,0.002212464685659825,0.0030634126416828346,47,49,2,4,3,3,5,3,45,54,74
122,100,100,59,59,0,100,100,45,45,0,100,100,59,59,0,0.03761189965621702,0.049184791858129955,95,96,1,1,1,1,10,20,0,23,46
123,0,206,1,87,86,0,66,1,34,33,0,27,1,39,38,0.0,0.003812246842983083,1,51,50,3,-1,4,15,1,7,45,35
124,88,294,74,99,25,48,48,72,72,0,48,48,74,74,0,0.015214949453691413,0.025085945743558324,79,86,7,3,3,3,3,13,60,33,37
125,108,724,75,100,25,134,134,89,89,0,108,134,75,89,14,0.0088498587426393,0.021546002246502605,67,84,17,2,2,2,6,6,41,26,5
126,124,740,78,100,22,182,192,71,71,0,124,192,78,91,13,0.007726607440688927,0.0247115286429082,63,87,24,2,3,3,12,9,6,31,23
127,208,808,92,100,8,136,136,86,86,0,136,136,87,87,0,0.023520201504475986,0.02808128254875932,86,88,2,2,2,2,7,17,62,6,44
128,40,1680,46,100,54,120,154,57,64,7,40,83,46,59,13,0.0019741992579733825,0.01143674052894925,42,69,27,1,2,2,14,2,17,42,64
129,100,100,60,60,0,100,100,50,50,0,100,100,60,60,0,0.054903162122604585,0.05908982606623779,99,99,0,2,1,1,9,29,28,1,26
130,0,616,1,100,99,0,82,1,39,38,0,82,1,58,57,0.0,0.021477926410020762,1,80,79,2,-1,3,12,0,2,97,0
131,44,146,58,88,30,38,38,52,52,0,38,38,55,55,0,0.006501242384015794,0.006569318220497634,63,63,0,4,3,3,3,4,66,38,4
132,104,310,77,96,19,60,60,55,55,0,60,60,60,60,0,0.01143674052894925,0.02297559481262126,71,84,13,3,3,3,5,14,70,32,6
133,2,208,27,92,65,10,16,28,30,2,2,9,27,35,8,3.4037918240920386e-05,0.0009190237925048504,27,37,10,3,5,4,6,1,65,95,61
134,6,212,32,93,61,28,28,36,36,0,6,14,32,38,6,0.00088498587426393,0.0027911092957554717,39,46,7,3,4,4,6,1,69,71,52
135,184,184,95,95,0,96,96,94,94,0,96,96,94,94,0,0.028932230504782327,0.028932230504782327,92,92,0,-1,2,2,3,16,94,18,87
136,16,632,32,100,68,154,164,65,67,2,16,34,32,42,10,0.003165526396405596,0.005037611899656217,50,55,5,2,3,3,14,3,8,46,83
137,32,133,47,81,34,84,84,46,46,0,32,33,47,48,1,0.0020422750944552232,0.002110350930937064,43,44,1,5,3,3,9,2,26,52,55
138,100,100,65,65,0,100,100,47,47,0,100,100,65,65,0,0.0333911977943429,0.033425235712583816,92,92,0,5,1,1,11,15,38,19,95
139,1,207,24,93,69,3,10,24,30,6,1,10,24,40,16,3.4037918240920386e-05,0.004833384390210695,26,51,25,3,6,4,3,1,92,68,31
140,8,214,36,93,57,14,14,35,35,0,8,14,36,42,6,0.0008509479560230097,0.005377991082065421,36,54,18,3,4,4,3,2,92,74,34
141,16,222,36,94,58,54,58,42,42,0,16,24,36,43,7,0.0007488342013002485,0.002586881786309949,36,45,9,3,3,3,7,2,46,42,83
142,6,6,33,33,0,8,8,33,33,0,6,6,33,33,0,0.00037441710065012424,0.00037441710065012424,35,35,0,-1,4,4,2,1,90,49,93
143,362,362,96,96,0,240,240,97,97,0,240,240,97,97,0,0.03362946322202934,0.03362946322202934,89,89,0,-1,2,2,9,22,31,9,36
144,0,206,1,90,89,0,54,1,32,31,0,12,1,33,32,0.0,0.0014295925661186562,1,41,40,3,-1,4,13,0,13,86,52
145,6,107,27,81,54,24,24,36,36,0,6,7,27,30,3,0.003369753905851118,0.0035059055788147996,46,46,0,6,4,4,4,1,67,90,78
146,42,242,54,92,38,100,100,48,48,0,40,42,50,54,4,0.0028591851322373124,0.003608019333537561,51,52,1,3,3,3,10,6,11,41,74
147,0,1640,1,100,99,0,44,1,63,62,0,44,1,64,63,0.0,0.03795227883862623,1,95,94,1,-1,2,3,0,85,99,24
148,606,812,100,100,0,400,400,99,99,0,400,400,99,99,0,0.052554545763981074,0.054358555430749855,99,99,0,3,2,2,13,36,13,2,83
149,206,206,91,91,0,140,140,67,67,0,140,140,84,84,0,0.015657442390823378,0.015657442390823378,78,78,0,-1,3,3,10,16,1,12,82
150,0,0,1,1,0,0,0,1,1,0,0,0,1,1,0,0.0,0.0,1,1,0,-1,-1,-1,11,0,5,85,98
151,22,638,41,100,59,110,110,59,59,0,22,78,41,56,15,0.0018040096667687805,0.006399128629293032,43,56,13,2,3,3,10,2,18,61,13
152,63,269,54,95,41,106,106,67,67,0,63,106,54,75,21,0.005207801490860819,0.013376901868681712,54,76,22,3,2,2,7,4,46,22,32
153,182,388,89,98,9,104,104,73,73,0,104,104,79,79,0,0.019878144252697506,0.02290751897613942,84,89,5,3,2,2,5,18,52,30,73
154,0,206,1,93,92,0,18,1,40,39,0,18,1,44,43,0.0,0.012253650566731339,1,74,73,3,-1,4,3,0,60,93,30
155,0,1640,1,100,99,0,112,1,61,60,0,112,1,76,75,0.0,0.028693965077095884,1,87,86,1,-1,2,8,0,42,81,9
156,0,206,1,87,86,0,40,1,33,32,0,22,1,41,40,0.0,0.003369753905851118,1,48,47,3,-1,4,10,0,22,76,28
157,62,678,53,100,47,122,132,66,69,3,62,102,53,72,19,0.0038462847612240037,0.010483678818203479,53,71,18,2,2,2,8,6,42,70,62
158,78,78,69,69,0,48,48,60,60,0,48,48,63,63,0,0.011811157629599374,0.011811157629599374,70,70,0,-1,3,3,3,8,58,17,59
159,22,638,46,100,54,28,28,43,43,0,22,28,46,49,3,0.002110350930937064,0.015112835698968652,46,80,34,2,3,3,3,2,75,52,12
160,64,64,57,57,0,86,86,56,56,0,64,64,57,57,0,0.006705469893461316,0.006705469893461316,62,62,0,-1,3,3,6,4,59,72,50
161,100,100,66,66,0,100,100,66,66,0,100,100,69,69,0,0.04200279110929576,0.05156744613499439,97,98,1,2,1,1,7,16,62,12,33
162,0,102,1,76,75,0,7,1,25,24,0,2,1,25,24,0.0,0.00034037918240920387,1,31,30,4,-1,5,6,0,56,93,88
163,138,344,84,97,13,110,110,83,83,0,110,110,83,83,0,0.01746145205759216,0.019707954661492902,80,80,0,3,2,2,6,9,71,39,75
164,100,100,63,63,0,100,100,47,47,0,100,100,63,63,0,0.05200993907212635,0.05200993907212635,98,98,0,-1,1,1,10,29,36,1,81
165,0,102,1,77,76,0,6,1,24,23,0,2,1,24,23,0.0,0.00010211375472276115,1,29,28,4,-1,5,5,0,50,93,60
166,37,653,58,100,42,22,32,49,68,19,22,32,53,68,15,0.0053099152455835805,0.025051907825317403,58,88,30,2,3,3,2,6,90,35,6
167,0,206,1,93,92,0,22,1,32,31,0,22,1,45,44,0.0,0.006909697402906838,1,60,59,3,-1,4,5,0,45,93,27
168,0,206,1,91,90,0,20,1,29,28,0,14,1,34,33,0.0,0.002382654276864427,1,41,40,3,-1,4,4,0,67,85,70
169,82,288,72,99,27,46,46,82,82,0,46,46,82,82,0,0.015521290717859695,0.018754892950747133,79,81,2,3,2,2,2,8,95,20,94
170,136,237,84,92,8,104,104,82,82,0,104,104,82,82,0,0.015180911535450491,0.015248987371932332,78,78,0,5,2,2,5,8,80,17,78
171,12,628,37,100,63,26,36,36,39,3,12,30,37,49,12,0.0025188059498281084,0.004935498144933456,48,52,4,2,4,3,5,2,37,75,52
172,0,206,1,94,93,0,12,1,31,30,0,12,1,36,35,0.0,0.007998910786616291,1,61,60,3,-1,4,2,1,91,45,20
173,492,698,98,100,2,400,400,99,99,0,400,400,99,99,0,0.041594336090404714,0.042989890738282445,95,95,0,3,2,2,13,29,13,0,41
174,128,744,87,100,13,72,72,80,80,0,72,72,80,80,0,0.018788930868988054,0.03369753905851118,84,91,7,2,2,2,3,13,76,33,5
175,100,100,62,62,0,100,100,45,45,0,100,100,62,62,0,0.042683549474114166,0.046019265461724364,96,97,1,2,1,1,12,20,3,23,72
176,34,240,49,91,42,90,90,43,43,0,34,60,49,55,6,0.001599782157323258,0.006092787365124749,42,59,17,3,3,3,10,4,1,64,26
177,63,1703,61,100,39,60,94,53,74,21,60,94,60,74,14,0.007182000748834201,0.042683549474114166,62,97,35,1,3,2,5,8,49,57,37
178,212,212,90,90,0,166,166,83,83,0,166,166,88,88,0,0.013376901868681712,0.013376901868681712,75,75,0,-1,2,2,8,14,15,32,96
179,420,1036,100,100,0,280,280,100,100,0,280,280,100,100,0,0.036624800027230335,0.04220701861874128,93,94,1,2,2,2,10,27,36,10,21
180,108,724,72,100,28,70,70,51,51,0,70,70,57,57,0,0.013547091459886314,0.018040096667687803,77,82,5,2,3,3,5,9,52,39,70
181,6,6,34,34,0,12,12,39,39,0,6,6,34,34,0,0.00088498587426393,0.00088498587426393,40,40,0,-1,4,4,2,1,93,71,67
182,36,652,52,100,48,88,98,52,54,2,36,65,52,57,5,0.00439089145307873,0.009190237925048503,54,65,11,2,3,3,8,6,21,73,22
183,268,268,92,92,0,302,302,97,97,0,268,268,96,96,0,0.01834643793185609,0.01834643793185609,77,77,0,-1,2,2,12,13,2,33,92
184,2,618,27,100,73,6,28,27,37,10,2,27,27,49,22,6.807583648184077e-05,0.0036760951700194017,27,49,22,2,5,3,5,1,37,78,22
185,64,166,56,83,27,130,130,65,65,0,64,66,56,57,1,0.006637394056979475,0.006637394056979475,60,60,0,4,3,3,10,4,22,72,65
186,196,196,90,90,0,278,278,85,85,0,196,196,90,90,0,0.011504816365431091,0.011504816365431091,71,71,0,-1,2,2,16,9,4,31,98
187,64,165,61,87,26,54,54,53,53,0,64,54,64,57,-7,0.00707988699411144,0.007147962830593281,62,62,0,5,3,3,4,4,79,72,78
188,0,0,1,1,0,0,0,1,1,0,0,0,1,1,0,0.0,0.0,1,1,0,-1,-1,-1,12,0,6,40,45
189,100,100,62,62,0,100,100,43,43,0,100,100,62,62,0,0.04877633683923891,0.049763436468225605,97,98,1,4,1,1,12,29,14,1,51
190,40,40,52,52,0,72,72,45,45,0,40,40,52,52,0,0.004050512270669526,0.004050512270669526,52,52,0,-1,3,3,7,6,24,73,85
191,0,616,1,100,99,0,34,1,43,42,0,34,1,54,53,0.0,0.009428503352734947,1,69,68,2,-1,3,4,0,72,80,77
192,0,206,1,94,93,0,8,1,32,31,0,6,1,32,31,0.0,0.002552843868069029,1,48,47,3,-1,4,2,0,90,80,46
193,18,120,45,84,39,28,28,45,45,0,18,20,45,46,1,0.0015317063208414173,0.002382654276864427,44,45,1,4,3,3,3,2,60,61,71
194,32,1672,44,100,56,102,146,56,69,13,32,146,44,83,39,0.0025188059498281084,0.023520201504475986,45,86,41,1,3,2,12,2,2,52,18
195,0,206,1,92,91,0,14,1,30,29,0,6,1,30,29,0.0,0.0007488342013002485,1,36,35,3,-1,4,5,0,70,97,71
196,56,56,65,65,0,56,56,86,86,0,56,56,86,86,0,0.008305252050784574,0.008305252050784574,65,65,0,-1,2,2,2,2,95,52,81
197,0,0,1,1,0,0,0,1,1,0,0,0,1,1,0,0.0,0.0,1,1,0,-1,-1,-1,7,0,24,99,79
198,100,100,71,71,0,100,100,80,80,0,100,100,81,81,0,0.031621226045815035,0.031621226045815035,90,90,0,-1,1,1,5,2,49,61,66
199,24,230,50,97,47,28,28,45,45,0,24,28,51,51,0,0.002144388849177984,0.014568229007113924,44,76,32,3,3,3,3,3,94,43,6
200,0,102,1,84,83,0,4,1,28,27,0,2,1,26,25,0.0,0.0011913271384322134,1,39,38,4,-1,5,2,1,98,45,53
201,0,102,1,74,73,0,7,1,26,25,0,2,1,26,25,0.0,0.0,1,1,0,4,-1,5,6,0,41,97,95
202,22,22,51,51,0,64,64,64,64,0,22,22,51,51,0,0.00445896728956057,0.00445896728956057,53,53,0,-1,3,3,4,3,77,29,92
203,0,102,1,73,72,0,13,1,25,24,0,2,1,25,24,0.0,0.00013615167296368154,1,29,28,4,-1,5,12,0,6,92,55
204,62,1702,53,100,47,138,182,62,70,8,62,143,53,83,30,0.0027911092957554717,0.01678069369277375,48,74,26,1,2,2,14,3,25,54,44
205,0,0,1,1,0,0,0,1,1,0,0,0,1,1,0,0.0,0.0,1,1,0,-1,-1,-1,3,0,60,92,36
206,230,230,94,94,0,190,190,93,93,0,190,190,94,94,0,0.02100139555464788,0.02100139555464788,84,84,0,-1,2,2,8,18,39,30,59
207,92,298,75,98,23,32,32,58,58,0,32,32,59,59,0,0.012015385139044895,0.014670342761836687,75,78,3,3,3,3,2,8,68,17,35
208,294,910,96,100,4,192,192,91,91,0,192,192,91,91,0,0.03012355764321454,0.04523639334218319,92,96,4,2,2,2,9,22,26,9,18
209,162,778,83,100,17,176,176,90,90,0,162,176,90,90,0,0.018074134585928724,0.023350011913271386,79,85,6,2,2,2,8,9,21,39,26
210,80,1720,64,100,36,106,130,71,79,8,80,130,64,81,17,0.006569318220497634,0.03359542530378842,60,91,31,1,2,2,7,6,43,28,15
211,66,272,57,95,38,112,112,66,66,0,64,72,57,60,3,0.00616086320160659,0.006535280302256714,58,61,3,3,2,2,8,6,21,41,63
212,98,714,74,100,26,48,48,65,65,0,48,48,68,68,0,0.012832295176826986,0.04077742605262262,79,95,16,2,3,3,3,13,66,33,3
213,32,32,52,52,0,38,38,56,56,0,32,32,58,58,0,0.003165526396405596,0.003165526396405596,48,48,0,-1,3,3,3,2,58,75,89
214,221,427,93,100,7,72,72,80,80,0,72,72,80,80,0,0.03359542530378842,0.04452159705912386,91,96,5,3,2,2,3,29,76,0,37
215,22,22,42,42,0,46,46,39,39,0,22,22,42,42,0,0.0018380475850097008,0.0018380475850097008,43,43,0,-1,3,3,6,2,41,61,85
216,2,104,28,84,56,4,4,30,30,0,2,4,28,31,3,0.00010211375472276115,0.00034037918240920387,29,33,4,4,5,5,2,1,68,95,88
217,36,1676,50,100,50,78,132,44,74,30,36,132,50,81,31,0.004561081044283332,0.04401102828551006,54,97,43,1,3,2,8,6,10,73,2
218,100,100,64,64,0,100,100,49,49,0,100,100,64,64,0,0.049763436468225605,0.06484223424895333,98,100,2,2,1,1,8,22,42,9,23
219,88,704,63,100,37,190,190,80,80,0,88,190,63,88,25,0.007998910786616291,0.026141121209026855,64,88,24,2,2,2,11,4,33,38,23
220,12,113,36,85,49,14,14,32,32,0,12,13,36,40,4,0.0020082371762143027,0.0020422750944552232,43,43,0,6,4,4,3,2,96,75,78
221,76,282,69,98,29,32,32,58,58,0,32,32,60,60,0,0.011062323428299126,0.012968446849790666,71,76,5,3,3,3,2,6,91,77,75
222,16,222,38,92,54,36,36,40,40,0,16,24,38,48,10,0.0011232513019503727,0.002314578440382586,39,47,8,3,3,3,5,1,37,71,74
223,16,222,46,96,50,22,22,48,48,0,16,22,47,50,3,0.0031314884781646754,0.007454304094761564,50,62,12,3,3,3,2,3,95,46,62
224,32,648,48,100,52,68,118,40,65,25,32,118,48,77,29,0.0015317063208414173,0.025358249089485686,42,89,47,2,3,3,8,2,15,74,7
225,0,206,1,91,90,0,32,1,34,33,0,20,1,40,39,0.0,0.0046972327172470135,1,50,49,3,-1,4,6,0,56,79,38
226,218,834,90,100,10,182,192,88,93,5,182,192,92,93,1,0.023486163586235065,0.0455767725245924,85,97,12,2,2,2,9,16,29,18,1
227,128,744,79,100,21,290,300,83,86,3,128,188,79,86,7,0.008713707069675619,0.014568229007113924,60,75,15,2,2,2,17,6,20,26,31
228,0,616,1,100,99,0,34,1,35,34,0,34,1,44,43,0.0,0.009326389598012186,1,64,63,2,-1,3,6,0,71,67,14
229,278,894,95,100,5,344,344,93,93,0,278,296,95,97,2,0.02552843868069029,0.026889955410327106,87,88,1,2,2,2,17,15,20,16,74
230,0,206,1,91,90,0,24,1,31,30,0,8,1,32,31,0.0,0.001055175465468532,1,37,36,3,-1,4,10,0,0,97,83
231,2,104,28,83,55,5,5,29,29,0,2,4,28,30,2,6.807583648184077e-05,0.0002382654276864427,29,32,3,4,5,5,3,1,55,65,88
232,0,101,1,83,82,0,2,1,24,23,0,1,1,24,23,0.0,0.0,1,1,0,5,-1,6,2,0,86,85,95
233,82,184,71,91,20,38,38,57,57,0,38,38,59,59,0,0.012219612648490419,0.012253650566731339,75,75,0,4,3,3,3,8,55,20,4
234,2,2,28,28,0,8,8,28,28,0,2,2,28,28,0,0.00013615167296368154,0.00013615167296368154,30,30,0,-1,5,5,5,1,45,65,36
235,0,616,1,100,99,0,62,1,35,34,0,34,1,49,48,0.0,0.0053439531638245,1,55,54,2,-1,3,10,0,36,84,22
236,28,644,45,100,55,46,66,37,43,6,28,66,45,55,10,0.0007828721195411688,0.022328874366043774,35,86,51,2,3,3,6,4,40,64,0
237,292,908,95,100,5,272,272,94,94,0,272,272,94,94,0,0.02743456210218183,0.03655672419074849,89,92,3,2,2,2,11,20,33,23,17
238,0,616,1,100,99,0,40,1,39,38,0,30,1,47,46,0.0,0.006024711528642908,1,56,55,2,-1,3,5,0,52,92,38
239,2,618,28,100,72,5,34,28,43,15,2,34,28,54,26,6.807583648184077e-05,0.014534191088873005,29,81,52,2,5,3,4,1,72,78,30
240,0,206,1,94,93,0,12,1,31,30,0,12,1,36,35,0.0,0.0018720855032506212,1,43,42,3,-1,4,2,0,91,85,54
241,66,66,71,71,0,56,56,84,84,0,56,56,84,84,0,0.01763164164879676,0.01763164164879676,81,81,0,-1,2,2,2,5,86,25,93
242,40,40,47,47,0,170,170,68,68,0,40,40,47,47,0,0.004799346471969774,0.004799346471969774,53,53,0,-1,2,2,16,1,9,90,87
243,0,101,1,82,81,0,3,1,25,24,0,1,1,25,24,0.0,0.0,1,1,0,6,-1,7,3,0,75,36,78
244,0,206,1,91,90,0,22,1,29,28,0,6,1,29,28,0.0,0.00030634126416828345,1,33,32,3,-1,4,11,1,38,50,49
245,332,948,95,100,5,168,168,96,96,0,168,168,96,96,0,0.03240409816535621,0.03635249668130297,91,92,1,2,2,2,6,22,40,9,35
246,114,730,76,100,24,100,110,70,80,10,100,110,72,81,9,0.01143674052894925,0.01684876952925559,69,79,10,2,2,2,6,9,65,31,44
247,128,1728,80,100,20,232,232,76,76,0,128,232,80,91,11,0.007113924912352361,0.026243234963749616,62,90,28,1,2,2,14,6,8,26,16
248,40,246,51,94,43,128,128,67,67,0,40,52,51,55,4,0.0051397256543789785,0.006535280302256714,58,59,1,3,2,2,9,1,28,90,52
249,62,163,66,92,26,38,38,51,51,0,38,38,54,54,0,0.008713707069675619,0.00891793457912114,65,65,0,5,3,3,3,9,94,31,88
250,252,252,95,95,0,64,64,64,64,0,64,64,67,67,0,0.03100854351747847,0.03100854351747847,90,90,0,-1,3,3,4,29,77,1,97
251,46,252,60,97,37,28,28,46,46,0,28,28,51,51,0,0.005616256509751864,0.02501786990707648,58,88,30,3,3,3,3,6,85,13,11
252,6,622,31,99,68,24,72,31,39,8,6,72,31,56,25,0.0002723033459273631,0.009224275843289425,34,62,28,2,4,3,11,1,19,55,32
253,16,117,35,75,40,40,40,35,35,0,16,17,35,40,5,0.0004084550188910446,0.0005105687736138058,36,36,0,5,3,3,7,1,24,88,68
254,16,16,40,40,0,28,28,45,45,0,16,16,40,40,0,0.0012253650566731338,0.0012253650566731338,37,37,0,-1,3,3,3,1,94,49,97
255,192,292,94,100,6,56,56,85,85,0,56,56,85,85,0,0.032914666938970015,0.0333911977943429,93,93,0,4,2,2,2,22,90,9,43
256,8,214,37,92,55,18,18,38,38,0,8,18,37,46,9,0.0004765308553728854,0.007726607440688927,37,64,27,3,4,4,3,2,76,56,77
257,205,205,92,92,0,136,136,98,98,0,136,136,98,98,0,0.03158718812757412,0.03158718812757412,91,91,0,-1,2,2,4,15,77,16,85
258,46,252,53,94,41,76,76,49,49,0,46,52,53,54,1,0.005616256509751864,0.0063650907110521125,55,58,3,3,2,2,7,2,43,75,71
259,2,2,28,28,0,5,5,29,29,0,2,2,28,28,0,0.0002042275094455223,0.0002042275094455223,32,32,0,-1,5,5,3,1,55,60,36
260,16,632,36,100,64,56,70,37,41,4,16,58,36,55,19,0.0002723033459273631,0.008101024541339052,35,64,29,2,3,3,9,1,28,49,77
261,91,291,72,96,24,48,48,60,60,0,48,48,63,63,0,0.012525953912658701,0.03025970931617822,72,91,19,3,3,3,3,13,58,33,7
262,0,616,1,100,99,0,40,1,44,43,0,40,1,51,50,0.0,0.0156914803090643,1,78,77,2,-1,3,5,0,37,40,23
263,102,718,83,100,17,48,48,59,59,0,48,48,63,63,0,0.01681473161101467,0.020014295925661188,82,83,1,2,3,3,3,17,75,6,53
264,224,224,88,88,0,300,300,91,91,0,224,224,88,88,0,0.01674665577453283,0.01674665577453283,74,74,0,-1,2,2,14,8,25,8,87
265,16,632,40,100,60,90,90,49,49,0,16,90,40,67,27,0.0030634126416828346,0.01317267435923619,46,72,26,2,3,3,9,2,26,94,19
266,38,654,50,100,50,78,98,45,51,6,38,98,50,64,14,0.0021784267674189047,0.01855066544130161,45,82,37,2,3,3,8,3,15,54,23
267,59,265,60,95,35,68,68,74,74,0,59,68,66,75,9,0.010279451308757957,0.018312400013615168,69,84,15,3,2,2,4,6,77,73,20
268,124,226,82,93,11,182,182,87,87,0,124,126,84,84,0,0.013070560604513427,0.01327478811395895,71,72,1,4,2,2,9,6,23,77,65
269,12,114,40,82,42,18,18,38,38,0,12,18,40,46,6,0.0015657442390823377,0.004595118962524252,42,56,14,4,4,4,3,2,81,52,22
270,60,162,62,88,26,60,60,51,51,0,60,60,62,62,0,0.006535280302256714,0.007760645358929848,60,63,3,4,3,3,5,5,80,47,83
271,32,32,49,49,0,24,24,42,42,0,32,32,55,55,0,0.003710133088260322,0.003710133088260322,50,50,0,-1,3,3,3,2,60,75,98
272,44,44,54,54,0,80,80,70,70,0,44,44,54,54,0,0.006875659484665918,0.006875659484665918,59,59,0,-1,3,3,5,4,45,38,99
273,292,394,95,97,2,252,252,94,94,0,252,252,94,94,0,0.02294155689438034,0.02307770856734402,86,86,0,4,2,2,11,16,19,12,88
274,0,206,1,96,95,0,18,1,35,34,0,18,1,44,43,0.0,0.01606589740971442,1,81,80,3,-1,4,3,0,75,76,15
275,1,1,25,25,0,2,2,25,25,0,1,1,25,25,0,6.807583648184077e-05,6.807583648184077e-05,27,27,0,-1,6,6,2,1,97,68,76
276,50,1690,59,100,41,38,72,52,79,27,38,72,55,79,24,0.005207801490860819,0.05725177848122809,56,97,41,1,3,2,3,6,66,28,23
277,0,206,1,89,88,0,18,1,32,31,0,16,1,35,34,0.0,0.0045270431260424114,1,55,54,3,-1,4,5,0,61,40,38
278,126,126,82,82,0,184,184,82,82,0,126,126,82,82,0,0.012117498893767658,0.012117498893767658,70,70,0,-1,2,2,10,8,22,17,50
279,114,114,75,75,0,118,118,89,89,0,114,114,90,90,0,0.008339289969025495,0.008339289969025495,61,61,0,-1,2,2,5,6,52,28,67
280,0,616,1,100,99,0,58,1,35,34,0,24,1,45,44,0.0,0.002995336805200994,1,48,47,2,-1,3,10,0,1,36,70
281,22,638,49,100,51,22,32,47,63,16,22,32,52,63,11,0.002144388849177984,0.01245787807617686,45,73,28,2,3,3,2,2,89,52,72
282,8,214,36,94,58,28,28,36,36,0,8,16,36,36,0,0.0002042275094455223,0.0012594029749140542,31,38,7,3,4,4,6,2,34,56,64
283,246,862,90,100,10,244,244,91,91,0,244,244,92,92,0,0.019980258007420267,0.030736240171551108,78,91,13,2,2,2,12,18,2,5,32
284,16,1656,36,100,64,36,106,34,66,32,16,106,36,75,39,0.000442492937131965,0.03846284761224004,33,93,60,1,3,2,7,1,46,4,11
285,62,1702,69,100,31,22,46,54,82,28,22,46,54,82,28,0.011028285510058205,0.08257598965247286,71,99,28,1,3,2,2,8,99,20,3
286,58,58,61,61,0,94,94,72,72,0,58,58,61,61,0,0.005514142755029102,0.005514142755029102,59,59,0,-1,2,2,5,6,80,70,99
287,0,616,1,100,99,0,66,1,48,47,0,66,1,58,57,0.0,0.016372238673882704,1,80,79,2,-1,3,6,0,44,67,16
288,0,616,1,100,99,0,88,1,40,39,0,88,1,60,59,0.0,0.013444977705163553,1,76,75,2,-1,3,12,1,3,45,30
289,0,616,1,100,99,0,74,1,41,40,0,74,1,57,56,0.0,0.012900371013308825,1,73,72,2,-1,3,9,1,29,50,5
290,1,1,26,26,0,4,4,26,26,0,1,1,26,26,0,6.807583648184077e-05,6.807583648184077e-05,27,27,0,-1,6,6,4,1,73,68,97
291,100,100,63,63,0,100,100,45,45,0,100,100,63,63,0,0.020456788862793153,0.0509207256884169,81,99,18,1,1,1,11,7,19,62,11
292,228,434,90,97,7,248,248,89,89,0,228,248,91,91,0,0.016916845365737433,0.01783586915824228,76,77,1,3,2,2,11,13,5,33,71
293,338,538,98,100,2,128,128,93,93,0,128,128,93,93,0,0.03536539705231628,0.0402328193607679,92,94,2,3,2,2,5,30,37,7,44
294,0,102,1,79,78,0,9,1,30,29,0,3,1,31,30,0.0,0.00037441710065012424,1,33,32,4,-1,5,5,0,45,36,56
295,40,656,52,100,48,106,106,66,66,0,40,106,52,74,22,0.0030293747234419145,0.009020048333843901,49,65,16,2,2,2,7,1,24,53,57
296,60,162,68,89,21,38,38,52,52,0,38,38,55,55,0,0.005888559855679227,0.006739507811702236,59,64,5,4,3,3,3,5,66,47,64
297,266,472,95,99,4,240,240,98,98,0,240,240,98,98,0,0.023894618605126112,0.0247115286429082,86,86,0,3,2,2,9,16,23,18,61
298,342,342,95,95,0,216,216,94,94,0,216,216,94,94,0,0.03808843051158991,0.03808843051158991,92,92,0,-1,2,2,9,27,31,10,79
299,278,894,95,100,5,344,344,93,93,0,278,344,95,98,3,0.02552843868069029,0.03788420300214439,87,93,6,2,2,2,17,15,20,16,30
300,100,100,67,67,0,100,100,55,54,-1,100,100,67,67,0,0.01960584090677014,0.04350045951189625,82,97,15,1,1,1,9,2,23,94,16
301,431,1031,100,100,0,224,224,98,98,0,224,224,98,98,0,0.038530923448721874,0.04680213758126553,95,97,2,2,2,2,8,30,21,7,33
302,32,1672,40,100,60,100,184,40,70,30,32,184,40,86,46,0.00088498587426393,0.022839443139657578,36,87,51,1,3,2,15,2,7,63,9
303,0,0,1,1,0,0,0,1,1,0,0,0,1,1,0,0.0,0.0,1,1,0,-1,-1,-1,6,1,44,69,98
304,2,618,27,100,73,11,39,28,34,6,2,25,27,45,18,0.0,0.003778208924742163,1,51,50,2,5,3,9,1,35,68,73
305,0,206,1,91,90,0,29,1,31,30,0,13,1,32,31,0.0,0.0009870996289866913,1,38,37,3,-1,4,9,0,31,85,64
306,174,774,89,100,11,88,88,77,77,0,88,88,77,77,0,0.02100139555464788,0.030804316008032948,85,89,4,2,2,2,4,16,79,12,39
307,217,417,90,96,6,208,208,89,89,0,208,208,93,93,0,0.024949794070594642,0.025766704108376733,85,86,1,3,2,2,10,20,12,23,43
308,12,114,45,84,39,12,12,35,35,0,12,12,43,43,0,0.0022465026039007454,0.0029612988869600733,48,52,4,4,4,4,2,2,86,75,64
309,297,503,97,100,3,88,88,81,81,0,88,88,81,81,0,0.03628442084482113,0.038360733857517273,94,95,1,3,2,2,4,29,73,1,41
310,2,1642,27,100,73,19,130,29,65,36,2,130,27,82,55,3.4037918240920386e-05,0.028421661731168522,26,87,61,1,5,2,11,1,38,95,7
311,0,0,1,1,0,0,0,1,1,0,0,0,1,1,0,0.0,0.0,1,1,0,-1,-1,-1,5,0,88,40,80
312,152,352,89,100,11,96,96,91,91,0,96,96,91,91,0,0.022396950202525613,0.03182545355526056,85,90,5,3,2,2,3,14,76,14,6
313,335,935,96,100,4,104,104,88,88,0,104,104,88,88,0,0.04183260151809115,0.057932536846046497,96,99,3,2,2,2,5,40,88,3,7
314,32,32,49,49,0,50,50,45,45,0,32,32,49,49,0,0.004765308553728854,0.004765308553728854,53,53,0,-1,3,3,5,3,45,29,40
315,128,230,81,92,11,134,134,91,91,0,128,130,91,91,0,0.015521290717859695,0.015589366554341537,78,78,0,4,2,2,6,6,71,41,88
316,88,704,61,100,39,164,164,74,74,0,88,117,61,78,17,0.00888389666088022,0.012117498893767658,67,74,7,2,2,2,10,4,1,38,22
317,0,101,1,73,72,0,7,1,25,24,0,1,1,25,24,0.0,0.0,1,1,0,5,-1,6,7,0,43,79,68
318,2,618,26,100,74,10,40,26,33,7,2,18,26,38,12,3.4037918240920386e-05,0.002552843868069029,26,45,19,2,5,3,9,2,31,58,94
319,206,822,89,100,11,128,128,67,67,0,128,128,79,79,0,0.01783586915824228,0.025119983661799246,81,87,6,2,3,3,8,16,15,12,21
320,0,101,1,78,77,0,6,1,24,23,0,1,1,24,23,0.0,3.4037918240920386e-05,1,27,26,5,-1,6,6,0,69,40,65
321,302,1942,100,100,0,72,96,85,93,8,72,96,85,93,8,0.04704040300895197,0.07794683277170768,97,99,2,1,2,2,3,40,94,3,51
322,0,0,1,1,0,0,0,1,1,0,0,0,1,1,0,0.0,0.0,1,1,0,-1,-1,-1,4,0,78,97,80
323,0,0,1,1,0,0,0,1,1,0,0,0,1,1,0,0.0,0.0,1,1,0,-1,-1,-1,3,0,75,80,67
324,0,616,1,100,99,0,54,1,34,33,0,24,1,44,43,0.0,0.0037441710065012424,1,51,50,2,-1,3,12,0,3,92,73
325,0,1640,1,100,99,0,100,1,62,61,0,100,1,67,66,0.0,0.033425235712583816,1,93,92,1,-1,2,6,0,41,99,16
326,2,2,27,27,0,12,12,27,27,0,2,2,27,27,0,6.807583648184077e-05,6.807583648184077e-05,27,27,0,-1,5,5,11,1,19,78,67
327,16,222,37,94,57,46,46,41,41,0,16,24,37,48,11,0.0014636304843595766,0.002825147213996392,41,48,7,3,3,3,6,1,59,71,52
328,0,206,1,97,96,0,8,1,34,33,0,8,1,40,39,0.0,0.0040845501889104465,1,52,51,3,-1,4,2,0,97,80,26
329,0,0,1,1,0,0,0,1,1,0,0,0,1,1,0,0.0,0.0,1,1,0,-1,-1,-1,5,0,45,66,98
330,16,222,41,94,53,40,40,43,43,0,16,40,41,52,11,0.0020422750944552232,0.010415602981721638,46,68,22,3,3,3,5,2,49,94,14
331,2,618,29,100,71,7,34,30,46,16,2,34,29,54,25,0.00010211375472276115,0.01157289220191293,30,73,43,2,5,3,4,1,77,4,39
332,0,0,1,1,0,0,0,1,1,0,0,0,1,1,0,0.0,0.0,1,1,0,-1,-1,-1,5,0,37,40,93
333,16,117,43,82,39,28,28,46,46,0,16,17,43,46,3,0.0019741992579733825,0.0020763130126961434,45,46,1,6,3,3,3,1,81,53,78
334,134,340,88,100,12,48,48,72,72,0,48,48,74,74,0,0.018210286258892407,0.0265495762279179,84,87,3,3,3,3,3,18,60,30,14
335,0,616,1,100,99,0,90,1,38,37,0,84,1,56,55,0.0,0.012491915994417782,1,72,71,2,-1,3,14,0,8,93,30
336,46,46,52,52,0,104,104,61,61,0,46,46,52,52,0,0.0036760951700194017,0.0036760951700194017,49,49,0,-1,2,2,10,2,22,75,69
337,184,184,90,90,0,158,158,95,95,0,158,158,95,95,0,0.022226760611321013,0.022226760611321013,86,86,0,-1,2,2,6,12,59,37,84
338,73,273,64,96,32,54,54,54,54,0,54,54,58,58,0,0.006773545729943157,0.014023622315259198,60,77,17,3,3,3,4,8,47,57,17
339,0,0,1,1,0,0,0,1,1,0,0,0,1,1,0,0.0,0.0,1,1,0,-1,-1,-1,6,0,74,81,66
340,126,126,82,82,0,64,64,63,63,0,64,64,64,64,0,0.01664454201981007,0.01664454201981007,81,81,0,-1,3,3,4,17,79,6,66
341,74,674,64,100,36,64,64,68,68,0,64,64,69,69,0,0.010143299635794275,0.038939378467612924,72,94,22,2,3,3,4,9,73,27,2
342,112,728,78,100,22,222,222,77,77,0,112,148,78,83,5,0.008135062459579971,0.011947309302563056,63,67,4,2,2,2,14,7,25,62,35
343,406,1022,97,100,3,182,192,99,99,0,182,192,99,99,0,0.03897341638585384,0.04932094353109364,95,98,3,2,2,2,6,29,41,0,8
344,0,206,1,96,95,0,12,1,34,33,0,12,1,42,41,0.0,0.007352190340038803,1,64,63,3,-1,4,2,1,86,50,27
345,0,616,1,100,99,0,60,1,52,51,0,60,1,59,58,0.0,0.021580040164743523,1,86,85,2,-1,3,5,0,49,86,9
346,6,6,28,28,0,43,43,30,30,0,6,6,28,28,0,0.00017018959120460194,0.00017018959120460194,29,29,0,-1,4,4,16,1,4,60,92
347,22,22,45,45,0,46,46,40,40,0,22,22,45,45,0,0.002382654276864427,0.002382654276864427,47,47,0,-1,3,3,6,2,44,75,92
348,2,102,29,79,50,14,14,29,29,0,2,4,29,32,3,0.00013615167296368154,0.0007147962830593281,30,35,5,4,5,5,9,1,26,55,51
349,326,926,98,100,2,348,348,94,94,0,326,348,98,98,0,0.019912182170938427,0.02927260968719153,82,89,7,2,2,2,17,16,20,12,39
350,136,752,82,100,18,186,196,70,71,1,136,196,82,87,5,0.01330882603219987,0.028728002995336805,75,90,15,2,2,2,12,8,14,20,23
351,100,100,61,61,0,100,100,43,43,0,100,100,61,61,0,0.021035433472888797,0.04047108478845434,80,97,17,2,1,1,12,6,2,34,1
352,128,328,82,98,16,90,90,71,71,0,90,90,73,73,0,0.01412573606998196,0.020763130126961436,77,81,4,3,2,2,6,14,69,32,8
353,0,616,1,100,99,0,38,1,33,32,0,20,1,40,39,0.0,0.0016338200755641784,1,41,40,2,-1,3,10,0,18,36,43
354,583,583,100,100,0,432,432,100,100,0,432,432,100,100,0,0.03897341638585384,0.03897341638585384,96,96,0,-1,2,2,15,29,7,1,99
355,6,6,29,29,0,19,19,32,32,0,6,6,29,29,0,0.00010211375472276115,0.00010211375472276115,29,29,0,-1,4,4,7,1,43,95,82
356,0,206,1,88,87,0,19,1,26,25,0,6,1,27,26,0.0,0.0002042275094455223,1,28,27,3,-1,4,14,0,17,84,65
357,6,6,29,29,0,48,48,34,34,0,6,6,29,29,0,0.00037441710065012424,0.00037441710065012424,32,32,0,-1,4,4,12,1,3,88,59
358,0,102,1,79,78,0,9,1,30,29,0,3,1,31,30,0.0,0.00037441710065012424,1,33,32,4,-1,5,5,0,45,36,56
359,81,287,71,99,28,68,68,77,77,0,68,68,79,79,0,0.010143299635794275,0.011811157629599374,69,73,4,3,2,2,4,8,72,44,51
360,42,658,53,100,47,98,98,54,54,0,40,98,51,63,12,0.0034037918240920387,0.011266550937744648,51,71,20,2,3,3,8,6,10,41,34
361,80,80,66,66,0,88,88,73,73,0,88,88,74,74,0,0.007590455767725246,0.007590455767725246,61,61,0,-1,2,2,4,6,83,28,98
362,38,38,51,51,0,56,56,46,46,0,38,38,51,51,0,0.0030293747234419145,0.0030293747234419145,49,49,0,-1,3,3,6,6,74,70,69
363,150,356,84,98,14,176,176,85,85,0,150,176,87,88,1,0.014261887742945642,0.019639878825011062,77,82,5,3,2,2,8,8,30,20,48
364,48,254,51,90,39,184,184,72,72,0,48,57,52,53,1,0.0035739814152966403,0.0046972327172470135,49,55,6,3,3,3,14,6,17,70,54
365,128,230,82,93,11,90,90,71,71,0,90,90,73,73,0,0.01412573606998196,0.014398039415909322,77,77,0,4,2,2,6,14,69,32,56
366,91,91,75,75,0,48,48,66,66,0,48,48,67,67,0,0.017291262466387555,0.017291262466387555,81,81,0,-1,3,3,3,12,76,37,86
367,42,1682,52,100,48,94,128,51,76,25,40,80,51,62,11,0.003642057251778481,0.018074134585928724,51,81,30,1,3,2,9,6,23,41,94
368,16,117,37,77,40,34,34,35,35,0,16,17,37,40,3,0.0005786446100956465,0.0005786446100956465,35,35,0,6,3,3,6,1,65,4,58
369,97,198,79,96,17,46,46,84,84,0,46,46,84,84,0,0.017121072875182955,0.017121072875182955,81,81,0,6,2,2,2,13,93,33,78
370,111,111,74,74,0,94,94,62,62,0,94,94,69,69,0,0.008373327887266415,0.008373327887266415,62,62,0,-1,2,2,5,8,52,57,93
371,8,8,38,38,0,20,20,34,34,0,8,8,38,38,0,0.0008509479560230097,0.0008509479560230097,40,40,0,-1,4,4,4,3,84,51,82
372,100,100,67,67,0,100,100,74,74,0,100,100,75,75,0,0.035875965825930084,0.05146533238027162,93,96,3,2,1,1,5,6,63,34,16
373,212,212,95,95,0,38,38,56,56,0,38,38,57,57,0,0.030293747234419143,0.030293747234419143,90,90,0,-1,3,3,3,27,60,10,87
374,0,616,1,100,99,0,28,1,42,41,0,28,1,49,48,0.0,0.013785356887572755,1,80,79,2,-1,3,3,0,75,36,12
375,54,155,65,90,25,48,48,68,68,0,48,48,69,69,0,0.009360427516253106,0.009530617107457708,70,72,2,5,3,3,3,7,81,48,55
376,0,0,1,1,0,0,0,1,1,0,0,0,1,1,0,0.0,0.0,1,1,0,-1,-1,-1,6,1,71,50,69
377,88,189,68,89,21,92,92,86,86,0,87,87,76,76,0,0.008679669151434699,0.008679669151434699,67,67,0,6,2,2,4,6,79,41,68
378,0,616,1,100,99,0,40,1,39,38,0,40,1,48,47,0.0,0.010790020082371761,1,71,70,2,-1,3,5,0,50,84,33
379,22,228,46,94,48,54,54,62,62,0,22,54,46,67,21,0.0022465026039007454,0.009905034208107831,46,70,24,3,3,3,4,2,72,52,20
380,0,0,1,1,0,0,0,1,1,0,0,0,1,1,0,0.0,0.0,1,1,0,-1,-1,-1,3,0,96,66,93
381,0,0,1,1,0,0,0,1,1,0,0,0,1,1,0,0.0,0.0,1,1,0,-1,-1,-1,8,0,21,86,59
382,0,0,1,1,0,0,0,1,1,0,0,0,1,1,0,0.0,0.0,1,1,0,-1,-1,-1,5,0,70,96,85
383,94,94,77,77,0,32,32,69,69,0,32,32,69,69,0,0.021035433472888797,0.021035433472888797,86,86,0,-1,3,3,2,20,93,23,59
384,80,80,58,58,0,130,130,65,65,0,80,80,58,58,0,0.006092787365124749,0.006092787365124749,57,57,0,-1,3,3,10,6,36,26,80
385,0,102,1,73,72,0,14,1,26,25,0,2,1,25,24,0.0,0.0,1,1,0,4,-1,5,12,0,6,76,95
386,0,616,1,100,99,0,46,1,49,48,0,46,1,52,51,0.0,0.013581129378127233,1,76,75,2,-1,3,5,0,37,67,12
387,0,0,1,1,0,0,0,1,1,0,0,0,1,1,0,0.0,0.0,1,1,0,-1,-1,-1,4,0,67,81,87
388,0,102,1,79,78,0,7,1,24,23,0,4,1,26,25,0.0,0.0006807583648184077,1,34,33,4,-1,5,4,0,67,81,74
389,132,332,82,97,15,154,154,72,72,0,132,154,82,85,3,0.013547091459886314,0.017018959120460194,76,81,5,3,2,2,10,8,36,8,13
390,22,228,44,93,49,40,40,45,45,0,22,31,44,50,6,0.001497668402600497,0.002825147213996392,43,48,5,3,3,3,5,2,37,61,43
391,88,294,66,95,29,66,66,47,47,0,66,66,55,55,0,0.011334626774226489,0.011777119711358454,68,69,1,3,3,3,6,8,71,8,49
392,125,331,88,98,10,48,48,65,65,0,48,48,68,68,0,0.014364001497668403,0.019844106334456584,80,83,3,3,3,3,3,15,66,19,24
393,6,6,27,27,0,24,24,36,36,0,6,6,27,27,0,0.003369753905851118,0.003369753905851118,46,46,0,-1,4,4,4,1,67,90,81
394,92,692,77,100,23,28,28,44,44,0,28,28,51,51,0,0.01589570781850982,0.03795227883862623,80,92,12,2,3,3,3,16,92,12,7
395,84,290,76,99,23,56,56,84,84,0,56,56,85,85,0,0.01494264610776405,0.02314578440382586,80,88,8,3,2,2,2,7,98,48,33
396,18,634,44,100,56,62,72,46,48,2,18,36,44,50,6,0.0015657442390823377,0.0051397256543789785,43,52,9,2,3,3,7,2,62,61,75
397,64,270,59,94,35,80,80,65,65,0,64,70,61,62,1,0.007420266176520644,0.009939072126348753,63,69,6,3,3,3,5,4,37,38,46
398,0,616,1,100,99,0,136,1,58,57,0,115,1,79,78,0.0,0.016712617856291908,1,79,78,2,-1,3,16,0,4,76,23
399,39,655,46,100,54,94,104,45,61,16,39,104,46,72,26,0.003778208924742163,0.012696143503863304,50,72,22,2,3,3,9,4,29,22,20
400,46,662,53,100,47,64,74,57,63,6,46,74,52,69,17,0.004935498144933456,0.01664454201981007,52,78,26,2,2,2,5,2,88,52,19
401,60,162,56,87,31,50,50,49,49,0,60,50,56,55,-1,0.005854521937438306,0.005990673610401988,57,57,0,4,3,3,5,6,61,26,4
402,44,660,57,100,43,22,22,54,54,0,22,22,54,54,0,0.006603356138738555,0.02226079852956193,62,87,25,2,3,3,2,4,99,72,16
403,116,322,78,94,16,120,120,79,79,0,120,120,81,81,0,0.01415977398822288,0.014466115252391163,78,79,1,3,2,2,6,8,44,17,49
404,75,1715,60,100,40,118,152,75,81,6,75,115,60,79,19,0.007386228258279724,0.018857006705469893,60,80,20,1,2,2,9,6,26,35,49
405,100,100,66,66,0,100,100,43,43,0,100,100,66,66,0,0.020729092208720514,0.021648116001225366,85,86,1,3,1,1,11,6,33,13,64
406,40,40,46,46,0,158,158,68,68,0,40,40,46,46,0,0.003880322679464924,0.003880322679464924,51,51,0,-1,2,2,14,3,17,46,40
407,2,618,27,100,73,7,56,27,45,18,2,56,27,57,30,3.4037918240920386e-05,0.02236291228428469,26,85,59,2,5,3,6,1,74,68,10
408,516,2116,100,100,0,152,152,94,94,0,152,152,94,94,0,0.04680213758126553,0.07587051975901155,95,100,5,1,2,2,5,40,52,3,9
409,209,209,94,94,0,144,144,90,90,0,144,144,90,90,0,0.023622315259198747,0.023622315259198747,87,87,0,-1,2,2,6,20,59,23,92
410,6,622,28,100,72,32,146,29,66,37,6,123,28,77,49,0.0002042275094455223,0.015419176963136935,32,79,47,2,4,3,16,1,9,55,18
411,18,224,44,91,47,108,108,67,67,0,18,38,44,52,8,0.0018380475850097008,0.006977773239388679,43,61,18,3,3,3,8,2,57,61,72
412,0,0,1,1,0,0,0,1,1,0,0,0,1,1,0,0.0,0.0,1,1,0,-1,-1,-1,2,0,91,98,50
413,0,0,1,1,0,0,0,1,1,0,0,0,1,1,0,0.0,0.0,1,1,0,-1,-1,-1,8,0,57,93,80
414,56,672,54,100,46,164,164,74,74,0,56,109,54,78,24,0.006297014874570271,0.011879233466081215,58,73,15,2,2,2,10,3,1,29,57
415,166,166,84,84,0,208,208,85,85,0,166,166,84,84,0,0.014874570271282209,0.014874570271282209,76,76,0,-1,2,2,10,9,18,39,85
416,0,101,1,75,74,0,8,1,25,24,0,1,1,25,24,0.0,0.0,1,1,0,5,-1,6,8,0,21,86,68
417,16,16,34,34,0,40,40,33,33,0,16,16,34,34,0,0.0002042275094455223,0.0002042275094455223,33,33,0,-1,3,3,11,1,33,4,79
418,47,47,55,55,0,64,64,59,59,0,64,64,63,63,0,0.0053439531638245,0.0053439531638245,55,55,0,-1,3,3,4,6,53,35,59
419,36,242,54,92,38,44,44,50,50,0,35,44,55,56,1,0.004356853534837809,0.00789679703189353,54,64,10,3,3,3,4,6,84,41,47
420,158,260,86,95,9,94,94,71,71,0,94,94,72,72,0,0.014261887742945642,0.014364001497668403,77,77,0,4,2,2,5,14,63,32,65
421,18,18,44,44,0,42,42,41,41,0,18,18,44,44,0,0.0020422750944552232,0.0020422750944552232,45,45,0,-1,3,3,6,2,32,83,59
422,100,100,70,70,0,100,100,53,53,0,100,100,70,70,0,0.05544776881445931,0.05800061268252834,100,100,0,2,1,1,9,29,31,0,26
423,278,878,93,100,7,310,310,94,94,0,278,310,93,95,2,0.016916845365737433,0.023622315259198747,76,87,11,2,2,2,14,14,25,14,31
424,6,622,30,100,70,12,44,30,48,18,6,44,30,52,22,0.00017018959120460194,0.014874570271282209,31,77,46,2,4,3,4,1,53,60,37
425,166,267,87,95,8,104,104,82,82,0,104,104,83,83,0,0.017223186629905716,0.017223186629905716,80,80,0,5,2,2,5,13,50,33,58
426,100,100,80,80,0,100,100,98,98,0,100,100,98,98,0,0.09547636066578168,0.09547636066578168,100,100,0,-1,1,1,2,16,93,18,99
427,16,16,35,35,0,88,88,48,48,0,16,16,35,35,0,0.003165526396405596,0.003165526396405596,49,49,0,-1,3,3,8,1,15,90,76
428,40,246,48,93,45,176,176,70,70,0,40,53,48,53,5,0.003778208924742163,0.006569318220497634,52,59,7,3,2,2,12,3,6,46,73
429,0,616,1,100,99,0,68,1,45,44,0,68,1,58,57,0.0,0.016474352428605468,1,79,78,2,-1,3,8,0,21,59,16
430,32,132,53,88,35,22,22,49,49,0,22,22,50,50,0,0.008475441641989176,0.008986010415602982,67,67,0,4,3,3,2,5,93,25,83
431,0,102,1,81,80,0,4,1,26,25,0,2,1,26,25,0.0,0.00010211375472276115,1,28,27,4,-1,5,3,0,66,59,4
432,6,212,31,94,63,15,24,31,33,2,6,24,31,47,16,0.00017018959120460194,0.005480104836788182,31,57,26,3,4,4,6,1,32,60,31
433,0,616,1,99,98,0,54,1,33,32,0,18,1,38,37,0.0,0.0015317063208414173,1,41,40,2,-1,3,12,0,6,59,61
434,82,183,72,93,21,72,72,80,80,0,72,72,80,80,0,0.011981347220803976,0.011981347220803976,75,75,0,5,2,2,3,7,66,48,95
435,332,538,96,100,4,216,216,96,96,0,216,216,97,97,0,0.03274447734776541,0.034140031995643146,92,92,0,3,2,2,9,22,35,9,94
436,0,0,1,1,0,0,0,1,1,0,0,0,1,1,0,0.0,0.0,1,1,0,-1,-1,-1,5,0,80,81,84
437,160,160,83,83,0,150,150,86,86,0,150,150,86,86,0,0.01851662752306069,0.01851662752306069,82,82,0,-1,2,2,7,12,43,37,84
438,88,88,57,57,0,218,218,72,72,0,88,88,57,57,0,0.007658531604207087,0.007658531604207087,59,59,0,-1,2,2,14,4,16,72,86
439,0,616,1,100,99,0,44,1,35,34,0,29,1,47,46,0.0,0.003608019333537561,1,48,47,2,-1,3,7,0,43,86,22
440,0,0,1,1,0,0,0,1,1,0,0,0,1,1,0,0.0,0.0,1,1,0,-1,-1,-1,17,0,20,80,97
441,256,872,93,100,7,110,110,74,74,0,110,110,76,76,0,0.021511964328261683,0.03240409816535621,84,90,6,2,2,2,6,19,41,15,39
442,0,616,1,100,99,0,56,1,44,43,0,56,1,52,51,0.0,0.00888389666088022,1,68,67,2,-1,3,6,1,59,50,20
443,124,740,83,100,17,114,114,64,64,0,114,114,81,81,0,0.010721944245889922,0.01415977398822288,71,75,4,2,3,3,9,14,31,32,22
444,6,1646,29,100,71,29,122,31,59,28,6,100,29,61,32,0.0002042275094455223,0.020150447598624867,31,80,49,1,4,2,12,1,3,65,39
445,2,208,29,90,61,14,46,29,38,9,2,46,29,51,22,0.00013615167296368154,0.008441403723748256,30,64,34,3,5,4,9,1,26,60,33
446,226,842,90,100,10,214,214,86,86,0,214,214,90,90,0,0.019741992579733823,0.02042275094455223,81,84,3,2,2,2,11,18,33,30,56
447,6,1646,27,100,73,36,70,34,48,14,6,70,27,55,28,0.00017018959120460194,0.02307770856734402,30,87,57,1,4,2,6,1,40,49,20
448,32,648,45,100,55,184,184,67,67,0,32,48,45,51,6,0.0025188059498281084,0.0051397256543789785,47,55,8,2,3,3,14,2,16,61,46
449,22,228,43,92,49,44,48,36,37,1,22,28,43,47,4,0.0018040096667687805,0.002552843868069029,42,46,4,3,3,3,7,3,43,51,71
450,6,6,29,29,0,28,28,30,30,0,6,6,29,29,0,0.00017018959120460194,0.00017018959120460194,31,31,0,-1,4,4,10,1,18,65,91
451,98,199,77,92,15,78,78,77,77,0,78,78,79,79,0,0.014432077334150244,0.014602266925354846,78,78,0,5,2,2,4,8,78,8,4
452,1,1,26,26,0,7,7,26,26,0,1,1,26,26,0,0.00010211375472276115,0.00010211375472276115,30,30,0,-1,6,6,7,1,46,78,67
453,22,228,51,92,41,38,38,49,49,0,22,38,51,53,2,0.0040845501889104465,0.010211375472276116,54,71,17,3,3,3,3,3,87,29,48
454,84,84,63,63,0,152,152,83,83,0,84,84,63,63,0,0.010619830491167161,0.010619830491167161,68,68,0,-1,2,2,8,5,21,25,36
455,0,0,1,1,0,0,0,1,1,0,0,0,1,1,0,0.0,0.0,1,1,0,-1,-1,-1,5,0,70,66,80
456,242,442,94,99,5,216,216,93,93,0,216,216,94,94,0,0.02413288403281255,0.025936893699581333,86,88,2,3,2,2,9,16,28,18,41
457,66,168,69,89,20,38,38,52,52,0,38,38,55,55,0,0.008203138296061813,0.009190237925048503,68,69,1,4,3,3,3,7,66,21,64
458,350,350,100,100,0,88,88,84,84,0,88,88,84,84,0,0.04819769222914327,0.04819769222914327,99,99,0,-1,2,2,4,36,67,2,93
459,1,207,25,97,72,2,8,25,34,9,1,8,25,40,15,3.4037918240920386e-05,0.0037441710065012424,26,50,24,3,6,4,2,1,97,78,41
460,0,206,1,89,88,0,18,1,32,31,0,22,1,47,46,0.0,0.003812246842983083,1,52,51,3,-1,4,5,0,61,79,26
461,16,16,36,36,0,52,52,39,39,0,16,16,36,36,0,0.001055175465468532,0.001055175465468532,38,38,0,-1,3,3,7,1,43,71,67
462,100,100,65,65,0,100,100,45,45,0,100,100,65,65,0,0.025358249089485686,0.028796078831818644,86,91,5,2,1,1,10,6,12,77,90
463,0,1640,1,100,99,0,56,1,81,80,0,56,1,81,80,0.0,0.0758024439225297,1,98,97,1,-1,2,2,0,89,93,3
464,76,692,70,100,30,48,48,66,66,0,48,48,67,67,0,0.008271214132543654,0.029476837196637053,66,89,23,2,3,3,3,7,76,21,0
465,6,212,32,91,59,20,24,34,37,3,6,24,32,49,17,0.0012253650566731338,0.005684332346233704,41,57,16,3,4,4,4,1,79,71,13
466,16,222,36,93,57,74,74,45,45,0,16,52,36,54,18,0.0023486163586235067,0.008373327887266415,47,68,21,3,3,3,9,1,35,53,21
467,0,616,1,100,99,0,86,1,34,33,0,44,1,51,50,0.0,0.006024711528642908,1,56,55,2,-1,3,14,0,16,67,48
468,16,16,34,34,0,120,120,58,58,0,16,16,34,34,0,0.0020422750944552232,0.0020422750944552232,44,44,0,-1,3,3,14,2,16,94,96
469,0,206,1,92,91,0,15,1,29,28,0,8,1,34,33,0.0,0.0015657442390823377,1,42,41,3,-1,4,6,0,65,86,83
470,234,440,92,98,6,134,134,90,90,0,134,134,90,90,0,0.02205657102011641,0.029408761360155213,85,89,4,3,2,2,6,16,48,12,77
471,60,161,68,89,21,38,38,56,56,0,38,38,57,57,0,0.005650294427992784,0.005820484019197386,55,55,0,5,3,3,3,5,60,47,55
472,363,363,98,98,0,152,152,99,99,0,152,152,99,99,0,0.0405731985431771,0.0405731985431771,95,95,0,-1,2,2,5,29,70,1,36
473,44,250,58,96,38,64,64,68,68,0,44,64,63,70,7,0.00789679703189353,0.0088498587426393,67,67,0,3,3,3,4,7,72,62,54
474,0,616,1,99,98,0,106,1,54,53,0,106,1,77,76,0.0,0.017325300384628477,1,79,78,2,-1,3,11,0,33,97,23
475,163,163,85,85,0,136,136,81,81,0,136,136,82,82,0,0.01681473161101467,0.01681473161101467,79,79,0,-1,2,2,7,15,43,19,80
476,2,1642,26,100,74,12,128,28,66,38,2,128,26,77,51,6.807583648184077e-05,0.04013070560604513,29,93,64,1,5,2,9,1,28,78,1
477,0,0,1,1,0,0,0,1,1,0,0,0,1,1,0,0.0,0.0,1,1,0,-1,-1,-1,14,0,17,66,92
478,100,100,57,57,0,100,100,38,38,0,100,100,57,57,0,0.03427618366860683,0.04598522754348344,93,98,5,2,1,1,16,16,4,12,37
479,62,268,53,94,41,92,92,47,47,0,62,68,53,57,4,0.00353994349705572,0.004322815616596889,51,53,2,3,2,2,8,3,42,54,71
480,0,0,1,1,0,0,0,1,1,0,0,0,1,1,0,0.0,0.0,1,1,0,-1,-1,-1,6,0,40,82,81
481,178,794,88,100,12,190,190,94,94,0,190,190,94,94,0,0.018788930868988054,0.03066816433506927,81,89,8,2,2,2,8,12,21,37,5
482,516,618,100,100,0,152,152,94,94,0,152,152,94,94,0,0.04680213758126553,0.04680213758126553,95,95,0,4,2,2,5,40,52,3,95
483,0,0,1,1,0,0,0,1,1,0,0,0,1,1,0,0.0,0.0,1,1,0,-1,-1,-1,9,0,31,67,99
484,36,36,56,56,0,34,34,47,47,0,34,34,55,55,0,0.0046972327172470135,0.0046972327172470135,56,56,0,-1,3,3,4,6,78,28,82
485,339,339,98,98,0,152,152,98,98,0,152,152,98,98,0,0.04360257326661901,0.04360257326661901,96,96,0,-1,2,2,5,29,45,11,50
486,0,101,1,75,74,0,6,1,25,24,0,1,1,25,24,0.0,0.0,1,1,0,5,-1,6,6,0,34,59,95
487,126,126,78,78,0,88,88,47,47,0,88,88,61,61,0,0.008135062459579971,0.008135062459579971,64,64,0,-1,3,3,8,13,10,24,85
488,252,868,93,100,7,158,158,95,95,0,158,158,95,95,0,0.025154021580040164,0.03451444909629327,87,92,5,2,2,2,6,16,40,18,27
489,16,16,43,43,0,30,30,45,45,0,16,16,44,44,0,0.0007488342013002485,0.0007488342013002485,38,38,0,-1,3,3,4,2,77,42,50
490,0,616,1,100,99,0,34,1,43,42,0,34,1,51,50,0.0,0.012798257258586064,1,77,76,2,-1,3,4,0,47,66,5
491,16,16,35,35,0,100,100,45,45,0,16,16,35,35,0,0.0026549576227917903,0.0026549576227917903,47,47,0,-1,3,3,10,2,1,94,76
492,0,0,1,1,0,0,0,1,1,0,0,0,1,1,0,0.0,0.0,1,1,0,-1,-1,-1,2,0,68,91,97
493,97,303,63,94,31,118,118,63,63,0,97,118,63,77,14,0.00888389666088022,0.009258313761530345,65,67,2,3,3,3,8,8,42,44,56
494,262,878,95,100,5,208,208,89,89,0,208,208,94,94,0,0.021682153919466287,0.04132203274447735,86,94,8,2,2,2,10,19,36,15,7
495,132,338,80,98,18,86,86,56,56,0,86,86,66,66,0,0.013887470642295518,0.018380475850097007,76,82,6,3,3,3,6,13,59,33,57
496,144,760,82,100,18,224,224,88,88,0,144,224,82,90,8,0.010075223799312433,0.02746860002042275,70,89,19,2,2,2,11,7,33,21,15
497,29,29,52,52,0,22,22,49,49,0,22,22,50,50,0,0.003710133088260322,0.003710133088260322,51,51,0,-1,3,3,2,4,93,22,82
498,100,100,82,82,0,100,100,98,98,0,100,100,98,98,0,0.10075223799312434,0.10075223799312434,99,99,0,-1,1,1,2,20,98,23,91
499,16,222,36,91,55,96,96,44,44,0,16,26,36,45,9,0.003880322679464924,0.0053099152455835805,51,58,7,3,3,3,11,1,38,90,54
500,40,656,51,100,49,118,138,64,68,4,40,138,51,81,30,0.004016474352428605,0.019741992579733823,52,83,31,2,2,2,9,2,28,94,30
501,54,54,56,56,0,50,50,50,50,0,54,54,55,55,0,0.007216038667075122,0.007216038667075122,61,61,0,-1,3,3,5,4,70,38,66
502,1,617,26,100,74,3,28,26,44,18,1,28,26,48,22,0.00010211375472276115,0.009939072126348753,30,68,38,2,6,3,3,1,60,78,20
503,96,96,75,75,0,38,38,51,51,0,38,38,54,54,0,0.009258313761530345,0.009258313761530345,67,67,0,-1,3,3,3,13,94,24,69
504,100,100,77,77,0,100,100,97,97,0,100,100,97,97,0,0.04969536063174376,0.09676980155893665,97,100,3,1,1,1,3,1,55,78,37
505,42,248,57,99,42,46,46,81,81,0,42,46,81,81,0,0.010007147962830594,0.028830116750059566,70,93,23,3,2,2,2,2,89,74,1
506,94,300,71,95,24,76,76,60,60,0,76,76,65,65,0,0.010687906327649,0.01157289220191293,70,70,0,3,3,3,6,9,69,27,61
507,100,100,63,63,0,100,100,47,47,0,100,100,63,63,0,0.06375302086524388,0.06375302086524388,100,100,0,-1,1,1,10,36,22,2,96
508,100,100,66,66,0,100,100,49,49,0,100,100,66,66,0,0.017972020831205963,0.01865277919602437,79,81,2,3,1,1,9,1,54,4,71
509,0,206,1,92,91,0,13,1,30,29,0,9,1,36,35,0.0,0.0010211375472276116,1,38,37,3,-1,4,5,0,37,76,64
510,0,0,1,1,0,0,0,1,1,0,0,0,1,1,0,0.0,0.0,1,1,0,-1,-1,-1,5,0,52,59,79
511,0,0,1,1,0,0,0,1,1,0,0,0,1,1,0,0.0,0.0,1,1,0,-1,-1,-1,3,1,76,50,66
512,2,1642,28,100,72,8,60,28,50,22,2,60,28,61,33,0.00013615167296368154,0.03744171006501242,30,94,64,1,5,2,5,1,45,65,10
513,0,616,1,99,98,0,96,1,42,41,0,96,1,58,57,0.0,0.012185574730249497,1,73,72,2,-1,3,11,0,5,66,6
514,256,456,97,100,3,86,86,94,94,0,86,86,94,94,0,0.03887130263113108,0.046223492971169886,93,96,3,3,2,2,3,27,55,10,20
515,16,632,35,100,65,32,96,29,40,11,16,50,35,52,17,0.0008509479560230097,0.0038462847612240037,35,51,16,2,3,3,13,2,13,58,70
516,100,100,67,67,0,100,100,55,55,0,100,100,67,67,0,0.03788420300214439,0.07998910786616291,96,100,4,1,1,1,9,15,23,16,2
517,70,686,67,100,33,62,62,80,80,0,62,62,80,80,0,0.00789679703189353,0.01497668402600497,61,78,17,2,2,2,3,6,55,26,21
518,6,6,28,28,0,13,13,28,28,0,6,6,28,28,0,0.0,0.0,1,1,0,-1,4,4,5,1,50,95,97
519,32,632,46,100,54,96,96,43,43,0,32,72,46,54,8,0.0005786446100956465,0.004799346471969774,36,53,17,2,3,3,11,2,5,56,13
520,100,306,70,95,25,100,100,68,68,0,100,100,73,73,0,0.00980292045338507,0.018176248340651485,69,82,13,3,2,2,6,7,48,21,19
521,0,206,1,94,93,0,24,1,35,34,0,24,1,46,45,0.0,0.008441403723748256,1,67,66,3,-1,4,4,0,53,76,32
522,278,894,95,100,5,344,344,93,93,0,278,344,95,98,3,0.02552843868069029,0.02750263793866367,87,89,2,2,2,2,17,15,20,16,70
523,54,670,55,100,45,94,114,51,66,15,54,114,55,79,24,0.006943735321147759,0.01756356581231492,63,80,17,2,3,3,9,4,23,38,27
524,20,226,45,95,50,32,32,58,58,0,32,32,60,60,0,0.0022465026039007454,0.007182000748834201,46,61,15,3,3,3,2,3,91,43,25
525,100,100,68,68,0,100,100,63,63,0,100,100,68,68,0,0.054494707103713534,0.062153238707920624,99,100,1,2,1,1,6,15,41,16,17
526,260,1900,94,100,6,224,248,98,100,2,224,248,98,100,2,0.021648116001225366,0.04945709520405732,84,97,13,1,2,2,8,18,10,5,23
527,160,261,89,96,7,152,152,82,82,0,152,152,88,88,0,0.0160318594914735,0.01606589740971442,79,79,0,6,2,2,8,15,39,19,58
528,12,1652,36,100,64,30,96,35,62,27,12,96,36,67,31,0.000442492937131965,0.03975628850539501,35,96,61,1,4,2,7,2,62,56,10
529,0,616,1,100,99,0,52,1,41,40,0,52,1,54,53,0.0,0.015112835698968652,1,77,76,2,-1,3,7,0,62,85,6
530,46,662,53,100,47,84,94,48,50,2,46,94,53,63,10,0.002825147213996392,0.012185574730249497,47,70,23,2,2,2,9,2,23,52,14
531,70,686,59,100,41,104,104,81,81,0,70,104,60,83,23,0.005786446100956465,0.014329963579427483,56,79,23,2,2,2,5,6,61,28,62
532,331,331,99,99,0,88,88,71,71,0,88,88,71,71,0,0.03182545355526056,0.03182545355526056,94,94,0,-1,2,2,4,29,53,1,85
533,58,264,72,100,28,22,22,55,55,0,22,22,57,57,0,0.006943735321147759,0.010007147962830594,63,70,7,3,3,3,2,13,97,24,83
534,6,6,29,29,0,19,19,29,29,0,6,6,29,29,0,0.00010211375472276115,0.00010211375472276115,30,30,0,-1,4,4,8,1,42,60,87
535,176,382,89,98,9,152,152,95,95,0,152,152,95,95,0,0.024507301133462677,0.027536675856904592,89,89,0,3,2,2,5,9,63,39,73
536,2,1642,27,100,73,5,68,27,65,38,2,68,27,68,41,0.0,0.04077742605262262,1,95,94,1,5,2,4,1,53,68,16
537,12,212,37,94,57,12,12,32,32,0,12,12,37,37,0,0.0018380475850097008,0.00888389666088022,44,65,21,3,4,4,2,2,91,83,27
538,0,0,1,1,0,0,0,1,1,0,0,0,1,1,0,0.0,0.0,1,1,0,-1,-1,-1,3,0,55,82,89
539,12,218,36,93,57,30,30,41,41,0,12,20,36,47,11,0.002110350930937064,0.003608019333537561,45,50,5,3,4,4,5,2,70,61,83
540,16,632,35,100,65,120,130,62,65,3,16,32,35,42,7,0.0019741992579733825,0.0034037918240920387,42,48,6,2,3,3,10,1,12,53,71
541,6,212,33,95,62,8,8,33,33,0,6,8,33,37,4,0.00034037918240920387,0.004935498144933456,35,56,21,3,4,4,2,1,89,49,38
542,100,100,58,58,0,100,100,38,38,0,100,100,58,58,0,0.013410939786922631,0.015317063208414174,72,76,4,2,1,1,16,4,9,22,53
543,70,70,62,62,0,64,64,67,67,0,64,64,68,68,0,0.006331052792811192,0.006331052792811192,54,54,0,-1,3,3,4,5,67,47,84
544,2,618,28,100,72,11,38,29,38,9,2,38,28,54,26,0.00017018959120460194,0.008951972497362062,31,66,35,2,5,3,6,1,44,55,8
545,363,363,97,97,0,168,168,96,96,0,168,168,96,96,0,0.036624800027230335,0.036624800027230335,92,92,0,-1,2,2,6,30,48,7,98
546,100,100,63,63,0,100,100,39,39,0,100,100,63,63,0,0.018891044623710815,0.018891044623710815,79,79,0,-1,1,1,14,6,17,13,76
547,24,640,45,100,55,64,94,39,50,11,24,94,45,63,18,0.0017018959120460194,0.0123557643214541,44,71,27,2,3,3,9,3,23,43,27
548,76,692,65,100,35,108,118,69,74,5,76,118,65,80,15,0.006331052792811192,0.02198849518363457,61,85,24,2,3,3,8,6,39,13,16
549,1,617,26,99,73,11,72,26,38,12,1,49,26,51,25,0.0,0.006262976956329351,1,57,56,2,6,3,11,1,33,78,48
550,90,290,68,95,27,104,104,86,86,0,104,104,87,87,0,0.011743081793117532,0.014874570271282209,70,78,8,3,2,2,5,6,49,77,35
551,125,125,79,79,0,102,102,65,65,0,102,102,74,74,0,0.016202049082678104,0.016202049082678104,79,79,0,-1,3,3,7,12,46,37,36
552,0,0,1,1,0,0,0,1,1,0,0,0,1,1,0,0.0,0.0,1,1,0,-1,-1,-1,3,0,55,85,50
553,0,206,1,93,92,0,32,1,36,35,0,18,1,40,39,0.0,0.0030293747234419145,1,50,49,3,-1,4,6,0,34,81,35
554,128,128,80,80,0,252,252,83,83,0,128,128,80,80,0,0.0068075836481840775,0.0068075836481840775,60,60,0,-1,2,2,14,5,8,47,69
555,35,241,52,97,45,38,38,51,51,0,38,38,54,54,0,0.005207801490860819,0.011062323428299126,53,69,16,3,3,3,3,6,94,73,21
556,2,2,28,28,0,8,8,28,28,0,2,2,28,28,0,0.00017018959120460194,0.00017018959120460194,31,31,0,-1,5,5,5,1,45,60,89
557,18,634,41,100,59,66,102,37,55,18,18,102,41,73,32,0.00034037918240920387,0.017359338302869398,32,76,44,2,3,3,12,2,2,56,9
558,8,214,38,91,53,20,24,34,39,5,8,24,38,50,12,0.0008509479560230097,0.019844106334456584,40,84,44,3,4,4,4,3,84,51,1
559,6,6,30,30,0,20,20,35,35,0,6,6,30,30,0,0.000442492937131965,0.000442492937131965,34,34,0,-1,4,4,4,1,83,49,59
560,6,622,29,100,71,48,68,35,39,4,6,48,29,52,23,0.0005786446100956465,0.005820484019197386,35,57,22,2,4,3,8,1,15,49,28
561,199,199,88,88,0,110,110,72,72,0,110,110,76,76,0,0.023622315259198747,0.023622315259198747,85,85,0,-1,2,2,6,20,40,23,86
562,150,150,90,90,0,72,72,87,87,0,72,72,87,87,0,0.027706865448109193,0.027706865448109193,89,89,0,-1,2,2,3,17,55,6,82
563,0,616,1,100,99,0,46,1,44,43,0,46,1,54,53,0.0,0.011709043874876613,1,75,74,2,-1,3,5,0,45,93,39
564,307,513,97,100,3,144,144,98,98,0,144,144,98,98,0,0.04098165356206814,0.042138942782259436,96,96,0,3,2,2,6,29,69,0,94
565,80,182,72,92,20,48,48,66,66,0,48,48,67,67,0,0.009292351679771264,0.011130399264780965,69,71,2,4,3,3,3,9,76,31,75
566,8,624,38,100,62,24,34,40,43,3,8,34,38,51,13,0.00037441710065012424,0.004493005207801491,35,55,20,2,4,3,4,2,47,56,41
567,16,118,35,81,46,34,34,39,39,0,16,19,35,40,5,0.002144388849177984,0.0024507301133462676,40,41,1,4,3,3,4,1,67,53,56
568,298,298,95,95,0,160,160,93,93,0,160,160,94,94,0,0.02900030634126417,0.02900030634126417,89,89,0,-1,2,2,7,22,62,9,81
569,6,622,27,100,73,17,82,27,39,12,6,80,27,57,30,0.00013615167296368154,0.009496579189216788,30,65,35,2,4,3,12,1,2,78,8
570,6,622,32,100,68,10,28,32,45,13,6,28,32,52,20,0.0002382654276864427,0.016168011164437182,31,78,47,2,4,3,3,1,81,65,15
571,233,233,99,99,0,56,56,82,82,0,56,56,82,82,0,0.037373634228530586,0.037373634228530586,96,96,0,-1,2,2,2,29,89,11,66
572,422,1022,99,100,1,144,144,91,91,0,144,144,92,92,0,0.047993464719697745,0.05350760747472685,99,99,0,2,2,2,6,36,51,2,24
573,0,101,1,78,77,0,5,1,25,24,0,1,1,25,24,0.0,0.00010211375472276115,1,28,27,5,-1,6,5,0,88,89,55
574,132,732,80,100,20,96,96,67,67,0,96,96,70,70,0,0.013887470642295518,0.02825147213996392,75,89,14,2,3,3,6,14,65,14,19
575,2,618,26,100,74,10,68,27,40,13,2,68,26,58,32,3.4037918240920386e-05,0.01695088328397835,26,81,55,2,5,3,8,1,30,68,23
576,294,294,96,96,0,192,192,91,91,0,192,192,91,91,0,0.03012355764321454,0.03012355764321454,92,92,0,-1,2,2,9,22,26,9,84
577,232,438,88,96,8,258,258,94,94,0,232,238,88,89,1,0.011981347220803976,0.0123557643214541,69,69,0,3,2,2,12,13,2,24,55
578,0,0,1,1,0,0,0,1,1,0,0,0,1,1,0,0.0,0.0,1,1,0,-1,-1,-1,11,1,38,45,79
579,16,222,34,89,55,68,72,36,38,2,16,24,34,42,8,0.0011913271384322134,0.0026209197045508697,39,44,5,3,3,3,11,2,33,42,83
580,0,616,1,100,99,0,66,1,50,49,0,66,1,61,60,0.0,0.018108172504169646,1,83,82,2,-1,3,6,0,34,96,23
581,0,206,1,94,93,0,12,1,39,38,0,12,1,41,40,0.0,0.007454304094761564,1,67,66,3,-1,4,2,1,90,45,27
582,0,206,1,93,92,0,30,1,40,39,0,16,1,39,38,0.0,0.004663194799006093,1,52,51,3,-1,4,5,0,45,66,38
583,16,222,41,95,54,32,32,58,58,0,16,32,41,59,18,0.004152626025392287,0.011198475101262807,52,72,20,3,3,3,2,1,91,90,14
584,1,1,26,26,0,4,4,26,26,0,1,1,26,26,0,3.4037918240920386e-05,3.4037918240920386e-05,26,26,0,-1,6,6,4,2,47,58,87
585,2,208,26,91,65,10,20,26,28,2,2,7,26,32,6,3.4037918240920386e-05,0.0002723033459273631,26,30,4,3,5,4,9,2,31,58,56
586,6,108,33,84,51,12,12,37,37,0,6,8,33,37,4,0.0007488342013002485,0.00088498587426393,38,38,0,4,4,4,2,2,89,42,4
587,0,616,1,100,99,0,22,1,54,53,0,22,1,56,55,0.0,0.03819054426631267,1,95,94,2,-1,3,2,0,97,99,3
588,58,1658,55,100,45,100,100,45,45,0,58,90,55,64,9,0.002110350930937064,0.016542428265087308,43,78,35,1,2,2,10,4,12,64,17
589,0,206,1,92,91,0,30,1,35,34,0,30,1,50,49,0.0,0.012662105585622384,1,73,72,3,-1,4,5,0,63,79,15
590,70,686,59,100,41,128,128,69,69,0,70,128,59,81,22,0.005786446100956465,0.016406276592123625,58,78,20,2,3,3,8,5,30,47,33
591,2,2,28,28,0,5,5,28,28,0,2,2,28,28,0,0.0002382654276864427,0.0002382654276864427,32,32,0,-1,5,5,3,1,96,55,81
592,0,206,1,92,91,0,20,1,34,33,0,20,1,45,44,0.0,0.005650294427992784,1,57,56,3,-1,4,4,0,47,36,34
593,0,206,1,92,91,0,20,1,35,34,0,20,1,50,49,0.0,0.006501242384015794,1,60,59,3,-1,4,4,0,78,86,27
594,0,616,1,100,99,0,42,1,35,34,0,42,1,48,47,0.0,0.012730181422104225,1,71,70,2,-1,3,6,0,56,59,18
595,6,108,33,78,45,18,18,34,34,0,6,9,33,38,5,0.0004765308553728854,0.0007828721195411688,36,37,1,4,4,4,5,1,49,88,56
596,44,44,57,57,0,38,38,59,59,0,38,38,62,62,0,0.006399128629293032,0.006399128629293032,60,60,0,-1,3,3,3,7,92,62,69
597,6,108,32,79,47,18,18,36,36,0,6,10,32,37,5,0.0018040096667687805,0.002484768031587188,45,48,3,4,4,4,3,1,64,53,51
598,314,514,94,98,4,230,230,95,95,0,230,230,95,95,0,0.025358249089485686,0.028693965077095884,86,87,1,3,2,2,9,19,31,15,57
599,0,616,1,100,99,0,116,1,58,57,0,95,1,57,56,0.0,0.007590455767725246,1,58,57,2,-1,3,16,0,9,99,24
600,80,286,59,94,35,140,140,69,69,0,80,94,59,62,3,0.006569318220497634,0.007998910786616291,59,63,4,3,3,3,10,6,22,26,54
601,0,0,1,1,0,0,0,1,1,0,0,0,1,1,0,0.0,0.0,1,1,0,-1,-1,-1,3,1,85,69,99
602,100,100,64,64,0,100,100,44,44,0,100,100,64,64,0,0.024983831988835564,0.024983831988835564,84,84,0,-1,1,1,13,14,13,32,45
603,102,204,70,89,19,104,104,62,62,0,102,104,70,72,2,0.007454304094761564,0.007522379931243405,59,59,0,4,3,3,9,8,29,44,60
604,2,104,28,82,54,7,7,29,29,0,2,6,28,32,4,0.00010211375472276115,0.0014295925661186562,30,41,11,4,5,5,4,1,78,65,83
605,86,702,54,100,46,180,194,64,70,6,86,125,54,82,28,0.003710133088260322,0.008237176214302734,49,62,13,2,2,2,16,3,4,43,57
606,0,616,1,100,99,0,38,1,55,54,0,38,1,58,57,0.0,0.024269035705776234,1,86,85,2,-1,3,3,0,58,82,10
607,168,270,94,100,6,56,56,82,82,0,56,56,82,82,0,0.03179141563701964,0.031995643146465164,94,94,0,4,2,2,2,22,89,9,49
608,0,616,1,100,99,0,62,1,35,34,0,39,1,49,48,0.0,0.005377991082065421,1,55,54,2,-1,3,10,0,36,59,57
609,0,0,1,1,0,0,0,1,1,0,0,0,1,1,0,0.0,0.0,1,1,0,-1,-1,-1,6,0,40,84,59
610,16,632,41,100,59,34,44,43,47,4,16,44,41,53,12,0.003165526396405596,0.012083460975526737,50,72,22,2,3,3,4,3,83,46,20
611,0,206,1,96,95,0,12,1,34,33,0,12,1,42,41,0.0,0.005854521937438306,1,60,59,3,-1,4,2,0,86,80,48
612,88,88,60,60,0,164,164,77,77,0,88,88,60,60,0,0.008475441641989176,0.008475441641989176,65,65,0,-1,2,2,10,4,36,22,79
613,0,0,1,1,0,0,0,1,1,0,0,0,1,1,0,0.0,0.0,1,1,0,-1,-1,-1,8,0,39,66,92
614,24,1664,47,100,53,38,72,46,76,30,24,72,48,78,30,0.0030634126416828346,0.0581027264372511,49,98,49,1,3,2,3,6,96,70,7
615,148,348,90,100,10,56,56,88,88,0,56,56,88,88,0,0.030361823070900983,0.037373634228530586,91,95,4,3,2,2,2,18,93,5,20
616,328,328,95,95,0,224,224,96,96,0,224,224,96,96,0,0.025051907825317403,0.025051907825317403,86,86,0,-1,2,2,8,19,42,15,80
617,175,175,90,90,0,142,142,98,98,0,142,142,98,98,0,0.020763130126961436,0.020763130126961436,85,85,0,-1,2,2,5,9,37,39,45
618,62,164,53,87,34,132,132,63,63,0,62,64,53,55,2,0.0018380475850097008,0.0020082371762143027,42,43,1,4,2,2,12,4,3,64,65
619,100,100,67,67,0,100,100,74,74,0,100,100,75,75,0,0.08019333537560842,0.08019333537560842,100,100,0,-1,1,1,5,40,63,3,82
620,2,618,26,100,74,16,144,27,62,35,2,144,26,82,56,3.4037918240920386e-05,0.022703291466693896,27,86,59,2,5,3,14,1,16,78,7
621,100,100,69,69,0,100,100,55,55,0,100,100,69,69,0,0.03151911229109228,0.03628442084482113,90,92,2,2,1,1,8,14,30,14,31
622,16,632,39,100,61,86,86,57,57,0,16,86,39,63,24,0.0030293747234419145,0.011709043874876613,50,72,22,2,3,3,6,3,44,46,8
623,98,304,77,98,21,78,78,77,77,0,78,78,79,79,0,0.014432077334150244,0.019061234214915415,78,80,2,3,2,2,4,8,78,8,38
624,0,616,1,100,99,0,62,1,34,33,0,18,1,37,36,0.0,0.00176997174852786,1,41,40,2,-1,3,14,0,8,99,61
625,231,431,94,100,6,72,72,86,86,0,72,72,86,86,0,0.03761189965621702,0.04489601415977399,92,94,2,3,2,2,3,29,92,0,20
626,0,0,1,1,0,0,0,1,1,0,0,0,1,1,0,0.0,0.0,1,1,0,-1,-1,-1,14,0,8,67,50
627,0,1640,1,100,99,0,52,1,74,73,0,52,1,75,74,0.0,0.04339834575717349,1,95,94,1,-1,2,3,0,82,96,30
628,2,103,28,82,54,4,4,31,31,0,2,2,28,28,0,0.0002723033459273631,0.0002723033459273631,32,32,0,6,5,5,2,1,95,55,78
629,168,374,87,98,11,128,128,69,69,0,128,128,82,82,0,0.012491915994417782,0.012900371013308825,75,76,1,3,3,3,8,14,30,32,56
630,0,1640,1,100,99,0,90,1,48,47,0,90,1,61,60,0.0,0.022601177711971135,1,84,83,1,-1,2,9,0,35,59,12
631,116,732,73,100,27,190,190,74,74,0,116,190,73,86,13,0.010075223799312433,0.02236291228428469,66,84,18,2,2,2,11,7,5,48,6
632,40,656,50,100,50,110,130,60,66,6,40,96,50,61,11,0.003812246842983083,0.012049423057285817,54,73,19,2,2,2,10,3,11,46,27
633,6,212,32,94,62,26,26,36,36,0,6,12,32,36,4,0.0002382654276864427,0.002144388849177984,32,45,13,3,4,4,5,1,45,49,94
634,6,206,31,92,61,10,10,32,32,0,6,6,31,31,0,0.00037441710065012424,0.0020763130126961434,34,43,9,3,4,4,3,1,85,88,46
635,0,206,1,96,95,0,12,1,38,37,0,12,1,44,43,0.0,0.019844106334456584,1,83,82,3,-1,4,2,0,93,85,10
636,28,644,52,100,48,28,48,42,61,19,28,48,51,63,12,0.003812246842983083,0.029510875114877974,53,91,38,2,3,3,3,6,64,41,0
637,6,622,29,100,71,23,64,30,38,8,6,60,29,55,26,0.00010211375472276115,0.009292351679771264,29,69,40,2,4,3,8,1,10,60,27
638,0,206,1,90,89,0,38,1,32,31,0,15,1,34,33,0.0,0.0022465026039007454,1,44,43,3,-1,4,13,0,13,66,41
639,32,32,50,50,0,76,76,59,59,0,32,32,50,50,0,0.0027911092957554717,0.0027911092957554717,48,48,0,-1,3,3,6,2,34,83,69
640,101,307,79,99,20,78,78,78,78,0,78,78,78,78,0,0.010075223799312433,0.013819394805813677,65,75,10,3,2,2,4,8,67,44,22
641,6,206,31,93,62,10,10,32,32,0,6,6,31,31,0,0.00037441710065012424,0.002110350930937064,33,45,12,3,4,4,3,1,55,88,46
642,100,100,62,62,0,100,100,43,43,0,100,100,62,62,0,0.05834099186493754,0.058613295210864905,100,100,0,2,1,1,12,40,14,3,56
643,0,102,1,71,70,0,7,1,27,26,0,2,1,25,24,0.0,0.00010211375472276115,1,28,27,4,-1,5,5,1,52,69,95
644,423,2063,98,100,2,184,208,96,98,2,184,208,96,98,2,0.03516116954287076,0.047993464719697745,91,94,3,1,2,2,7,29,46,1,88
645,290,496,95,99,4,222,222,90,90,0,222,222,92,92,0,0.02403077027808979,0.02723033459273631,87,88,1,3,2,2,10,19,11,15,28
646,0,206,1,92,91,0,28,1,33,32,0,12,1,36,35,0.0,0.0016678579938050988,1,43,42,3,-1,4,8,0,21,40,52
647,0,1640,1,100,99,0,62,1,79,78,0,62,1,80,79,0.0,0.062323428299125225,1,99,98,1,-1,2,3,0,94,66,2
648,0,206,1,94,93,0,8,1,32,31,0,6,1,32,31,0.0,0.0016338200755641784,1,42,41,3,-1,4,2,0,90,84,53
649,46,46,54,54,0,90,90,71,71,0,46,46,54,54,0,0.008305252050784574,0.008305252050784574,64,64,0,-1,2,2,6,2,69,83,92
650,100,100,61,61,0,100,100,40,40,0,100,100,61,61,0,0.02365635317743967,0.02396269444160795,88,89,1,3,1,1,14,14,8,32,65
651,0,1640,1,100,99,0,90,1,48,47,0,72,1,59,58,0.0,0.017495489975833077,1,81,80,1,-1,2,9,0,26,92,77
652,406,1006,100,100,0,192,192,99,99,0,192,192,99,99,0,0.046563872153579086,0.06497838592191701,96,99,3,2,2,2,6,30,65,7,10
653,104,720,75,100,25,220,220,73,73,0,104,143,75,84,9,0.007113924912352361,0.011675005956635693,60,71,11,2,2,2,16,6,4,26,28
654,224,430,91,97,6,206,206,81,81,0,206,206,90,90,0,0.02011640968038395,0.027843017121072875,80,87,7,3,2,2,12,16,3,18,8
655,232,832,92,100,8,268,268,96,96,0,232,268,92,96,4,0.013138636440995268,0.016236087000919025,74,78,4,2,2,2,12,13,14,24,22
656,133,235,88,93,5,54,54,59,59,0,54,54,63,63,0,0.016304162837400864,0.016542428265087308,82,82,0,4,3,3,4,18,77,5,63
657,40,141,52,86,34,60,60,52,52,0,40,41,52,53,1,0.006671431975220395,0.006671431975220395,58,58,0,6,2,2,5,1,45,90,68
658,134,340,80,96,16,208,208,89,89,0,134,148,80,81,1,0.010177337554035196,0.011232513019503728,70,70,0,3,2,2,10,7,12,21,43
659,320,526,97,99,2,340,340,97,97,0,320,340,97,98,1,0.025392287007726607,0.02559651451717213,87,87,0,3,2,2,15,16,7,18,56
660,46,662,54,100,46,90,100,65,69,4,46,70,54,59,5,0.006024711528642908,0.009734844616903231,60,67,7,2,2,2,6,3,74,29,54
661,12,628,36,100,64,14,38,32,45,13,12,38,36,50,14,0.0004084550188910446,0.021546002246502605,34,88,54,2,4,3,3,2,96,63,9
662,6,6,33,33,0,26,26,35,35,0,6,6,33,33,0,0.0010211375472276116,0.0010211375472276116,40,40,0,-1,4,4,5,1,88,71,79
663,0,101,1,82,81,0,4,1,25,24,0,1,1,25,24,0.0,0.0,1,1,0,6,-1,7,4,0,78,84,58
664,100,100,67,67,0,100,100,57,57,0,100,100,67,67,0,0.02900030634126417,0.03386772864971578,89,92,3,3,1,1,8,8,21,44,57
665,256,256,93,93,0,200,200,93,93,0,200,200,93,93,0,0.021137547227611558,0.021137547227611558,82,82,0,-1,2,2,8,18,27,5,96
666,2,103,26,74,48,15,15,26,26,0,2,3,26,28,2,6.807583648184077e-05,6.807583648184077e-05,28,28,0,5,5,5,14,2,16,58,68
667,344,344,94,94,0,176,176,88,88,0,176,176,88,88,0,0.031655263964055956,0.031655263964055956,91,91,0,-1,2,2,8,27,27,10,59
668,6,6,29,29,0,16,16,29,29,0,6,6,29,29,0,0.00037441710065012424,0.00037441710065012424,34,34,0,-1,4,4,7,1,43,55,67
669,6,622,27,100,73,24,46,31,36,5,6,46,27,51,24,0.00030634126416828345,0.012866333095067906,31,76,45,2,4,3,6,1,40,88,12
670,0,616,1,100,99,0,34,1,43,42,0,29,1,51,50,0.0,0.0068075836481840775,1,60,59,2,-1,3,4,0,47,85,22
671,16,616,39,100,61,38,38,39,39,0,16,28,39,51,12,0.0005786446100956465,0.004595118962524252,35,55,20,2,3,3,6,1,44,49,26
672,66,682,61,100,39,96,96,61,61,0,66,96,61,68,7,0.01055175465468532,0.021069471391129718,72,83,11,2,3,3,6,6,48,77,8
673,16,16,40,40,0,28,28,45,45,0,16,16,40,40,0,0.002314578440382586,0.002314578440382586,46,46,0,-1,3,3,3,1,94,53,50
674,0,206,1,92,91,0,26,1,32,31,0,6,1,31,30,0.0,0.0020422750944552232,1,42,41,3,-1,4,7,0,46,98,94
675,12,628,40,100,60,20,34,35,43,8,12,34,40,51,11,0.0009530617107457708,0.01681473161101467,39,82,43,2,4,3,4,2,47,74,15
676,0,206,1,92,91,0,18,1,32,31,0,10,1,34,33,0.0,0.0011232513019503727,1,37,36,3,-1,4,5,0,63,97,43
677,78,694,60,100,40,100,100,63,63,0,78,100,61,67,6,0.008203138296061813,0.012219612648490419,64,71,7,2,2,2,6,4,41,72,22
678,74,690,69,100,31,38,48,55,65,10,38,48,58,66,8,0.011096361346540046,0.03812246842983083,72,95,23,2,3,3,3,9,76,27,11
679,84,1724,60,100,40,212,236,78,84,6,84,202,60,89,29,0.010313489226998877,0.025868817863099493,69,88,19,1,2,2,13,5,13,25,8
680,0,1640,1,100,99,0,84,1,58,57,0,84,1,65,64,0.0,0.0352292453793526,1,92,91,1,-1,2,5,0,52,98,9
681,66,66,64,64,0,48,48,60,60,0,48,48,63,63,0,0.009190237925048503,0.009190237925048503,65,65,0,-1,3,3,3,6,58,34,89
682,7,7,37,37,0,8,8,32,32,0,7,7,37,37,0,0.00034037918240920387,0.00034037918240920387,33,33,0,-1,4,4,2,2,95,56,67
683,12,628,35,100,65,18,28,35,44,9,12,28,35,51,16,0.0017018959120460194,0.0123557643214541,41,71,30,2,4,3,3,2,94,52,19
684,100,100,62,62,0,100,100,45,45,0,100,100,62,62,0,0.025970931617822254,0.03774805132918071,86,93,7,2,1,1,12,8,3,17,12
685,16,632,39,100,61,28,38,40,50,10,16,38,39,53,14,0.0033357159876101976,0.009462541270975866,51,71,20,2,3,3,3,1,82,90,13
686,0,0,1,1,0,0,0,1,1,0,0,0,1,1,0,0.0,0.0,1,1,0,-1,-1,-1,8,1,39,50,93
687,0,102,1,84,83,0,4,1,28,27,0,4,1,31,30,0.0,0.002927260968719153,1,49,48,4,-1,5,2,1,98,69,28
688,0,0,1,1,0,0,0,1,1,0,0,0,1,1,0,0.0,0.0,1,1,0,-1,-1,-1,4,1,77,45,76
689,138,138,82,82,0,190,190,92,92,0,138,138,82,82,0,0.008577555396711936,0.008577555396711936,63,63,0,-1,2,2,8,6,42,28,86
690,284,284,95,95,0,256,256,95,95,0,256,256,95,95,0,0.021341774737057083,0.021341774737057083,83,83,0,-1,2,2,10,18,18,5,76
691,28,644,46,100,54,90,100,46,47,1,28,100,46,61,15,0.0020422750944552232,0.016882807447496512,45,78,33,2,3,3,10,3,11,54,18
692,2,103,29,87,58,3,3,29,29,0,2,3,29,32,3,0.0002382654276864427,0.0002723033459273631,33,33,0,7,5,5,2,1,97,55,58
693,22,228,38,92,54,56,56,37,37,0,22,28,38,40,2,0.0005105687736138058,0.0011913271384322134,33,38,5,3,3,3,9,2,29,56,42
694,22,638,43,100,57,54,64,39,45,6,22,46,43,54,11,0.0012934408931549745,0.005956635692161067,41,57,16,2,3,3,8,2,21,74,41
695,160,776,87,100,13,176,176,91,91,0,160,176,90,92,2,0.01596378365499166,0.02995336805200994,78,90,12,2,2,2,8,8,10,17,32
696,0,102,1,82,81,0,7,1,28,27,0,3,1,32,31,0.0,0.0008509479560230097,1,36,35,4,-1,5,4,0,78,80,74
697,16,222,37,92,55,50,50,37,37,0,16,24,37,48,11,0.0007147962830593281,0.001599782157323258,38,43,5,3,3,3,8,1,21,49,74
698,0,1640,1,100,99,0,64,1,57,56,0,64,1,63,62,0.0,0.028013206712277475,1,88,87,1,-1,2,5,0,80,67,33
699,1,101,26,79,53,3,3,26,26,0,1,1,26,26,0,3.4037918240920386e-05,0.0,27,1,-26,5,6,6,3,2,94,58,95
700,320,1960,98,100,2,334,358,98,99,1,320,358,98,99,1,0.022601177711971135,0.04911671602164812,85,98,13,1,2,2,14,17,8,6,10
701,70,276,60,94,34,76,76,54,54,0,70,76,63,65,2,0.005377991082065421,0.006603356138738555,52,57,5,3,3,3,6,5,56,47,64
702,0,102,1,77,76,0,7,1,27,26,0,2,1,27,26,0.0,0.0005446066918547262,1,37,36,4,-1,5,4,0,84,40,42
703,116,322,76,94,18,120,120,78,78,0,120,120,78,78,0,0.014432077334150244,0.019129310051397258,75,81,6,3,2,2,6,8,41,20,34
704,2,104,28,78,50,7,8,28,29,1,2,4,28,31,3,0.00017018959120460194,0.0013274788113958951,31,40,9,4,5,5,4,1,84,55,94
705,0,0,1,1,0,0,0,1,1,0,0,0,1,1,0,0.0,0.0,1,1,0,-1,-1,-1,8,0,42,36,87
706,16,222,32,91,59,40,48,32,33,1,16,31,32,42,10,0.00037441710065012424,0.0028591851322373124,32,46,14,3,3,3,9,1,29,4,22
707,73,73,67,67,0,78,78,77,77,0,73,73,78,78,0,0.010824058000612683,0.010824058000612683,72,72,0,-1,2,2,4,4,78,22,80
708,0,101,1,82,81,0,2,1,25,24,0,1,1,25,24,0.0,0.00010211375472276115,1,28,27,5,-1,6,2,1,68,50,55
709,0,102,1,81,80,0,4,1,26,25,0,2,1,26,25,0.0,0.00037441710065012424,1,35,34,4,-1,5,3,0,81,89,49
710,6,212,33,93,60,16,24,33,37,4,6,24,33,49,16,0.00017018959120460194,0.0176997174852786,30,81,51,3,4,4,4,1,73,4,10
711,2,2,27,27,0,7,7,27,27,0,2,2,27,27,0,3.4037918240920386e-05,3.4037918240920386e-05,27,27,0,-1,5,5,6,1,48,78,50
712,0,616,1,100,99,0,66,1,47,46,0,66,1,58,57,0.0,0.02546036284420845,1,90,89,2,-1,3,6,0,59,89,11
713,124,740,77,100,23,150,160,85,93,8,124,160,83,94,11,0.010415602981721638,0.015248987371932332,71,78,7,2,2,2,7,7,46,21,73
714,38,244,47,93,46,62,66,48,49,1,38,66,47,60,13,0.002382654276864427,0.007760645358929848,43,62,19,3,3,3,6,6,56,70,22
715,2,618,26,99,73,12,86,26,41,15,2,86,26,57,31,0.0,0.013070560604513427,1,73,72,2,5,3,11,1,5,78,30
716,0,616,1,100,99,0,54,1,51,50,0,54,1,54,53,0.0,0.023486163586235065,1,86,85,2,-1,3,4,0,83,66,7
717,0,616,1,100,99,0,110,1,56,55,0,104,1,75,74,0.0,0.013921508560536438,1,71,70,2,-1,3,14,0,25,93,30
718,187,289,88,96,8,128,128,93,93,0,128,128,93,93,0,0.020626978453997753,0.021648116001225366,82,82,0,4,2,2,5,15,70,19,43
719,60,161,61,88,27,54,54,55,55,0,54,54,60,60,0,0.006297014874570271,0.006467204465774873,58,59,1,5,3,3,4,6,73,28,55
720,196,812,90,100,10,136,136,98,98,0,136,136,98,98,0,0.02828551005820484,0.05013785356887573,87,96,9,2,2,2,4,18,79,30,7
721,152,358,86,96,10,256,256,90,90,0,152,162,86,86,0,0.01596378365499166,0.01861874127778345,76,79,3,3,2,2,13,9,13,39,73
722,100,100,58,58,0,100,100,35,35,0,100,100,59,59,0,0.056434868443446,0.06453589298478506,99,100,1,2,1,1,17,36,20,2,32
723,0,616,1,100,99,0,166,1,60,59,0,166,1,86,85,0.0,0.02277136730317574,1,84,83,2,-1,3,16,0,4,79,10
724,0,1640,1,100,99,0,138,1,62,61,0,122,1,82,81,0.0,0.016984921202219273,1,76,75,1,-1,2,14,0,17,87,19
725,170,370,88,98,10,86,86,56,56,0,86,86,66,66,0,0.017121072875182955,0.022839443139657578,82,87,5,3,3,3,6,16,59,12,32
726,33,239,54,98,44,12,12,39,39,0,12,12,45,45,0,0.00616086320160659,0.026073045372545015,59,88,29,3,4,4,2,8,93,57,10
727,66,66,57,57,0,124,124,64,64,0,64,64,56,56,0,0.005037611899656217,0.005037611899656217,55,55,0,-1,2,2,10,6,22,41,91
728,126,1766,78,100,22,206,240,75,88,13,126,240,78,92,14,0.012764219340345145,0.04271758739235508,73,93,20,1,2,2,12,8,14,17,11
729,145,761,81,100,19,188,198,80,82,2,145,198,81,90,9,0.009905034208107831,0.021069471391129718,70,85,15,2,2,2,10,8,0,44,39
730,0,0,1,1,0,0,0,1,1,0,0,0,1,1,0,0.0,0.0,1,1,0,-1,-1,-1,5,1,49,69,92
731,32,134,44,79,35,58,58,39,39,0,32,34,44,45,1,0.002586881786309949,0.002586881786309949,47,47,0,4,3,3,8,2,42,75,95
732,16,632,34,100,66,54,58,35,38,3,16,58,34,52,18,0.0010892133837094523,0.012049423057285817,39,76,37,2,3,3,8,1,42,71,37
733,0,101,1,82,81,0,2,1,25,24,0,1,1,25,24,0.0,0.0002042275094455223,1,31,30,5,-1,6,2,0,90,89,60
734,0,1640,1,100,99,0,84,1,58,57,0,84,1,65,64,0.0,0.03546751080703904,1,93,92,1,-1,2,5,1,52,45,9
735,260,260,95,95,0,120,120,85,85,0,120,120,87,87,0,0.029544913033118896,0.029544913033118896,89,89,0,-1,2,2,6,22,74,9,67
736,0,0,1,1,0,0,0,1,1,0,0,0,1,1,0,0.0,0.0,1,1,0,-1,-1,-1,4,0,78,93,81
737,40,40,45,45,0,172,172,66,66,0,40,40,45,45,0,0.003165526396405596,0.003165526396405596,51,51,0,-1,2,2,17,3,20,46,59
738,2,618,28,100,72,6,28,31,42,11,2,28,28,49,21,6.807583648184077e-05,0.006297014874570271,30,54,24,2,5,3,3,1,96,95,47
739,22,22,43,43,0,88,88,48,48,0,22,22,43,43,0,0.0021784267674189047,0.0021784267674189047,45,45,0,-1,3,3,8,2,15,52,81
740,60,162,62,85,23,50,50,50,50,0,60,50,60,55,-5,0.004935498144933456,0.0051397256543789785,54,56,2,4,3,3,5,5,70,47,65
741,46,662,52,100,48,98,98,52,52,0,46,82,53,65,12,0.0029612988869600733,0.009088124170325743,46,67,21,2,2,2,9,2,31,52,48
742,54,260,56,93,37,70,70,67,67,0,54,70,55,70,15,0.007386228258279724,0.012151536812008578,63,73,10,3,3,3,5,7,70,62,24
743,38,38,49,49,0,98,98,52,52,0,38,38,49,49,0,0.003608019333537561,0.003608019333537561,49,49,0,-1,3,3,8,6,39,70,99
744,38,38,52,52,0,66,66,49,49,0,38,38,53,53,0,0.0034718676605738795,0.0034718676605738795,51,51,0,-1,3,3,6,6,32,70,50
745,150,356,83,96,13,140,140,88,88,0,150,140,91,89,-2,0.017257224548146634,0.022635215630212056,79,85,6,3,2,2,7,8,62,20,24
746,266,1906,95,100,5,240,264,98,100,2,240,264,98,100,2,0.023894618605126112,0.05800061268252834,86,99,13,1,2,2,9,16,23,18,1
747,16,222,40,92,52,28,32,38,40,2,16,22,40,44,4,0.0007828721195411688,0.002314578440382586,37,46,9,3,3,3,5,1,88,4,53
748,110,316,80,96,16,120,120,87,87,0,110,120,85,88,3,0.01065386840940808,0.015419176963136935,72,79,7,3,2,2,6,7,32,21,62
749,22,1662,39,100,61,98,220,37,71,34,22,220,39,87,48,0.0010892133837094523,0.037373634228530586,37,94,57,1,3,2,16,2,9,74,3
750,422,622,100,100,0,160,160,93,93,0,160,160,94,94,0,0.048844412675720754,0.052384356172776474,98,98,0,3,2,2,7,36,62,2,38
751,0,0,1,1,0,0,0,1,1,0,0,0,1,1,0,0.0,0.0,1,1,0,-1,-1,-1,5,0,52,97,50
752,16,222,39,93,54,28,28,40,40,0,16,28,39,48,9,0.0013615167296368155,0.0028591851322373124,40,49,9,3,3,3,3,2,82,42,54
753,100,100,60,60,0,100,100,50,50,0,100,100,60,60,0,0.06855236733721366,0.06855236733721366,100,100,0,-1,1,1,9,36,28,2,98
754,280,280,94,94,0,144,144,89,89,0,144,144,90,90,0,0.024371149460498995,0.024371149460498995,86,86,0,-1,2,2,6,19,40,15,96
755,254,870,92,100,8,190,200,91,92,1,190,200,91,92,1,0.025936893699581333,0.03819054426631267,87,97,10,2,2,2,8,15,27,16,5
756,162,778,85,100,15,194,204,78,84,6,162,204,85,92,7,0.010960209673576363,0.02413288403281255,69,88,19,2,2,2,11,9,19,31,6
757,96,696,66,100,34,118,118,68,68,0,96,118,66,79,13,0.006501242384015794,0.016133973246196264,61,76,15,2,3,3,8,6,21,13,14
758,422,422,99,99,0,144,144,91,91,0,144,144,92,92,0,0.047993464719697745,0.047993464719697745,99,99,0,-1,2,2,6,36,51,2,85
759,139,241,85,95,10,64,64,68,68,0,64,64,70,70,0,0.016712617856291908,0.01763164164879676,80,80,0,4,3,3,4,18,78,5,74
760,14,220,39,97,58,18,18,35,35,0,14,18,39,45,6,0.0010211375472276116,0.006637394056979475,36,59,23,3,4,4,3,4,94,64,44
761,24,640,48,100,52,38,38,51,51,0,24,38,48,53,5,0.0026209197045508697,0.007113924912352361,49,64,15,2,3,3,3,3,82,54,46
762,2,2,27,27,0,4,4,27,27,0,2,2,27,27,0,0.0,0.0,1,1,0,-1,5,5,3,1,58,78,36
763,6,6,28,28,0,32,32,35,35,0,6,6,28,28,0,0.0005446066918547262,0.0005446066918547262,34,34,0,-1,4,4,6,1,56,49,67
764,16,222,32,88,56,63,76,33,34,1,16,22,32,39,7,0.0002382654276864427,0.0020763130126961434,32,43,11,3,3,3,17,1,20,88,94
765,50,50,59,59,0,38,38,52,52,0,38,38,55,55,0,0.005207801490860819,0.005207801490860819,56,56,0,-1,3,3,3,6,66,28,67
766,16,222,41,93,52,40,40,44,44,0,16,40,41,52,11,0.002552843868069029,0.00793083495013445,46,66,20,3,3,3,5,2,70,94,44
767,87,703,64,100,36,98,108,55,65,10,87,108,64,77,13,0.006297014874570271,0.011402702610708328,60,71,11,2,3,3,8,8,21,57,26
768,0,1640,1,100,99,0,80,1,61,60,0,80,1,65,64,0.0,0.04717655468191565,1,99,98,1,-1,2,6,0,71,91,7
769,60,60,56,56,0,130,130,66,66,0,60,60,56,56,0,0.006671431975220395,0.006671431975220395,60,60,0,-1,3,3,10,6,12,26,80
770,12,628,38,100,62,50,60,40,41,1,12,41,38,51,13,0.001940161339732462,0.006909697402906838,42,59,17,2,4,3,9,2,26,75,35
771,78,78,65,65,0,64,64,68,68,0,64,64,69,69,0,0.007998910786616291,0.007998910786616291,63,63,0,-1,3,3,4,7,73,48,69
772,0,0,1,1,0,0,0,1,1,0,0,0,1,1,0,0.0,0.0,1,1,0,-1,-1,-1,6,0,69,84,98
773,0,206,1,91,90,0,20,1,28,27,0,6,1,28,27,0.0,0.0002042275094455223,1,31,30,3,-1,4,10,0,0,80,4
774,46,252,60,94,34,48,48,63,63,0,48,48,64,64,0,0.008509479560230097,0.010449640899962559,67,74,7,3,3,3,3,5,82,25,70
775,70,276,58,96,38,140,140,67,67,0,70,76,58,59,1,0.006603356138738555,0.009190237925048503,59,68,9,3,3,3,10,6,1,26,90
776,16,1656,34,100,66,92,126,41,65,24,16,75,34,56,22,0.0026889955410327104,0.017087034956942034,48,74,26,1,3,2,12,2,2,94,25
777,262,1862,95,100,5,208,208,89,89,0,208,208,94,94,0,0.021682153919466287,0.05857925729262398,86,99,13,1,2,2,10,19,36,15,2
778,100,100,69,69,0,94,94,72,72,0,94,94,73,73,0,0.00966676878042139,0.00966676878042139,70,70,0,-1,2,2,5,7,80,21,84
779,100,100,62,62,0,100,100,45,45,0,100,100,62,62,0,0.042683549474114166,0.042819701147077845,96,96,0,5,1,1,12,20,3,23,78
780,80,181,70,89,19,88,88,82,82,0,88,88,82,82,0,0.01320671227747711,0.01324075019571803,77,77,0,5,2,2,4,5,78,25,65
781,22,228,47,93,46,32,32,58,58,0,22,32,46,58,12,0.0018720855032506212,0.004629156880765172,45,56,11,3,3,3,2,2,68,61,35
782,98,714,59,100,41,222,232,77,80,3,98,232,59,89,30,0.007216038667075122,0.02130773681881616,59,82,23,2,2,2,14,4,25,22,30
783,242,842,96,100,4,56,56,76,76,0,56,56,77,77,0,0.0333911977943429,0.044793900405051226,92,96,4,2,2,2,2,27,68,10,12
784,6,212,30,92,62,16,20,31,32,1,6,14,30,36,6,0.00088498587426393,0.0015657442390823377,37,42,5,3,4,4,6,2,65,42,74
785,58,674,57,100,43,78,88,68,72,4,58,88,60,73,13,0.005718370264474625,0.033255046121379216,56,91,35,2,2,2,4,3,83,54,11
786,0,0,1,1,0,0,0,1,1,0,0,0,1,1,0,0.0,0.0,1,1,0,-1,-1,-1,5,0,50,81,36
787,520,1136,100,100,0,192,192,100,100,0,192,192,100,100,0,0.04748289594608394,0.0599407740222608,97,100,3,2,2,2,6,40,41,3,6
788,0,206,1,92,91,0,20,1,35,34,0,6,1,33,32,0.0,0.0033357159876101976,1,50,49,3,-1,4,4,0,77,59,90
789,134,750,81,100,19,110,110,78,78,0,110,110,82,82,0,0.011368664692467409,0.024473263215221756,69,85,16,2,2,2,6,13,51,24,5
790,0,616,1,100,99,0,80,1,43,42,0,58,1,56,55,0.0,0.009258313761530345,1,65,64,2,-1,3,10,0,11,98,17
791,2,2,28,28,0,3,3,28,28,0,2,2,28,28,0,6.807583648184077e-05,6.807583648184077e-05,28,28,0,-1,5,5,2,1,89,95,69
792,16,632,34,100,66,90,120,46,64,18,16,120,34,78,44,0.003369753905851118,0.01592974573675074,52,77,25,2,3,3,10,1,11,90,5
793,258,874,95,100,5,216,216,96,96,0,216,216,96,96,0,0.024234997787535316,0.026039007454304094,87,89,2,2,2,2,9,15,29,16,55
794,0,0,1,1,0,0,0,1,1,0,0,0,1,1,0,0.0,0.0,1,1,0,-1,-1,-1,10,0,22,85,97
795,0,616,1,100,99,0,40,1,48,47,0,40,1,56,55,0.0,0.012287688484972258,1,72,71,2,-1,3,4,0,84,86,8
796,0,206,1,93,92,0,18,1,39,38,0,18,1,44,43,0.0,0.005446066918547262,1,56,55,3,-1,4,3,0,55,92,25
797,152,1792,84,100,16,108,132,69,74,5,108,132,77,81,4,0.012696143503863304,0.030532012662105586,75,88,13,1,3,2,8,14,10,14,20
798,0,1640,1,100,99,0,68,1,70,69,0,68,1,72,71,0.0,0.03795227883862623,1,94,93,1,-1,2,4,0,79,99,23
799,0,616,1,100,99,0,66,1,49,48,0,66,1,60,59,0.0,0.020967357636406957,1,86,85,2,-1,3,6,0,56,85,16
800,56,56,56,56,0,126,126,69,69,0,56,56,56,56,0,0.006092787365124749,0.006092787365124749,58,58,0,-1,2,2,7,3,24,29,97
801,22,22,42,42,0,34,34,39,39,0,22,22,42,42,0,0.0018380475850097008,0.0018380475850097008,44,44,0,-1,3,3,4,2,53,61,76
802,80,286,70,98,28,38,38,57,57,0,38,38,59,59,0,0.009122162088566664,0.010517716736444398,66,69,3,3,3,3,3,9,55,31,42
803,0,616,1,100,99,0,68,1,40,39,0,68,1,58,57,0.0,0.012968446849790666,1,76,75,2,-1,3,8,0,30,76,6
804,0,0,1,1,0,0,0,1,1,0,0,0,1,1,0,0.0,0.0,1,1,0,-1,-1,-1,8,0,39,66,89
805,0,206,1,92,91,0,22,1,33,32,0,6,1,32,31,0.0,0.0015657442390823377,1,44,43,3,-1,4,5,0,88,92,53
806,100,100,59,59,0,100,100,46,46,0,100,100,59,59,0,0.04932094353109364,0.053813948738895126,99,100,1,2,1,1,11,29,5,1,26
807,56,56,54,54,0,122,122,62,62,0,56,56,54,54,0,0.003778208924742163,0.003778208924742163,52,52,0,-1,2,2,12,2,2,83,93
808,308,508,99,100,1,80,80,96,96,0,80,80,96,96,0,0.052248204499812795,0.05592429966983219,97,97,0,3,2,2,2,40,86,3,13
809,0,616,1,100,99,0,18,1,47,46,0,18,1,50,49,0.0,0.008441403723748256,1,69,68,2,-1,3,2,0,90,81,48
810,134,1774,83,100,17,76,110,51,75,24,76,110,63,80,17,0.010824058000612683,0.05163552197147622,70,96,26,1,3,2,6,14,59,32,3
811,0,101,1,75,74,0,5,1,24,23,0,1,1,24,23,0.0,0.00017018959120460194,1,30,29,5,-1,6,5,0,80,59,65
812,100,100,71,71,0,100,100,80,80,0,100,100,81,81,0,0.0318935293917424,0.03349331154906566,91,92,1,3,1,1,5,2,49,63,94
813,2,103,27,84,57,4,4,27,27,0,2,3,27,30,3,6.807583648184077e-05,0.00013615167296368154,27,31,4,6,5,5,3,1,92,55,58
814,6,212,31,92,61,14,18,36,37,1,6,14,31,42,11,0.0006467204465774873,0.002144388849177984,38,43,5,3,4,4,3,2,85,42,51
815,16,632,35,100,65,68,78,43,43,0,16,53,35,50,15,0.0038462847612240037,0.010143299635794275,48,66,18,2,3,3,8,1,27,90,34
816,22,638,38,100,62,66,76,36,41,5,22,38,38,45,7,0.0002723033459273631,0.0023486163586235067,33,46,13,2,3,3,10,2,0,56,53
817,40,40,55,55,0,52,52,74,74,0,40,40,61,61,0,0.006671431975220395,0.006671431975220395,60,60,0,-1,2,2,3,2,58,94,87
818,100,100,81,81,0,100,100,98,98,0,100,100,98,98,0,0.11613737703802035,0.12137921644712209,100,100,0,4,1,1,2,40,99,3,8
819,0,616,1,99,98,0,52,1,34,33,0,18,1,40,39,0.0,0.0016678579938050988,1,40,39,2,-1,3,11,0,19,84,61
820,0,206,1,96,95,0,8,1,33,32,0,8,1,39,38,0.0,0.010245413390517035,1,68,67,3,-1,4,2,0,93,85,37
821,2,208,28,96,68,3,12,28,38,10,2,12,28,44,16,0.00013615167296368154,0.02018448551686579,31,85,54,3,5,4,2,1,93,55,10
822,183,183,91,91,0,96,96,95,95,0,96,96,95,95,0,0.029749140542564417,0.029749140542564417,89,89,0,-1,2,2,3,16,60,18,97
823,32,32,48,48,0,56,56,49,49,0,32,32,48,48,0,0.0014295925661186562,0.0014295925661186562,42,42,0,-1,3,3,6,2,69,61,50
824,0,0,1,1,0,0,0,1,1,0,0,0,1,1,0,0.0,0.0,1,1,0,-1,-1,-1,4,0,83,80,86
825,6,6,31,31,0,12,12,37,37,0,6,6,31,31,0,0.0016678579938050988,0.0016678579938050988,41,41,0,-1,4,4,2,1,99,71,82
826,16,16,42,42,0,28,28,43,43,0,16,16,42,42,0,0.0007147962830593281,0.0007147962830593281,37,37,0,-1,3,3,3,1,75,49,67
827,0,0,1,1,0,0,0,1,1,0,0,0,1,1,0,0.0,0.0,1,1,0,-1,-1,-1,6,0,56,86,66
828,18,634,43,100,57,30,40,36,41,5,18,40,43,52,9,0.0014636304843595766,0.010619830491167161,41,71,30,2,4,3,5,3,61,43,14
829,0,102,1,84,83,0,4,1,28,27,0,3,1,31,30,0.0,0.0009530617107457708,1,37,36,4,-1,5,2,0,98,89,61
830,443,1059,99,100,1,320,320,99,99,0,320,320,99,99,0,0.03451444909629327,0.04680213758126553,91,96,5,2,2,2,11,29,19,0,37
831,187,393,88,100,12,128,128,93,93,0,128,128,93,93,0,0.020626978453997753,0.025290173253003846,82,85,3,3,2,2,5,15,70,19,72
832,49,665,56,100,44,56,66,44,50,6,49,66,56,61,5,0.004288777698355968,0.009292351679771264,54,70,16,2,3,3,6,4,34,22,47
833,12,12,36,36,0,14,14,32,32,0,12,12,36,36,0,0.0020082371762143027,0.0020082371762143027,43,43,0,-1,4,4,3,2,96,75,99
834,122,122,82,82,0,104,104,82,82,0,104,104,82,82,0,0.01494264610776405,0.01494264610776405,77,77,0,-1,2,2,5,8,80,8,93
835,100,100,70,70,0,100,100,53,53,0,100,100,70,70,0,0.02743456210218183,0.03951802307770857,87,94,7,2,1,1,9,9,31,27,37
836,0,616,1,100,99,0,30,1,35,34,0,25,1,43,42,0.0,0.00707988699411144,1,56,55,2,-1,3,6,0,71,85,73
837,168,168,86,86,0,110,110,86,86,0,110,110,86,86,0,0.0195377650702883,0.0195377650702883,80,80,0,-1,2,2,6,18,69,30,66
838,335,951,99,100,1,72,72,87,87,0,72,72,87,87,0,0.04527043126042411,0.05282684910990844,96,98,2,2,2,2,3,40,55,3,73
839,40,246,51,94,43,134,134,67,67,0,40,47,51,53,2,0.004629156880765172,0.005003573981415297,54,55,1,3,2,2,10,2,36,94,63
840,16,632,35,100,65,68,100,39,44,5,16,100,35,64,29,0.0009870996289866913,0.013547091459886314,40,73,33,2,3,3,10,2,12,42,5
841,70,686,65,100,35,60,60,49,49,0,60,60,59,59,0,0.00789679703189353,0.01579359406378706,63,78,15,2,3,3,5,9,88,31,17
842,0,616,1,100,99,0,28,1,43,42,0,28,1,50,49,0.0,0.010313489226998877,1,71,70,2,-1,3,3,0,92,36,17
843,0,0,1,1,0,0,0,1,1,0,0,0,1,1,0,0.0,0.0,1,1,0,-1,-1,-1,4,0,77,59,91
844,4,210,33,97,64,4,8,30,34,4,4,8,33,40,7,0.0004084550188910446,0.002927260968719153,36,49,13,3,5,4,2,2,97,56,75
845,100,100,61,61,0,100,100,40,40,0,100,100,61,61,0,0.02365635317743967,0.02365635317743967,88,88,0,-1,1,1,14,14,8,32,79
846,0,616,1,100,99,0,50,1,35,34,0,34,1,45,44,0.0,0.0053099152455835805,1,55,54,2,-1,3,8,0,27,86,62
847,128,128,83,83,0,128,128,78,78,0,128,128,83,83,0,0.013751318969331836,0.013751318969331836,75,75,0,-1,3,3,8,13,39,33,98
848,0,206,1,92,91,0,34,1,32,31,0,34,1,46,45,0.0,0.005173763572619898,1,54,53,3,-1,4,7,0,46,82,31
849,0,0,1,1,0,0,0,1,1,0,0,0,1,1,0,0.0,0.0,1,1,0,-1,-1,-1,4,0,67,81,59
850,160,776,86,100,14,302,302,88,88,0,160,193,86,89,3,0.010687906327649,0.015112835698968652,68,78,10,2,2,2,16,4,4,38,57
851,66,682,71,100,29,56,56,84,84,0,56,56,84,84,0,0.01763164164879676,0.02569862827189489,81,87,6,2,2,2,2,5,86,25,57
852,56,56,68,68,0,38,38,61,61,0,38,38,63,63,0,0.007147962830593281,0.007147962830593281,65,65,0,-1,3,3,3,7,81,21,97
853,84,1724,64,100,36,104,138,66,78,12,84,124,64,80,16,0.009394465434494027,0.021239660982334322,67,82,15,1,3,2,9,9,26,27,49
854,0,206,1,88,87,0,27,1,31,30,0,7,1,34,33,0.0,0.0006126825283365669,1,35,34,3,-1,4,8,0,15,36,56
855,0,206,1,91,90,0,23,1,33,32,0,14,1,35,34,0.0,0.0017018959120460194,1,39,38,3,-1,4,6,0,56,98,70
856,0,206,1,91,90,0,24,1,35,34,0,24,1,42,41,0.0,0.011743081793117532,1,70,69,3,-1,4,4,0,67,80,18
857,78,284,62,94,32,76,76,54,54,0,76,76,61,61,0,0.00789679703189353,0.010381565063480718,62,68,6,3,3,3,6,7,44,48,73
858,22,124,47,85,38,48,48,60,60,0,22,48,47,62,15,0.0046972327172470135,0.005582218591510943,53,56,3,4,3,3,3,3,58,29,64
859,22,228,49,98,49,22,22,47,47,0,22,22,52,52,0,0.002144388849177984,0.006943735321147759,45,63,18,3,3,3,2,2,89,52,25
860,163,369,88,99,11,72,72,77,77,0,72,72,77,77,0,0.017903944994724124,0.026651689982640663,82,88,6,3,2,2,3,15,82,19,39
861,0,206,1,92,91,0,26,1,32,31,0,12,1,33,32,0.0,0.0019061234214915416,1,42,41,3,-1,4,7,0,46,80,52
862,125,125,79,79,0,120,120,79,79,0,125,125,81,81,0,0.010755982164130842,0.010755982164130842,70,70,0,-1,2,2,7,8,43,44,98
863,132,748,82,100,18,100,120,66,78,12,100,120,72,80,8,0.013751318969331836,0.038360733857517273,77,93,16,2,2,2,6,8,44,8,0
864,0,0,1,1,0,0,0,1,1,0,0,0,1,1,0,0.0,0.0,1,1,0,-1,-1,-1,3,0,76,87,85
865,0,616,1,100,99,0,38,1,50,49,0,38,1,53,52,0.0,0.03271043942952449,1,95,94,2,-1,3,3,0,94,81,10
866,0,616,1,100,99,0,82,1,47,46,0,82,1,58,57,0.0,0.017223186629905716,1,80,79,2,-1,3,7,0,24,81,15
867,100,100,66,66,0,100,100,49,49,0,100,100,66,66,0,0.03669287586371218,0.040198781442526976,95,96,1,2,1,1,9,12,54,37,41
868,22,228,45,94,49,50,50,48,48,0,22,31,45,51,6,0.0016678579938050988,0.0030634126416828346,43,49,6,3,3,3,5,2,49,52,54
869,18,18,40,40,0,52,52,40,40,0,18,18,40,40,0,0.0020082371762143027,0.0020082371762143027,41,41,0,-1,3,3,6,2,56,61,76
870,0,102,1,77,76,0,11,1,28,27,0,2,1,27,26,0.0,0.00030634126416828345,1,33,32,4,-1,5,8,0,57,79,88
871,0,206,1,95,94,0,12,1,36,35,0,12,1,40,39,0.0,0.018925082541951733,1,83,82,3,-1,4,2,0,89,87,1
872,44,660,57,100,43,38,48,56,59,3,38,48,59,62,3,0.0057524081827155455,0.019639878825011062,58,84,26,2,3,3,3,4,58,38,30
873,62,268,58,95,37,90,90,63,63,0,62,68,59,60,1,0.006399128629293032,0.008679669151434699,59,65,6,3,2,2,6,3,65,54,90
874,0,206,1,88,87,0,44,1,33,32,0,16,1,31,30,0.0,0.0024166921951053475,1,45,44,3,-1,4,14,0,17,36,41
875,0,616,1,100,99,0,56,1,41,40,0,48,1,52,51,0.0,0.008577555396711936,1,67,66,2,-1,3,6,0,51,85,21
876,216,216,87,87,0,176,176,88,88,0,176,176,88,88,0,0.024064808196330712,0.024064808196330712,85,85,0,-1,2,2,8,18,27,30,79
877,0,206,1,92,91,0,68,1,34,33,0,46,1,52,51,0.0,0.005003573981415297,1,55,54,3,-1,4,12,0,6,98,31
878,100,306,64,96,32,122,122,72,72,0,100,122,65,79,14,0.007318152421797883,0.00878178290615746,61,65,4,3,2,2,8,6,10,13,54
879,54,1694,53,100,47,188,212,73,77,4,54,212,53,89,36,0.006297014874570271,0.020763130126961436,60,82,22,1,3,2,13,7,13,62,24
880,70,276,62,94,32,86,86,68,68,0,70,86,63,71,8,0.011709043874876613,0.012696143503863304,71,71,0,3,3,3,6,5,69,25,61
881,110,212,83,94,11,48,48,67,67,0,48,48,70,70,0,0.018108172504169646,0.023418087749753225,81,89,8,4,3,3,3,18,96,30,8
882,56,56,56,56,0,144,144,71,71,0,56,56,56,56,0,0.004663194799006093,0.004663194799006093,56,56,0,-1,2,2,10,3,11,29,76
883,6,107,32,75,43,32,32,34,34,0,6,7,32,35,3,0.0004084550188910446,0.0004765308553728854,34,34,0,5,4,4,6,1,44,88,60
884,0,616,1,100,99,0,22,1,41,40,0,22,1,45,44,0.0,0.02226079852956193,1,87,86,2,-1,3,2,0,68,76,11
885,73,73,64,64,0,54,54,54,54,0,54,54,58,58,0,0.006773545729943157,0.006773545729943157,60,60,0,-1,3,3,4,8,47,57,50
886,1,103,25,83,58,2,3,25,26,1,1,3,25,30,5,0.0,0.00030634126416828345,1,30,29,4,6,5,2,1,99,68,63
887,54,260,63,97,34,32,32,70,70,0,32,32,70,70,0,0.0088498587426393,0.0141938119064638,66,75,9,3,3,3,2,7,95,48,21
888,16,222,43,97,54,28,28,46,46,0,16,28,43,52,9,0.001497668402600497,0.006058749446883829,41,61,20,3,3,3,3,1,81,71,21
889,22,123,42,78,36,42,42,38,38,0,22,23,42,44,2,0.0011232513019503727,0.0011232513019503727,38,38,0,5,3,3,6,2,65,74,78
890,160,776,91,100,9,72,72,80,80,0,72,72,80,80,0,0.023009632730862182,0.030736240171551108,86,89,3,2,2,2,3,18,76,5,24
891,0,0,1,1,0,0,0,1,1,0,0,0,1,1,0,0.0,0.0,1,1,0,-1,-1,-1,5,1,63,69,40
892,88,704,61,100,39,122,132,69,71,2,88,132,61,78,17,0.007726607440688927,0.022430988120766535,62,84,22,2,2,2,8,4,27,72,18
893,0,206,1,92,91,0,21,1,32,31,0,9,1,33,32,0.0,0.0009190237925048504,1,38,37,3,-1,4,7,0,46,85,43
894,18,634,42,100,58,36,50,38,44,6,18,50,42,57,15,0.0007488342013002485,0.01667857993805099,36,79,43,2,3,3,5,2,63,56,16
895,62,62,59,59,0,22,22,42,42,0,22,22,46,46,0,0.00881582082439838,0.00881582082439838,64,64,0,-1,3,3,2,6,68,34,40
896,236,337,92,95,3,174,174,93,93,0,174,174,94,94,0,0.017155110793423873,0.017257224548146634,80,81,1,5,2,2,7,14,24,32,58
897,16,632,37,100,63,126,146,64,66,2,16,146,37,82,45,0.002825147213996392,0.01674665577453283,48,78,30,2,3,3,11,3,19,46,16
898,0,616,1,100,99,0,68,1,37,36,0,50,1,55,54,0.0,0.008407365805507334,1,66,65,2,-1,3,11,0,38,40,8
899,0,206,1,90,89,0,48,1,36,35,0,24,1,48,47,0.0,0.005037611899656217,1,54,53,3,-1,4,8,0,30,59,38
900,70,276,60,94,34,90,90,67,67,0,70,76,63,65,2,0.009462541270975866,0.011232513019503728,67,71,4,3,2,2,6,5,56,25,46
901,100,100,59,59,0,100,100,46,46,0,100,100,59,59,0,0.01746145205759216,0.01746145205759216,77,77,0,-1,1,1,11,3,5,54,91
902,0,206,1,88,87,0,62,1,32,31,0,15,1,31,30,0.0,0.0034718676605738795,1,51,50,3,-1,4,17,0,20,98,73
903,0,616,1,100,99,0,28,1,44,43,0,28,1,47,46,0.0,0.019265461724360937,1,85,84,2,-1,3,3,0,60,59,9
904,96,96,75,75,0,48,48,63,63,0,48,48,64,64,0,0.007998910786616291,0.007998910786616291,66,66,0,-1,3,3,3,13,82,24,97
905,32,32,47,47,0,80,80,42,42,0,32,32,47,47,0,0.002552843868069029,0.002552843868069029,47,47,0,-1,3,3,10,2,36,75,80
906,22,638,45,100,55,36,50,41,47,6,22,50,45,56,11,0.0020082371762143027,0.023009632730862182,45,88,43,2,3,3,5,2,49,75,11
907,0,616,1,100,99,0,40,1,38,37,0,40,1,52,51,0.0,0.015657442390823378,1,78,77,2,-1,3,5,0,63,93,16
908,100,100,79,79,0,100,100,95,95,0,100,100,95,95,0,0.08502671976581912,0.09421695769086763,99,100,1,3,1,1,3,27,75,10,6
909,142,758,90,100,10,72,72,80,80,0,72,72,80,80,0,0.017359338302869398,0.021818305592429966,81,87,6,2,2,2,3,15,87,19,28
910,16,118,31,79,48,144,144,63,63,0,16,18,31,39,8,0.003199564314646516,0.003199564314646516,50,50,0,4,3,3,14,3,25,46,68
911,0,206,1,94,93,0,12,1,39,38,0,12,1,41,40,0.0,0.007488342013002485,1,68,67,3,-1,4,2,0,90,59,14
912,32,1672,47,100,53,94,128,48,66,18,32,110,47,73,26,0.0020082371762143027,0.020661016372238675,46,85,39,1,3,2,9,2,28,52,48
913,38,638,52,100,48,56,56,47,47,0,36,56,52,59,7,0.0035739814152966403,0.01756356581231492,52,83,31,2,3,3,6,6,32,41,18
914,0,0,1,1,0,0,0,1,1,0,0,0,1,1,0,0.0,0.0,1,1,0,-1,-1,-1,16,0,9,82,93
915,40,246,47,93,46,128,128,70,70,0,40,52,47,52,5,0.005548180673270023,0.006705469893461316,55,58,3,3,2,2,9,1,29,90,61
916,84,184,75,95,20,22,22,52,52,0,22,22,54,54,0,0.012764219340345145,0.013547091459886314,75,75,0,4,3,3,2,8,86,8,54
917,39,655,54,100,46,76,76,54,54,0,39,76,54,65,11,0.0042547397801150485,0.01943565131556554,53,86,33,2,3,3,6,4,32,22,18
918,100,100,63,63,0,100,100,47,47,0,100,100,63,63,0,0.024200959869294394,0.024200959869294394,85,85,0,5,1,1,10,13,22,24,78
919,126,742,78,100,22,88,88,47,47,0,88,88,61,61,0,0.008135062459579971,0.0141938119064638,64,75,11,2,3,3,8,13,10,24,72
920,28,130,46,80,34,56,56,44,44,0,28,30,46,46,0,0.001599782157323258,0.001599782157323258,42,42,0,4,3,3,6,3,41,43,95
921,22,1662,40,100,60,56,114,38,63,25,22,114,40,80,40,0.0012934408931549745,0.02757071377514551,40,86,46,1,3,2,9,3,31,51,30
922,80,696,56,100,44,100,110,59,71,12,80,110,57,75,18,0.00789679703189353,0.03345927363082474,62,92,30,2,2,2,6,6,40,28,10
923,108,108,75,75,0,88,88,73,73,0,88,88,74,74,0,0.012287688484972258,0.012287688484972258,73,73,0,-1,2,2,4,9,83,27,86
924,174,380,87,97,10,224,224,87,87,0,174,180,87,88,1,0.019878144252697506,0.02198849518363457,80,82,2,3,2,2,11,12,19,37,46
925,465,1081,99,100,1,280,280,98,98,0,280,280,98,98,0,0.03577385207120733,0.04915075393988903,94,98,4,2,2,2,10,30,11,7,30
926,100,100,76,76,0,78,78,75,75,0,78,78,77,77,0,0.011368664692467409,0.011368664692467409,71,71,0,-1,2,2,4,7,77,21,40
927,0,0,1,1,0,0,0,1,1,0,0,0,1,1,0,0.0,0.0,1,1,0,-1,-1,-1,11,0,33,87,84
928,0,616,1,100,99,0,40,1,38,37,0,40,1,52,51,0.0,0.012491915994417782,1,73,72,2,-1,3,5,0,63,76,37
929,2,208,28,93,65,4,8,30,31,1,2,8,28,35,7,0.0002723033459273631,0.006569318220497634,31,59,28,3,5,4,2,1,68,55,27
930,132,234,83,94,11,216,216,96,96,0,132,134,83,83,0,0.012900371013308825,0.013002484768031588,74,74,0,4,2,2,9,5,35,25,60
931,0,1640,1,100,99,0,110,1,60,59,0,110,1,75,74,0.0,0.016440314510364547,1,78,77,1,-1,2,11,0,19,67,14
932,2,104,28,75,47,12,12,30,30,0,2,6,28,31,3,0.00013615167296368154,0.0008509479560230097,30,36,6,4,5,5,6,1,44,65,74
933,177,177,91,91,0,72,72,83,83,0,72,72,83,83,0,0.023213860240307704,0.023213860240307704,85,85,0,-1,2,2,3,19,58,15,89
934,0,0,1,1,0,0,0,1,1,0,0,0,1,1,0,0.0,0.0,1,1,0,-1,-1,-1,11,0,5,86,40
935,118,324,78,97,19,176,176,74,74,0,118,176,78,87,9,0.011845195547840293,0.019912182170938427,72,82,10,3,3,3,11,9,19,27,20
936,0,206,1,91,90,0,24,1,35,34,0,24,1,42,41,0.0,0.003914360597705844,1,46,45,3,-1,4,4,0,67,93,47
937,22,228,49,97,48,22,22,49,49,0,22,22,50,50,0,0.0031314884781646754,0.021409850573538922,49,87,38,3,3,3,2,2,93,52,9
938,543,644,100,100,0,232,232,100,100,0,232,232,100,100,0,0.0490826781034072,0.04911671602164812,95,95,0,5,2,2,7,40,46,3,60
939,42,42,57,57,0,22,22,47,47,0,22,22,52,52,0,0.00793083495013445,0.00793083495013445,66,66,0,-1,3,3,2,6,89,34,80
940,100,100,60,60,0,100,100,40,40,0,100,100,60,60,0,0.01933353756084278,0.03158718812757412,79,92,13,1,1,1,14,7,25,48,13
941,100,100,67,67,0,100,100,74,74,0,100,100,75,75,0,0.06341264168283468,0.06358283127403928,99,99,0,3,1,1,5,27,63,10,88
942,0,206,1,97,96,0,12,1,38,37,0,12,1,43,42,0.0,0.014261887742945642,1,77,76,3,-1,4,2,0,97,93,15
943,100,716,76,100,24,48,48,54,54,0,48,48,56,56,0,0.009394465434494027,0.01589570781850982,65,80,15,2,3,3,3,9,87,31,57
944,0,0,1,1,0,0,0,1,1,0,0,0,1,1,0,0.0,0.0,1,1,0,-1,-1,-1,6,0,59,99,85
945,150,356,84,96,12,208,208,88,88,0,150,156,84,85,1,0.014329963579427483,0.01596378365499166,76,78,2,3,2,2,10,8,11,17,53
946,344,944,96,100,4,352,352,96,96,0,352,352,96,96,0,0.02644746247319514,0.03713536880084414,88,94,6,2,2,2,13,15,13,16,18
947,61,677,57,100,43,130,130,67,67,0,61,105,57,73,16,0.005173763572619898,0.011164437183021887,58,69,11,2,3,3,10,6,11,35,62
948,0,616,1,100,99,0,44,1,47,46,0,44,1,53,52,0.0,0.007862759113652609,1,64,63,2,-1,3,4,1,83,50,13
949,126,742,83,100,17,114,114,67,67,0,114,114,80,80,0,0.008271214132543654,0.016508390346846386,67,79,12,2,3,3,9,13,23,24,14
950,142,243,88,97,9,72,72,85,85,0,72,72,85,85,0,0.022635215630212056,0.022669253548452978,87,87,0,5,2,2,3,19,94,15,95
951,100,100,78,78,0,100,100,96,96,0,100,100,96,96,0,0.08325674801729126,0.08492460601109636,100,100,0,3,1,1,3,27,81,10,43
952,0,616,1,100,99,0,28,1,42,41,0,28,1,48,47,0.0,0.014261887742945642,1,81,80,2,-1,3,3,0,66,59,37
953,196,396,89,98,9,172,172,88,88,0,172,172,90,90,0,0.019469689233806462,0.02038871302631131,80,83,3,3,2,2,9,18,35,30,61
954,0,1640,1,100,99,0,144,1,62,61,0,102,1,74,73,0.0,0.0141938119064638,1,76,75,1,-1,2,14,0,16,79,17
955,1,207,26,93,67,5,14,26,33,7,1,9,26,38,12,6.807583648184077e-05,0.0018720855032506212,28,43,15,3,6,4,5,2,49,58,83
956,0,206,1,90,89,0,18,1,29,28,0,14,1,35,34,0.0,0.0036760951700194017,1,49,48,3,-1,4,7,0,43,87,35
957,100,100,58,58,0,100,100,38,38,0,100,100,58,58,0,0.016133973246196264,0.02831954797644576,78,90,12,1,1,1,16,8,9,57,21
958,22,22,47,47,0,28,28,40,40,0,22,22,47,47,0,0.0020763130126961434,0.0020763130126961434,45,45,0,-1,3,3,3,2,82,83,91
959,70,70,64,64,0,96,96,70,70,0,70,70,65,65,0,0.007113924912352361,0.007113924912352361,63,63,0,-1,3,3,6,5,32,47,40
960,232,848,91,100,9,320,320,92,92,0,232,320,91,94,3,0.019571802988529223,0.0283876238129276,80,89,9,2,2,2,14,12,16,37,8
961,184,1824,89,100,11,220,254,85,92,7,184,254,88,92,4,0.013615167296368155,0.04350045951189625,76,97,21,1,2,2,12,13,3,33,11
962,270,470,98,100,2,96,96,94,94,0,96,96,94,94,0,0.041185881071513664,0.04329623200245073,95,95,0,3,2,2,3,27,85,10,28
963,0,102,1,81,80,0,5,1,27,26,0,2,1,26,25,0.0,0.0002382654276864427,1,32,31,4,-1,5,3,0,66,99,49
964,96,96,63,63,0,150,150,70,70,0,96,96,63,63,0,0.008101024541339052,0.008101024541339052,65,65,0,-1,2,2,11,6,38,34,36
965,32,133,44,82,38,56,56,41,41,0,32,33,44,44,0,0.0035739814152966403,0.0037441710065012424,47,48,1,5,3,3,6,2,71,75,55
966,2,208,29,94,65,3,8,29,32,3,2,8,29,37,8,0.0002042275094455223,0.004765308553728854,32,56,24,3,5,4,2,1,90,55,62
967,120,120,81,81,0,240,240,77,77,0,120,120,81,81,0,0.006467204465774873,0.006467204465774873,57,57,0,-1,2,2,16,6,4,13,59
968,2,1642,28,100,72,13,96,31,52,21,2,96,28,63,35,0.0002382654276864427,0.03182545355526056,32,91,59,1,5,2,7,1,46,55,9
969,46,662,53,100,47,74,84,62,68,6,46,84,53,70,17,0.004016474352428605,0.010449640899962559,52,70,18,2,2,2,5,2,37,52,62
970,6,212,32,94,62,14,14,34,34,0,6,12,32,38,6,0.0006126825283365669,0.0013274788113958951,34,43,9,3,4,4,3,1,60,49,4
971,70,70,63,63,0,88,88,47,47,0,70,70,63,63,0,0.0053099152455835805,0.0053099152455835805,58,58,0,-1,3,3,8,6,39,26,69
972,88,88,57,57,0,174,174,72,72,0,88,88,57,57,0,0.008305252050784574,0.008305252050784574,62,62,0,-1,2,2,10,4,0,38,87
973,118,1758,77,100,23,188,222,83,91,8,118,222,77,93,16,0.007386228258279724,0.0390755301405766,63,94,31,1,2,2,10,5,12,47,0
974,16,222,43,93,50,40,40,49,49,0,16,40,43,55,12,0.0026209197045508697,0.005548180673270023,48,57,9,3,3,3,4,2,73,94,35
975,2,618,25,100,75,6,32,25,34,9,2,26,25,45,20,0.0,0.0053439531638245,1,52,51,2,5,3,5,2,50,58,22
976,16,632,35,100,65,98,168,41,67,26,16,168,35,87,52,0.0013274788113958951,0.03223390857415161,40,92,52,2,3,3,13,1,13,71,2
977,178,384,93,100,7,72,72,77,77,0,72,72,79,79,0,0.026855917492086184,0.029578950951359814,91,91,0,3,2,2,3,20,96,23,22
978,2,2,28,28,0,6,6,28,28,0,2,2,28,28,0,6.807583648184077e-05,6.807583648184077e-05,28,28,0,-1,5,5,5,1,70,68,76
979,76,282,61,95,34,104,104,66,66,0,76,82,61,63,2,0.00616086320160659,0.006705469893461316,56,58,2,3,3,3,9,6,26,13,42
980,24,24,48,48,0,46,46,45,45,0,24,24,48,48,0,0.002110350930937064,0.002110350930937064,46,46,0,-1,3,3,6,3,32,43,80
981,24,24,50,50,0,28,28,45,45,0,24,24,51,51,0,0.002144388849177984,0.002144388849177984,44,44,0,-1,3,3,3,3,94,43,82
982,90,90,66,66,0,120,120,79,79,0,90,90,66,66,0,0.010994247591817285,0.010994247591817285,72,72,0,-1,2,2,6,5,44,25,81
983,345,551,98,100,2,128,128,90,90,0,128,128,90,90,0,0.0370672929643623,0.03829265802103543,94,95,1,3,2,2,5,29,63,1,64
984,42,658,57,100,43,46,46,81,81,0,42,46,81,81,0,0.010007147962830594,0.02743456210218183,70,91,21,2,2,2,2,2,89,74,12
985,0,101,1,75,74,0,9,1,25,24,0,1,1,25,24,0.0,0.0002723033459273631,1,32,31,5,-1,6,9,0,54,40,88
986,252,868,95,100,5,64,64,64,64,0,64,64,67,67,0,0.03100854351747847,0.049763436468225605,90,96,6,2,3,3,4,29,77,1,7
987,182,798,87,100,13,136,136,77,77,0,136,136,83,83,0,0.01783586915824228,0.020729092208720514,82,84,2,2,2,2,7,18,24,30,46
988,0,102,1,75,74,0,15,1,25,24,0,2,1,25,24,0.0,0.00013615167296368154,1,28,27,4,-1,5,14,0,8,82,55
989,74,74,60,60,0,100,100,66,66,0,68,68,58,58,0,0.006024711528642908,0.006024711528642908,55,55,0,-1,2,2,6,6,51,41,66
990,32,648,46,100,54,152,182,70,76,6,32,182,46,87,41,0.004493005207801491,0.020354675108070392,54,80,26,2,3,3,12,3,3,29,6
991,176,776,91,100,9,48,48,63,63,0,48,48,64,64,0,0.023315973995030465,0.04414717995847374,87,96,9,2,3,3,3,15,82,16,11
992,108,708,75,100,25,88,88,73,73,0,88,88,74,74,0,0.012287688484972258,0.021546002246502605,73,86,13,2,2,2,4,9,83,27,17
993,132,234,80,93,13,96,96,67,67,0,96,96,70,70,0,0.013887470642295518,0.014500153170632085,75,77,2,4,3,3,6,14,65,14,49
994,543,1143,100,100,0,232,232,100,100,0,232,232,100,100,0,0.0490826781034072,0.05405221416658157,95,98,3,2,2,2,7,40,46,3,13
995,56,672,50,100,50,204,214,73,73,0,56,114,50,75,25,0.005071649817897137,0.011777119711358454,53,66,13,2,2,2,15,3,7,29,48
996,80,286,65,97,32,64,64,59,59,0,64,64,63,63,0,0.005480104836788182,0.010313489226998877,56,70,14,3,3,3,4,5,53,47,72
997,38,1678,47,100,53,62,106,44,66,22,38,106,47,75,28,0.0013955546478777359,0.04527043126042411,40,96,56,1,3,2,7,4,46,64,11
998,178,794,90,100,10,80,80,66,66,0,80,80,68,68,0,0.01960584090677014,0.02825147213996392,82,90,8,2,3,3,5,19,63,15,17
999,0,0,1,1,0,0,0,1,1,0,0,0,1,1,0,0.0,0.0,1,1,0,-1,-1,-1,6,0,41,93,98
