,FreeNet_pre_score,FreeNet_post_score,FreeNet_pre_rank,FreeNet_post_rank,FreeNet_delta_ranks,Reversed_pre_score,Reversed_post_score,Reversed_pre_rank,Reversed_post_rank,Reversed_delta_ranks,Independent_pre_score,Independent_post_score,Independent_pre_rank,Independent_post_rank,Independent_delta_ranks,Random_pre_score,Random_post_score,Random_pre_rank,Random_post_rank,Random_delta_ranks,dist_victim_relayer,dist_victim_vilain_pre,dist_victim_vilain_post,out_deg_victim,in_deg_villain,victim,villain,relayer
0,46,148,55,87,32,60,60,52,52,0,46,48,55,55,0,0.00888389666088022,0.009020048333843901,68,68,0,4,2,2,5,2,45,83,4
1,77,693,74,100,26,22,22,49,49,0,22,22,50,50,0,0.015385139044896015,0.03611423125361653,79,96,17,2,3,3,2,12,93,37,16
2,38,654,53,100,47,118,118,69,69,0,38,118,53,80,27,0.003608019333537561,0.01327478811395895,52,76,24,2,3,3,8,6,57,70,39
3,0,0,1,1,0,0,0,1,1,0,0,0,1,1,0,0.0,0.0,1,1,0,-1,-1,-1,3,0,87,97,59
4,0,616,1,100,99,0,30,1,31,30,0,16,1,32,31,0.0,0.002484768031587188,1,45,44,2,-1,3,9,1,31,50,71
5,0,616,1,100,99,0,96,1,40,39,0,96,1,63,62,0.0,0.012696143503863304,1,74,73,2,-1,3,13,0,13,93,12
6,271,271,96,96,0,112,112,97,97,0,112,112,97,97,0,0.03594404166241193,0.03594404166241193,92,92,0,-1,2,2,4,29,84,11,50
7,98,304,65,97,32,198,198,86,86,0,98,108,65,78,13,0.011266550937744648,0.0123557643214541,73,74,1,3,2,2,10,5,1,25,43
8,85,701,60,100,40,134,134,66,66,0,85,134,60,83,23,0.006875659484665918,0.01678069369277375,61,77,16,2,2,2,10,6,22,35,33
9,0,616,1,100,99,0,78,1,46,45,0,78,1,65,64,0.0,0.023894618605126112,1,88,87,2,-1,3,8,0,39,40,11
10,183,285,89,95,6,182,182,87,87,0,182,182,92,92,0,0.015385139044896015,0.015623404472582456,77,78,1,4,2,2,9,15,23,19,88
11,56,262,66,98,32,38,38,52,52,0,38,38,55,55,0,0.0063650907110521125,0.012662105585622384,60,77,17,3,3,3,3,6,66,13,24
12,0,0,1,1,0,0,0,1,1,0,0,0,1,1,0,0.0,0.0,1,1,0,-1,-1,-1,7,1,62,45,84
13,6,212,29,90,61,28,32,33,33,0,6,14,29,36,7,0.00037441710065012424,0.0019741992579733825,35,43,8,3,4,4,8,1,10,88,83
14,168,168,90,90,0,96,96,93,93,0,96,96,93,93,0,0.02569862827189489,0.02569862827189489,91,91,0,-1,2,2,3,18,66,30,76
15,18,18,48,48,0,30,30,46,46,0,18,18,48,48,0,0.0009190237925048504,0.0009190237925048504,37,37,0,-1,3,3,4,2,78,63,50
16,0,1640,1,100,99,0,54,1,48,47,0,54,1,57,56,0.0,0.019061234214915415,1,79,78,1,-1,2,6,0,69,66,41
17,20,20,46,46,0,44,44,48,48,0,20,20,46,46,0,0.0018380475850097008,0.0018380475850097008,45,45,0,-1,3,3,4,3,47,43,45
18,96,302,67,94,27,128,128,76,76,0,96,128,67,80,13,0.008611593314952858,0.011504816365431091,66,72,6,3,3,3,8,7,57,21,28
19,0,102,1,75,74,0,7,1,25,24,0,2,1,25,24,0.0,0.0002382654276864427,1,28,27,4,-1,5,6,1,51,45,88
20,0,102,1,76,75,0,17,1,26,25,0,2,1,24,23,0.0,0.0002382654276864427,1,29,28,4,-1,5,10,0,36,84,49
21,1,207,25,91,66,4,24,25,39,14,1,24,25,50,25,0.0,0.01324075019571803,1,73,72,3,6,4,4,1,84,68,23
22,100,100,76,76,0,100,100,96,96,0,100,100,96,96,0,0.0597705844310562,0.0597705844310562,98,98,0,-1,1,1,3,13,87,24,93
23,120,736,78,100,22,124,124,91,91,0,124,124,91,91,0,0.011981347220803976,0.017087034956942034,70,79,9,2,2,2,6,7,65,48,44
24,319,919,95,100,5,104,104,81,81,0,104,104,84,84,0,0.03465060076925695,0.04346642159365533,89,95,6,2,2,2,5,30,61,7,5
25,120,736,80,100,20,158,158,79,79,0,120,144,80,81,1,0.00888389666088022,0.01055175465468532,68,70,2,2,2,2,9,7,54,21,64
26,2,618,27,100,73,6,28,30,45,15,2,28,27,52,25,0.00010211375472276115,0.014908608189523128,29,76,47,2,5,3,3,1,81,4,30
27,16,632,38,100,62,58,82,44,55,11,16,82,38,64,26,0.0030634126416828346,0.032506211920078965,48,91,43,2,3,3,7,3,62,46,2
28,250,866,95,100,5,96,96,91,91,0,96,96,91,91,0,0.03512713162462984,0.04952517104053916,92,96,4,2,2,2,3,22,76,9,5
29,34,240,53,92,39,54,54,55,55,0,34,54,53,59,6,0.007488342013002485,0.021035433472888797,62,83,21,3,3,3,4,7,84,62,23
30,0,616,1,100,99,0,18,1,50,49,0,18,1,53,52,0.0,0.00793083495013445,1,64,63,2,-1,3,2,1,98,45,72
31,22,638,45,100,55,28,38,43,45,2,22,38,46,50,4,0.002110350930937064,0.013853432724054596,44,77,33,2,3,3,3,2,96,52,20
32,16,16,42,42,0,28,28,43,43,0,16,16,42,42,0,0.0026889955410327104,0.0026889955410327104,47,47,0,-1,3,3,3,2,96,94,99
33,112,112,84,84,0,86,86,90,90,0,86,86,90,90,0,0.0158616699002689,0.0158616699002689,79,79,0,-1,2,2,3,4,76,38,99
34,22,22,51,51,0,34,34,47,47,0,22,22,51,51,0,0.003369753905851118,0.003369753905851118,51,51,0,-1,3,3,4,2,77,83,59
35,454,660,98,100,2,334,334,99,99,0,334,334,99,99,0,0.03812246842983083,0.039109568058817525,95,95,0,3,2,2,11,29,5,0,74
36,18,18,45,45,0,28,28,44,44,0,18,18,45,45,0,0.001599782157323258,0.001599782157323258,41,41,0,-1,3,3,3,2,92,61,36
37,0,0,1,1,0,0,0,1,1,0,0,0,1,1,0,0.0,0.0,1,1,0,-1,-1,-1,14,1,16,69,50
38,0,0,1,1,0,0,0,1,1,0,0,0,1,1,0,0.0,0.0,1,1,0,-1,-1,-1,6,1,71,45,66
39,334,950,95,100,5,208,208,97,97,0,208,208,97,97,0,0.02750263793866367,0.03141699853636951,88,90,2,2,2,2,7,19,24,15,29
40,0,616,1,100,99,0,46,1,39,38,0,46,1,56,55,0.0,0.009973110044589673,1,70,69,2,-1,3,6,1,44,69,39
41,126,742,83,100,17,222,222,83,83,0,126,158,83,86,3,0.01153885428367201,0.015623404472582456,73,76,3,2,2,2,13,8,13,17,75
42,154,256,89,96,7,64,64,68,68,0,64,64,71,71,0,0.021920419347152727,0.023622315259198747,84,85,1,4,3,3,4,19,72,15,75
43,0,206,1,91,90,0,24,1,33,32,0,14,1,38,37,0.0,0.0026209197045508697,1,47,46,3,-1,4,6,0,44,79,41
44,56,672,51,100,49,112,132,67,71,4,56,132,52,78,26,0.0051397256543789785,0.018108172504169646,55,78,23,2,2,2,8,3,27,29,5
45,0,616,1,100,99,0,43,1,35,34,0,25,1,46,45,0.0,0.00353994349705572,1,49,48,2,-1,3,9,0,23,96,22
46,0,206,1,90,89,0,48,1,36,35,0,24,1,48,47,0.0,0.005105687736138058,1,54,53,3,-1,4,8,0,30,89,38
47,0,206,1,92,91,0,30,1,35,34,0,30,1,50,49,0.0,0.009258313761530345,1,68,67,3,-1,4,5,0,63,97,19
48,100,100,63,63,0,100,100,47,47,0,100,100,63,63,0,0.034854828278702475,0.04145818441744103,91,94,3,2,1,1,10,17,36,6,20
49,24,124,48,81,33,68,68,43,43,0,24,25,48,50,2,0.001599782157323258,0.0019061234214915416,41,43,2,4,3,3,8,3,57,43,56
50,0,616,1,100,99,0,23,1,32,31,0,16,1,36,35,0.0,0.0014636304843595766,1,41,40,2,-1,3,6,0,41,97,4
51,0,616,1,100,99,0,56,1,43,42,0,56,1,51,50,0.0,0.014704380680077607,1,77,76,2,-1,3,6,0,56,82,15
52,1,103,26,76,50,6,10,26,28,2,1,3,26,29,3,3.4037918240920386e-05,0.00010211375472276115,26,28,2,4,6,5,6,2,71,58,4
53,92,298,65,94,29,138,138,71,71,0,92,98,65,65,0,0.0088498587426393,0.0088498587426393,67,67,0,3,2,2,9,7,54,48,95
54,66,272,61,94,33,60,60,49,49,0,60,60,59,59,0,0.005956635692161067,0.007590455767725246,55,61,6,3,3,3,5,6,88,13,53
55,142,758,82,100,18,86,86,56,56,0,86,86,62,62,0,0.013070560604513427,0.0337315769767521,75,93,18,2,3,3,6,14,51,14,0
56,0,102,1,75,74,0,12,1,28,27,0,2,1,26,25,0.0,0.0017359338302869397,1,43,42,4,-1,5,6,0,65,97,46
57,6,212,34,97,63,12,12,39,39,0,6,12,34,43,9,0.0017359338302869397,0.008169100377820893,44,66,22,3,4,4,2,1,97,53,48
58,6,6,33,33,0,16,16,33,33,0,6,6,33,33,0,0.00034037918240920387,0.00034037918240920387,34,34,0,-1,4,4,4,1,47,4,84
59,100,100,79,79,0,100,100,98,98,0,100,100,98,98,0,0.11174648558494163,0.11174648558494163,100,100,0,-1,1,1,2,30,68,7,97
60,0,206,1,90,89,0,14,1,30,29,0,6,1,29,28,0.0,0.0018040096667687805,1,43,42,3,-1,4,5,0,80,85,46
61,105,721,84,100,16,32,32,63,63,0,32,32,64,64,0,0.017427414139351238,0.02559651451717213,80,87,7,2,3,3,2,18,86,5,57
62,22,638,43,100,57,54,88,39,51,12,22,88,43,64,21,0.0012934408931549745,0.02011640968038395,41,83,42,2,3,3,8,2,21,74,9
63,0,616,1,100,99,0,138,1,60,59,0,138,1,85,84,0.0,0.022124646856598252,1,83,82,2,-1,3,13,1,13,50,10
64,142,142,89,89,0,72,72,87,87,0,72,72,87,87,0,0.01960584090677014,0.01960584090677014,86,86,0,-1,2,2,3,16,55,12,36
65,46,1686,62,100,38,22,56,52,83,31,22,56,55,84,29,0.007692569522448007,0.0706286803499098,64,98,34,1,3,2,2,7,98,21,23
66,0,206,1,93,92,0,14,1,34,33,0,14,1,42,41,0.0,0.005990673610401988,1,57,56,3,-1,4,3,0,92,97,25
67,324,940,96,100,4,368,368,97,97,0,324,368,97,97,0,0.024166921951053473,0.03512713162462984,87,95,8,2,2,2,14,16,16,18,14
68,16,632,36,100,64,56,96,36,43,7,16,64,36,58,22,0.0004765308553728854,0.008169100377820893,36,65,29,2,3,3,11,1,38,88,77
69,0,616,1,100,99,0,28,1,37,36,0,16,1,39,38,0.0,0.0036760951700194017,1,49,48,2,-1,3,5,0,88,67,46
70,6,108,27,81,54,24,24,36,36,0,6,10,27,31,4,0.003369753905851118,0.004118588107151367,46,47,1,4,4,4,4,1,67,90,74
71,6,212,29,90,61,18,42,30,35,5,6,42,29,50,21,0.00010211375472276115,0.007760645358929848,29,62,33,3,4,4,7,1,43,65,14
72,22,638,43,100,57,44,58,36,41,5,22,40,43,49,6,0.0018040096667687805,0.005582218591510943,42,55,13,2,3,3,7,3,43,51,75
73,78,78,58,58,0,202,202,74,74,0,78,78,58,58,0,0.00616086320160659,0.00616086320160659,59,59,0,-1,2,2,13,4,13,22,50
74,29,645,54,100,46,38,38,55,55,0,38,38,58,58,0,0.00439089145307873,0.03209775690118792,55,92,37,2,3,3,3,4,76,22,3
75,56,262,55,94,39,154,154,72,72,0,56,65,55,56,1,0.00622893903808843,0.00707988699411144,58,60,2,3,2,2,10,3,36,29,64
76,1,617,25,100,75,3,38,25,50,25,1,38,25,53,28,6.807583648184077e-05,0.02831954797644576,27,91,64,2,6,3,3,1,82,78,3
77,0,102,1,77,76,0,8,1,29,28,0,2,1,27,26,0.0,0.0012934408931549745,1,40,39,4,-1,5,4,1,84,45,94
78,0,206,1,90,89,0,54,1,32,31,0,12,1,33,32,0.0,0.0014295925661186562,1,40,39,3,-1,4,13,0,13,36,52
79,104,1744,78,100,22,148,172,78,87,9,104,150,78,85,7,0.007794683277170768,0.020252561353347628,62,83,21,1,2,2,9,5,35,47,52
80,161,361,94,100,6,32,32,67,67,0,32,32,68,68,0,0.028728002995336805,0.03553558664352088,90,95,5,3,3,3,2,29,97,1,19
81,100,100,66,66,0,130,130,85,85,0,98,98,68,68,0,0.008645631233193778,0.008645631233193778,66,66,0,-1,2,2,7,6,62,41,40
82,6,6,34,34,0,12,12,39,39,0,6,6,34,34,0,0.0017359338302869397,0.0017359338302869397,44,44,0,-1,4,4,2,1,97,53,86
83,0,206,1,92,91,0,32,1,34,33,0,32,1,49,48,0.0,0.011743081793117532,1,71,70,3,-1,4,6,0,59,66,6
84,100,100,65,65,0,100,100,47,47,0,100,100,65,65,0,0.04081146397086354,0.044793900405051226,95,96,1,2,1,1,11,20,38,23,44
85,100,100,66,66,0,100,100,43,43,0,100,100,66,66,0,0.030532012662105586,0.031212771026923995,91,91,0,3,1,1,11,18,33,5,71
86,34,135,52,83,31,54,54,54,54,0,34,35,52,55,3,0.003710133088260322,0.003710133088260322,52,52,0,6,3,3,4,6,47,70,78
87,451,552,100,100,0,240,240,98,98,0,240,240,98,98,0,0.04986555022294836,0.04996766397767113,98,98,0,5,2,2,9,36,26,2,55
88,58,58,59,59,0,72,72,59,59,0,58,58,61,61,0,0.006126825283365669,0.006126825283365669,55,55,0,-1,2,2,6,3,69,54,79
89,50,256,65,99,34,22,22,47,47,0,22,22,52,52,0,0.004493005207801491,0.007726607440688927,53,65,12,3,3,3,2,5,89,47,35
90,0,616,1,100,99,0,66,1,47,46,0,66,1,58,57,0.0,0.020831205963443275,1,85,84,2,-1,3,6,0,59,82,30
91,32,632,48,100,52,148,148,63,63,0,32,148,48,85,37,0.0020082371762143027,0.01667857993805099,43,77,34,2,3,3,13,2,13,52,16
92,203,203,89,89,0,192,192,91,91,0,192,192,91,91,0,0.025256135334762925,0.025256135334762925,88,88,0,-1,2,2,9,15,26,16,59
93,564,2204,100,100,0,336,360,100,100,0,336,360,100,100,0,0.04615541713468804,0.06453589298478506,98,100,2,1,2,2,12,40,2,3,37
94,32,134,49,82,33,40,40,41,41,0,32,34,49,50,1,0.0025188059498281084,0.0029612988869600733,47,49,2,4,3,3,5,2,80,75,42
95,12,628,33,100,67,58,72,35,38,3,12,30,33,42,9,0.001157289220191293,0.0026209197045508697,38,44,6,2,4,3,11,3,33,51,61
96,63,165,65,90,25,54,54,55,55,0,54,54,60,60,0,0.007284114503556962,0.007556417849484326,61,63,2,4,3,3,4,8,84,57,56
97,116,732,81,100,19,94,94,78,78,0,94,94,78,78,0,0.013615167296368155,0.024575376969944517,76,88,12,2,2,2,5,8,45,17,37
98,0,206,1,89,88,0,19,1,27,26,0,8,1,31,30,0.0,0.00088498587426393,1,34,33,3,-1,4,9,0,29,91,74
99,100,716,58,100,42,230,240,73,73,0,98,122,58,77,19,0.005071649817897137,0.006297014874570271,54,56,2,2,2,2,17,6,20,41,64
100,244,860,94,100,6,144,144,92,92,0,144,144,92,92,0,0.026753803737363423,0.031280846863405834,89,89,0,2,2,2,6,15,48,16,28
101,100,100,69,69,0,100,100,76,76,0,100,100,76,76,0,0.03604615541713469,0.03761189965621702,91,91,0,3,1,1,5,6,80,28,52
102,0,206,1,92,91,0,26,1,36,35,0,26,1,49,48,0.0,0.012015385139044895,1,72,71,3,-1,4,5,0,70,59,37
103,106,706,74,100,26,126,126,69,69,0,106,126,75,77,2,0.00970080669866231,0.025868817863099493,69,85,16,2,2,2,7,7,24,48,23
104,22,638,38,100,62,56,66,42,43,1,22,66,38,56,18,0.0014295925661186562,0.016712617856291908,39,79,40,2,3,3,6,2,51,61,15
105,110,1750,80,100,20,120,144,87,90,3,110,144,85,90,5,0.01065386840940808,0.03015759556145546,72,90,18,1,2,2,6,7,32,21,75
106,0,0,1,1,0,0,0,1,1,0,0,0,1,1,0,0.0,0.0,1,1,0,-1,-1,-1,6,0,51,66,92
107,0,0,1,1,0,0,0,1,1,0,0,0,1,1,0,0.0,0.0,1,1,0,-1,-1,-1,8,1,57,50,36
108,539,2139,99,100,1,350,350,98,98,0,350,350,98,98,0,0.03693114129139862,0.05915790190271963,93,100,7,1,2,2,12,29,3,1,23
109,0,616,1,99,98,0,82,1,40,39,0,50,1,52,51,0.0,0.004629156880765172,1,53,52,2,-1,3,11,0,5,59,47
110,46,252,49,93,44,112,112,62,62,0,46,52,49,50,1,0.0025188059498281084,0.0033016780693692774,46,50,4,3,2,2,8,2,42,61,71
111,6,212,29,91,62,36,40,33,36,3,6,25,29,45,16,0.0004765308553728854,0.0030634126416828346,35,47,12,3,4,4,8,2,39,42,22
112,22,22,41,41,0,44,44,44,44,0,22,22,41,41,0,0.0024166921951053475,0.0024166921951053475,42,42,0,-1,3,3,4,2,67,61,97
113,88,190,67,90,23,132,132,79,79,0,88,91,67,67,0,0.00878178290615746,0.008951972497362062,67,68,1,4,2,2,8,7,39,62,56
114,142,244,82,95,13,54,54,55,55,0,54,54,58,58,0,0.013070560604513427,0.01320671227747711,76,76,0,4,3,3,4,14,53,14,60
115,16,222,35,87,52,78,78,44,44,0,16,35,35,46,11,0.0026889955410327104,0.005684332346233704,46,56,10,3,3,3,8,3,27,46,22
116,6,6,28,28,0,18,18,28,28,0,6,6,28,28,0,0.00034037918240920387,0.00034037918240920387,30,30,0,-1,4,4,8,1,27,55,82
117,0,1640,1,100,99,0,142,1,65,64,0,129,1,79,78,0.0,0.01923142380612002,1,86,85,1,-1,2,16,1,9,50,6
118,2,2,27,27,0,6,6,27,27,0,2,2,27,27,0,6.807583648184077e-05,6.807583648184077e-05,28,28,0,-1,5,5,5,1,63,68,98
119,0,101,1,78,77,0,4,1,25,24,0,1,1,25,24,0.0,3.4037918240920386e-05,1,26,25,5,-1,6,4,0,47,84,55
120,58,58,57,57,0,78,78,68,68,0,58,58,60,60,0,0.005718370264474625,0.005718370264474625,56,56,0,-1,2,2,4,3,83,54,76
121,22,22,45,45,0,56,56,45,45,0,22,22,45,45,0,0.002586881786309949,0.002586881786309949,47,47,0,-1,3,3,6,2,59,75,92
122,112,318,75,97,22,210,210,78,78,0,112,150,75,85,10,0.008135062459579971,0.01327478811395895,64,72,8,3,2,2,12,4,6,72,48
123,63,679,56,100,44,100,100,63,63,0,63,100,56,67,11,0.006024711528642908,0.020354675108070392,56,82,26,2,2,2,6,4,41,22,23
124,26,26,45,45,0,56,56,44,44,0,26,26,45,45,0,0.0038462847612240037,0.0038462847612240037,48,48,0,-1,3,3,6,6,56,73,89
125,7,213,37,97,60,8,8,32,32,0,7,8,37,37,0,0.00037441710065012424,0.005650294427992784,34,60,26,3,4,4,2,2,98,56,21
126,56,56,61,61,0,44,44,53,53,0,44,44,58,58,0,0.007692569522448007,0.007692569522448007,63,63,0,-1,3,3,4,6,78,34,36
127,88,190,73,91,18,64,64,68,68,0,64,64,71,71,0,0.01245787807617686,0.01324075019571803,74,76,2,4,3,3,4,13,72,33,71
128,0,206,1,96,95,0,12,1,38,37,0,12,1,44,43,0.0,0.01773375540351952,1,83,82,3,-1,4,2,0,93,89,0
129,38,244,46,91,45,128,128,60,60,0,38,51,46,52,6,0.001497668402600497,0.003710133088260322,42,51,9,3,3,3,16,3,9,43,73
130,340,340,100,100,0,120,120,100,100,0,120,120,100,100,0,0.055209503386772864,0.055209503386772864,97,97,0,-1,2,2,3,40,81,3,82
131,16,632,37,100,63,56,76,44,58,14,16,76,37,65,28,0.0018040096667687805,0.024234997787535316,45,87,42,2,3,3,6,1,34,53,1
132,129,231,85,97,12,56,56,84,84,0,56,56,84,84,0,0.01783586915824228,0.018686817114265293,82,84,2,4,2,2,2,13,86,24,74
133,0,206,1,93,92,0,26,1,35,34,0,19,1,44,43,0.0,0.0033016780693692774,1,49,48,3,-1,4,5,0,49,36,22
134,16,632,33,100,67,30,66,32,41,9,16,50,33,53,20,0.0005446066918547262,0.0061949011198475104,34,60,26,2,3,3,9,1,31,65,38
135,0,101,1,81,80,0,3,1,24,23,0,1,1,24,23,0.0,0.0002382654276864427,1,30,29,5,-1,6,3,0,82,79,55
136,126,126,82,82,0,88,88,77,77,0,88,88,77,77,0,0.014840532353041287,0.014840532353041287,78,78,0,-1,2,2,4,8,79,17,84
137,150,251,84,92,8,208,208,88,88,0,150,151,84,84,0,0.014329963579427483,0.014432077334150244,76,76,0,5,2,2,10,8,11,17,78
138,2,208,27,93,66,4,10,27,30,3,2,10,27,40,13,6.807583648184077e-05,0.003267640151128357,27,48,21,3,5,4,3,1,92,60,29
139,100,100,75,75,0,100,100,89,89,0,100,100,89,89,0,0.0719561591613057,0.07655127812382995,99,100,1,2,1,1,4,29,73,0,46
140,0,0,1,1,0,0,0,1,1,0,0,0,1,1,0,0.0,0.0,1,1,0,-1,-1,-1,8,0,21,81,69
141,77,179,59,87,28,76,76,55,55,0,76,76,60,60,0,0.008203138296061813,0.008271214132543654,61,61,0,4,3,3,6,8,71,44,4
142,6,6,29,29,0,18,18,32,32,0,6,6,29,29,0,0.0002382654276864427,0.0002382654276864427,33,33,0,-1,4,4,5,1,52,88,82
143,12,212,35,93,58,18,18,36,36,0,12,18,35,44,9,0.0013274788113958951,0.0024507301133462676,39,47,8,3,4,4,3,2,82,74,43
144,64,270,56,93,37,130,130,65,65,0,64,94,56,62,6,0.006637394056979475,0.010892133837094524,60,67,7,3,3,3,10,4,22,72,26
145,1,1,25,25,0,2,2,25,25,0,1,1,25,25,0,6.807583648184077e-05,6.807583648184077e-05,27,27,0,-1,6,6,2,1,97,68,69
146,40,141,54,87,33,68,68,71,71,0,40,41,54,54,0,0.005854521937438306,0.005956635692161067,58,58,0,5,2,2,4,2,79,94,60
147,0,616,1,100,99,0,42,1,33,32,0,18,1,40,39,0.0,0.002757071377514551,1,48,47,2,-1,3,10,0,12,96,83
148,104,310,76,96,20,110,110,79,79,0,104,110,79,80,1,0.008407365805507334,0.011845195547840293,66,72,6,3,2,2,6,5,34,47,13
149,0,101,1,80,79,0,4,1,25,24,0,1,1,25,24,0.0,6.807583648184077e-05,1,26,25,6,-1,7,4,0,73,59,68
150,371,987,97,100,3,184,184,96,96,0,184,184,96,96,0,0.03713536880084414,0.042649511555873244,92,94,2,2,2,2,7,29,46,0,62
151,0,206,1,92,91,0,28,1,30,29,0,12,1,33,32,0.0,0.0017359338302869397,1,41,40,3,-1,4,10,0,36,98,75
152,12,212,35,94,59,30,30,36,36,0,12,18,35,41,6,0.0014295925661186562,0.004186663943633207,42,52,10,3,4,4,5,3,63,51,29
153,88,88,56,56,0,276,276,79,79,0,88,88,56,56,0,0.008441403723748256,0.008441403723748256,59,59,0,-1,2,2,17,4,20,38,85
154,78,284,70,98,28,32,32,58,58,0,32,32,60,60,0,0.011606930120153852,0.021375812655298,73,87,14,3,3,3,2,9,91,27,37
155,60,162,68,89,21,38,38,52,52,0,38,38,55,55,0,0.005888559855679227,0.006058749446883829,59,59,0,4,3,3,3,5,66,47,63
156,40,1680,46,100,54,158,202,68,73,5,40,120,46,82,36,0.003880322679464924,0.015589366554341537,51,76,25,1,2,2,14,3,17,46,13
157,16,16,37,37,0,116,116,62,62,0,16,16,37,37,0,0.0037441710065012424,0.0037441710065012424,51,51,0,-1,3,3,11,1,19,90,98
158,176,176,87,87,0,174,174,78,78,0,174,174,87,87,0,0.015283025290173252,0.015283025290173252,78,78,0,-1,2,2,10,13,11,33,76
159,24,230,45,93,48,80,80,43,43,0,24,60,45,57,12,0.0013615167296368155,0.00616086320160659,40,59,19,3,3,3,9,4,23,64,21
160,87,703,60,100,40,104,124,64,71,7,87,124,60,80,20,0.008373327887266415,0.031485074372851356,65,92,27,2,3,3,9,8,35,44,0
161,100,100,58,58,0,100,100,35,35,0,100,100,59,59,0,0.01841451376833793,0.01841451376833793,81,81,0,-1,1,1,17,4,20,72,91
162,0,616,1,100,99,0,68,1,35,34,0,43,1,52,51,0.0,0.005616256509751864,1,56,55,2,-1,3,13,0,13,92,44
163,100,100,62,62,0,100,100,48,48,0,100,100,62,62,0,0.021614078082984444,0.023179822322066782,81,85,4,2,1,1,10,4,11,72,52
164,100,100,63,63,0,100,100,39,39,0,100,100,63,63,0,0.02723033459273631,0.03642057251778481,89,94,5,2,1,1,14,15,17,19,5
165,100,100,67,67,0,100,100,57,57,0,100,100,67,67,0,0.02900030634126417,0.04292181490180061,89,97,8,2,1,1,8,8,21,44,12
166,76,177,62,85,23,76,76,57,57,0,76,76,61,61,0,0.005956635692161067,0.006058749446883829,58,59,1,5,3,3,6,6,74,13,95
167,214,1854,93,100,7,136,160,81,93,12,136,160,88,94,6,0.017597603730555838,0.05030804316008033,83,96,13,1,2,2,7,16,46,12,11
168,2,2,27,27,0,22,22,29,29,0,2,2,27,27,0,0.0002723033459273631,0.0002723033459273631,32,32,0,-1,5,5,12,1,14,55,86
169,40,656,54,100,46,28,38,44,58,14,28,38,51,61,10,0.005446066918547262,0.02995336805200994,54,90,36,2,3,3,3,6,92,26,0
170,88,294,74,99,25,48,48,72,72,0,48,48,74,74,0,0.015214949453691413,0.016236087000919025,79,80,1,3,3,3,3,13,60,33,61
171,190,806,91,100,9,88,88,71,71,0,88,88,71,71,0,0.019061234214915415,0.03008951972497362,81,94,13,2,2,2,4,16,53,12,33
172,6,212,31,92,61,9,14,31,35,4,6,14,31,42,11,0.00037441710065012424,0.003880322679464924,34,51,17,3,4,4,3,1,85,55,47
173,28,644,46,100,54,40,50,40,45,5,28,46,46,51,5,0.001599782157323258,0.006126825283365669,42,55,13,2,3,3,5,3,50,43,75
174,6,622,29,100,71,18,58,30,41,11,6,58,29,56,27,0.00013615167296368154,0.009734844616903231,31,68,37,2,4,3,7,1,43,60,33
175,22,228,47,94,47,28,28,45,45,0,22,28,47,49,2,0.0025188059498281084,0.006977773239388679,46,62,16,3,3,3,3,3,58,51,44
176,0,616,1,100,99,0,53,1,37,36,0,34,1,46,45,0.0,0.0035059055788147996,1,50,49,2,-1,3,9,1,54,45,41
177,300,300,95,95,0,112,112,92,92,0,112,112,92,92,0,0.03192756730998332,0.03192756730998332,90,90,0,-1,2,2,4,22,83,9,87
178,100,100,69,69,0,100,100,66,66,0,100,100,72,72,0,0.04428333163143742,0.04911671602164812,94,97,3,2,1,1,6,18,44,30,13
179,34,136,50,89,39,38,38,59,59,0,34,38,61,61,0,0.0030634126416828346,0.0032336022328874367,48,48,0,4,3,3,3,6,92,70,4
180,444,444,98,98,0,336,336,97,97,0,336,336,97,97,0,0.03655672419074849,0.03655672419074849,92,92,0,-1,2,2,12,29,3,0,92
181,0,0,1,1,0,0,0,1,1,0,0,0,1,1,0,0.0,0.0,1,1,0,-1,-1,-1,11,0,38,92,69
182,0,102,1,78,77,0,7,1,28,27,0,4,1,32,31,0.0,0.0007147962830593281,1,37,36,4,-1,5,4,0,47,79,74
183,0,0,1,1,0,0,0,1,1,0,0,0,1,1,0,0.0,0.0,1,1,0,-1,-1,-1,15,0,7,80,93
184,204,410,90,98,8,136,136,81,81,0,136,136,82,82,0,0.021818305592429966,0.023111746485584943,84,85,1,3,2,2,7,16,43,18,52
185,0,616,1,100,99,0,60,1,37,36,0,46,1,54,53,0.0,0.003778208924742163,1,51,50,2,-1,3,9,0,28,80,13
186,0,1640,1,100,99,0,126,1,68,67,0,126,1,76,75,0.0,0.04748289594608394,1,97,96,1,-1,2,7,0,24,40,2
187,0,102,1,71,70,0,10,1,27,26,0,2,1,25,24,0.0,0.00017018959120460194,1,30,29,4,-1,5,7,0,24,92,60
188,0,1640,1,100,99,0,108,1,66,65,0,108,1,77,76,0.0,0.028523775485891283,1,89,88,1,-1,2,9,0,23,82,30
189,373,579,99,100,1,120,120,99,99,0,120,120,99,99,0,0.05265665951870384,0.05922597773920147,97,97,0,3,2,2,3,36,75,2,77
190,248,248,93,93,0,264,264,93,93,0,264,264,94,94,0,0.0228734810578985,0.0228734810578985,86,86,0,-1,2,2,12,16,14,18,86
191,0,616,1,100,99,0,56,1,48,47,0,56,1,57,56,0.0,0.02995336805200994,1,91,90,2,-1,3,6,1,69,45,0
192,0,0,1,1,0,0,0,1,1,0,0,0,1,1,0,0.0,0.0,1,1,0,-1,-1,-1,4,0,77,87,91
193,42,658,52,99,47,122,122,62,62,0,40,62,48,55,7,0.0034718676605738795,0.007250076585316042,51,62,11,2,3,3,12,6,6,41,29
194,404,404,98,98,0,272,272,100,100,0,272,272,100,100,0,0.03492290411518432,0.03492290411518432,90,90,0,-1,2,2,8,22,57,9,36
195,16,632,35,100,65,78,126,39,60,21,16,104,35,70,35,0.00088498587426393,0.010517716736444398,37,71,34,2,3,3,11,2,5,42,8
196,100,100,59,59,0,100,100,40,40,0,100,100,59,59,0,0.018142210422410564,0.022465026039007456,80,85,5,2,1,1,15,7,7,21,13
197,8,214,37,92,55,14,14,35,35,0,8,14,37,42,5,0.002110350930937064,0.004050512270669526,48,54,6,3,4,4,3,2,76,83,90
198,70,70,67,67,0,62,62,80,80,0,62,62,80,80,0,0.00789679703189353,0.00789679703189353,61,61,0,-1,2,2,3,6,55,26,59
199,0,206,1,92,91,0,34,1,33,32,0,12,1,35,34,0.0,0.0012594029749140542,1,39,38,3,-1,4,9,0,35,36,61
200,0,616,1,100,99,0,88,1,48,47,0,88,1,60,59,0.0,0.01834643793185609,1,78,77,2,-1,3,8,0,27,97,9
201,0,206,1,89,88,0,27,1,29,28,0,8,1,32,31,0.0,0.0006126825283365669,1,36,35,3,-1,4,12,0,14,67,74
202,16,118,36,74,38,60,60,38,38,0,16,16,36,36,0,0.0011232513019503727,0.0011913271384322134,39,39,0,4,3,3,9,1,28,71,65
203,280,896,97,100,3,88,88,71,71,0,88,88,71,71,0,0.029408761360155213,0.04047108478845434,93,96,3,2,2,2,4,29,53,0,33
204,32,32,55,55,0,22,22,47,47,0,22,22,52,52,0,0.0046972327172470135,0.0046972327172470135,55,55,0,-1,3,3,2,6,89,35,36
205,0,0,1,1,0,0,0,1,1,0,0,0,1,1,0,0.0,0.0,1,1,0,-1,-1,-1,3,0,94,81,97
206,272,888,95,100,5,280,280,93,93,0,280,280,95,95,0,0.02559651451717213,0.05813676435549202,86,100,14,2,2,2,13,20,13,23,2
207,0,206,1,94,93,0,14,1,31,30,0,9,1,35,34,0.0,0.002280540522141666,1,45,44,3,-1,4,3,0,96,91,70
208,145,761,81,100,19,188,188,80,80,0,145,188,81,90,9,0.009905034208107831,0.01923142380612002,70,83,13,2,2,2,10,8,0,44,33
209,94,94,67,67,0,86,86,65,65,0,86,86,68,68,0,0.011640968038394772,0.011640968038394772,69,69,0,-1,3,3,6,9,71,27,97
210,90,290,74,98,24,28,28,48,48,0,28,28,54,54,0,0.010755982164130842,0.014023622315259198,70,77,7,3,3,3,3,14,55,32,62
211,100,100,78,78,0,100,100,97,97,0,100,100,97,97,0,0.08642227441369686,0.095340208992818,99,100,1,3,1,1,3,27,96,10,14
212,16,1656,36,100,64,44,88,36,48,12,16,88,36,63,27,0.0005446066918547262,0.025119983661799246,36,87,51,1,3,2,9,1,23,49,16
213,78,179,74,93,19,32,32,63,63,0,32,32,65,65,0,0.011504816365431091,0.011640968038394772,73,73,0,5,3,3,2,8,98,17,60
214,44,44,51,51,0,74,74,42,42,0,44,44,51,51,0,0.0036760951700194017,0.0036760951700194017,51,51,0,-1,3,3,9,6,31,73,80
215,58,674,66,100,34,62,62,82,82,0,58,62,83,83,0,0.010415602981721638,0.026175159127267776,70,87,17,2,2,2,3,3,60,54,23
216,22,1662,40,100,60,90,160,36,59,23,22,124,40,82,42,0.00088498587426393,0.016236087000919025,37,78,41,1,3,2,16,3,4,51,39
217,100,100,59,59,0,100,100,39,39,0,100,100,59,59,0,0.029817216379046257,0.050818611933694136,90,98,8,2,1,1,14,16,16,12,11
218,0,101,1,78,77,0,6,1,25,24,0,1,1,25,24,0.0,0.0002042275094455223,1,31,30,5,-1,6,6,0,32,98,55
219,22,228,41,92,51,66,66,50,50,0,22,28,41,45,4,0.002723033459273631,0.003778208924742163,45,47,2,3,3,3,6,2,56,52,53
220,6,108,32,84,52,8,8,32,32,0,6,8,32,37,5,0.0004084550188910446,0.003369753905851118,35,53,18,4,4,4,2,1,98,88,35
221,180,386,90,98,8,132,132,74,74,0,132,132,81,81,0,0.020456788862793153,0.02464345280642636,83,86,3,3,2,2,8,17,21,6,57
222,6,212,29,93,64,29,38,31,35,4,6,20,29,40,11,0.00017018959120460194,0.0020763130126961434,29,44,15,3,4,4,9,1,23,60,54
223,6,6,29,29,0,42,42,31,31,0,6,6,29,29,0,0.00013615167296368154,0.00013615167296368154,30,30,0,-1,4,4,14,1,16,60,66
224,29,129,47,82,35,46,46,42,42,0,29,29,47,47,0,0.0036760951700194017,0.003778208924742163,49,50,1,5,3,3,6,6,48,73,60
225,80,696,56,100,44,100,110,59,71,12,80,110,57,75,18,0.00789679703189353,0.014227849824704722,62,76,14,2,2,2,6,6,40,28,62
226,22,1662,45,100,55,52,96,42,62,20,22,96,45,67,22,0.002144388849177984,0.03815650634807175,45,94,49,1,3,2,7,2,62,83,10
227,0,102,1,80,79,0,5,1,28,27,0,2,1,27,26,0.0,0.0006126825283365669,1,34,33,4,-1,5,3,0,55,89,71
228,370,2010,97,100,3,88,112,73,91,18,88,112,74,91,17,0.04094761564382722,0.0746451547023384,94,100,6,1,2,2,4,40,83,3,30
229,100,1700,63,100,37,228,228,78,78,0,100,228,63,90,27,0.009190237925048503,0.03897341638585384,66,94,28,1,2,2,14,6,17,77,3
230,26,26,47,47,0,58,58,42,42,0,26,26,47,47,0,0.003948398515946765,0.003948398515946765,50,50,0,-1,3,3,7,6,43,73,97
231,100,100,69,69,0,100,100,70,70,0,100,100,72,72,0,0.03318697028489737,0.03318697028489737,93,93,0,-1,1,1,6,6,65,41,81
232,0,616,1,100,99,0,34,1,38,37,0,34,1,49,48,0.0,0.021511964328261683,1,89,88,2,-1,3,4,0,53,59,1
233,242,242,96,96,0,56,56,76,76,0,56,56,77,77,0,0.0333911977943429,0.0333911977943429,92,92,0,-1,2,2,2,27,68,10,86
234,84,290,73,98,25,72,72,80,80,0,72,72,80,80,0,0.011300588855985567,0.012764219340345145,74,78,4,3,2,2,3,9,66,31,51
235,0,102,1,83,82,0,4,1,30,29,0,4,1,32,31,0.0,0.001497668402600497,1,42,41,4,-1,5,2,0,90,97,83
236,32,1672,49,100,51,50,84,45,73,28,32,84,49,74,25,0.004765308553728854,0.02811532046700024,53,90,37,1,3,2,5,3,45,29,73
237,22,638,51,100,49,34,54,47,59,12,22,54,51,61,10,0.0022465026039007454,0.018993158378433576,48,82,34,2,3,3,4,2,78,75,6
238,22,228,40,92,52,90,98,36,37,1,22,28,40,42,2,0.00088498587426393,0.0027911092957554717,37,45,8,3,3,3,16,3,4,51,46
239,22,22,39,39,0,90,90,36,36,0,22,22,39,39,0,0.0011913271384322134,0.0011913271384322134,38,38,0,-1,3,3,16,3,9,51,80
240,102,102,80,80,0,62,62,80,80,0,62,62,81,81,0,0.020797168045202357,0.020797168045202357,83,83,0,-1,2,2,3,9,94,39,84
241,16,632,32,100,68,88,106,37,55,18,16,48,32,51,19,0.0004084550188910446,0.005207801490860819,36,56,20,2,3,3,14,1,8,49,35
242,228,329,92,94,2,104,104,82,82,0,104,104,82,82,0,0.023384049831512304,0.023520201504475986,86,86,0,5,2,2,5,19,80,15,65
243,34,1674,48,100,52,80,154,41,73,32,34,154,48,85,37,0.0014636304843595766,0.03829265802103543,41,95,54,1,3,2,10,4,22,64,3
244,0,616,1,100,99,0,62,1,42,41,0,62,1,57,56,0.0,0.00980292045338507,1,69,68,2,-1,3,7,1,24,45,19
245,22,1662,43,100,57,50,92,37,50,13,22,92,43,66,23,0.0014295925661186562,0.0317233398005378,41,91,50,1,3,2,8,3,30,51,10
246,0,0,1,1,0,0,0,1,1,0,0,0,1,1,0,0.0,0.0,1,1,0,-1,-1,-1,4,1,47,45,97
247,202,818,93,100,7,172,172,85,85,0,172,172,90,90,0,0.015555328636100617,0.03512713162462984,78,91,13,2,2,2,9,14,23,32,7
248,260,860,97,100,3,88,88,82,82,0,88,88,82,82,0,0.033425235712583816,0.0404030089519725,92,94,2,2,2,2,4,22,78,9,8
249,16,222,46,96,50,22,22,48,48,0,16,22,47,50,3,0.0031314884781646754,0.01844855168657885,50,82,32,3,3,3,2,3,95,46,9
250,2,618,28,100,72,5,28,28,43,15,2,28,28,53,25,0.00017018959120460194,0.015623404472582456,31,80,49,2,5,3,3,1,76,60,23
251,164,780,87,100,13,164,164,77,77,0,164,164,87,87,0,0.011777119711358454,0.025324211171244768,72,88,16,2,2,2,10,14,36,32,37
252,0,206,1,86,85,0,52,1,33,32,0,6,1,26,25,0.0,0.0025188059498281084,1,46,45,3,-1,4,14,0,25,79,46
253,266,882,93,100,7,272,272,96,96,0,272,272,96,96,0,0.02651553830967698,0.03451444909629327,88,93,5,2,2,2,11,16,38,18,17
254,184,800,84,100,16,166,166,84,84,0,166,166,85,85,0,0.011947309302563056,0.024609414888185438,69,86,17,2,2,2,8,13,27,24,14
255,40,656,47,100,53,62,88,38,48,10,40,74,47,56,9,0.002825147213996392,0.008101024541339052,47,62,15,2,2,2,8,1,27,65,62
256,16,222,44,94,50,44,44,53,53,0,16,44,45,57,12,0.0027911092957554717,0.007556417849484326,50,64,14,3,3,3,4,3,78,46,62
257,0,206,1,89,88,0,46,1,34,33,0,46,1,54,53,0.0,0.005412029000306341,1,58,57,3,-1,4,9,0,28,96,24
258,40,246,47,94,47,70,74,40,41,1,40,48,47,50,3,0.002144388849177984,0.0031314884781646754,45,47,2,3,2,2,10,1,0,88,74
259,207,309,93,98,5,112,112,94,94,0,112,112,94,94,0,0.02644746247319514,0.02661765206439974,87,87,0,4,2,2,4,19,78,15,56
260,142,348,90,98,8,72,72,80,80,0,72,72,80,80,0,0.017359338302869398,0.026958031246808945,81,90,9,3,2,2,3,15,87,19,37
261,40,40,48,48,0,54,54,56,56,0,40,40,49,49,0,0.004731270635487933,0.004731270635487933,49,49,0,-1,2,2,4,1,67,71,66
262,35,136,58,92,34,22,22,55,55,0,22,22,57,57,0,0.0048674223084516155,0.005241839409101739,55,56,1,5,3,3,2,6,97,28,56
263,192,808,92,100,8,48,48,60,60,0,48,48,63,63,0,0.026855917492086184,0.0405731985431771,90,95,5,2,3,3,3,22,58,9,16
264,0,616,1,100,99,0,66,1,36,35,0,65,1,57,56,0.0,0.006467204465774873,1,60,59,2,-1,3,10,0,1,66,24
265,0,0,1,1,0,0,0,1,1,0,0,0,1,1,0,0.0,0.0,1,1,0,-1,-1,-1,11,0,5,89,40
266,104,310,77,96,19,60,60,55,55,0,60,60,60,60,0,0.01143674052894925,0.015351101126655093,71,76,5,3,3,3,5,14,70,32,22
267,12,218,36,93,57,30,30,35,35,0,12,20,36,44,8,0.000442492937131965,0.0012934408931549745,35,40,5,3,4,4,7,2,62,56,64
268,0,0,1,1,0,0,0,1,1,0,0,0,1,1,0,0.0,0.0,1,1,0,-1,-1,-1,5,0,80,40,99
269,6,1646,30,100,70,27,80,34,57,23,6,80,30,60,30,0.0004084550188910446,0.03669287586371218,33,93,60,1,4,2,6,1,41,88,7
270,0,616,1,100,99,0,34,1,44,43,0,34,1,52,51,0.0,0.011743081793117532,1,72,71,2,-1,3,4,0,84,36,39
271,256,872,94,100,6,104,104,88,88,0,104,104,88,88,0,0.03066816433506927,0.03788420300214439,88,93,5,2,2,2,5,22,88,9,32
272,120,120,78,78,0,238,238,79,79,0,120,120,78,78,0,0.00970080669866231,0.00970080669866231,66,66,0,-1,2,2,14,7,16,21,69
273,80,696,65,100,35,100,110,70,80,10,80,110,65,81,16,0.010007147962830594,0.018040096667687803,68,79,11,2,2,2,6,5,65,25,31
274,431,637,100,100,0,224,224,98,98,0,224,224,98,98,0,0.038530923448721874,0.03897341638585384,95,95,0,3,2,2,8,30,21,7,64
275,44,145,57,87,30,38,38,56,56,0,38,38,59,59,0,0.0057524081827155455,0.005786446100956465,58,58,0,5,3,3,3,4,58,38,95
276,0,206,1,92,91,0,38,1,32,31,0,19,1,41,40,0.0,0.002757071377514551,1,47,46,3,-1,4,11,0,19,81,41
277,0,101,1,83,82,0,2,1,24,23,0,1,1,24,23,0.0,6.807583648184077e-05,1,27,26,5,-1,6,2,0,89,59,65
278,124,740,83,100,17,54,64,55,69,14,54,64,60,69,9,0.013070560604513427,0.027843017121072875,72,88,16,2,3,3,4,14,84,32,5
279,100,100,59,59,0,100,100,46,46,0,100,100,59,59,0,0.01872085503250621,0.01872085503250621,78,78,0,-1,1,1,11,6,5,41,80
280,0,206,1,92,91,0,10,1,31,30,0,6,1,31,30,0.0,0.002586881786309949,1,48,47,3,-1,4,3,0,64,84,90
281,0,0,1,1,0,0,0,1,1,0,0,0,1,1,0,0.0,0.0,1,1,0,-1,-1,-1,10,0,36,59,91
282,24,640,44,100,56,68,78,42,46,4,24,69,44,62,18,0.0013274788113958951,0.00881582082439838,40,68,28,2,3,3,8,4,39,64,25
283,100,100,64,64,0,100,100,44,44,0,100,100,64,64,0,0.021784267674189048,0.021784267674189048,83,83,0,-1,1,1,13,13,13,24,36
284,1,1,25,25,0,6,6,25,25,0,1,1,25,25,0,3.4037918240920386e-05,3.4037918240920386e-05,28,28,0,-1,6,6,6,1,69,78,76
285,64,680,59,100,41,86,86,57,57,0,64,86,60,65,5,0.007794683277170768,0.014534191088873005,63,76,13,2,3,3,6,4,65,38,34
286,6,212,27,90,63,36,48,30,32,2,6,18,27,38,11,0.00010211375472276115,0.0012253650566731338,28,38,10,3,4,4,14,1,8,4,64
287,6,6,30,30,0,30,30,37,37,0,6,6,30,30,0,0.0013955546478777359,0.0013955546478777359,39,39,0,-1,4,4,5,1,80,71,86
288,2,2,29,29,0,4,4,31,31,0,2,2,29,29,0,3.4037918240920386e-05,3.4037918240920386e-05,27,27,0,-1,5,5,2,1,90,65,45
289,64,270,71,98,27,32,32,63,63,0,32,32,65,65,0,0.011743081793117532,0.025154021580040164,74,90,16,3,3,3,2,8,98,20,18
290,0,616,1,100,99,0,18,1,50,49,0,18,1,53,52,0.0,0.008271214132543654,1,63,62,2,-1,3,2,0,86,76,72
291,104,310,80,97,17,50,50,45,45,0,50,50,56,56,0,0.010960209673576363,0.012219612648490419,74,75,1,3,3,3,5,14,45,32,61
292,73,73,56,56,0,154,154,67,67,0,73,73,56,56,0,0.005888559855679227,0.005888559855679227,56,56,0,-1,2,2,10,4,18,22,40
293,228,329,100,100,0,56,56,92,92,0,56,56,92,92,0,0.054154327921304334,0.054324517512508934,98,98,0,5,2,2,2,36,97,2,55
294,0,206,1,93,92,0,20,1,34,33,0,20,1,47,46,0.0,0.005241839409101739,1,56,55,3,-1,4,4,0,73,86,44
295,260,876,94,100,6,264,264,93,93,0,264,264,94,94,0,0.022601177711971135,0.04217298070050036,85,93,8,2,2,2,12,18,14,30,10
296,156,1796,83,100,17,200,224,81,86,5,156,224,83,93,10,0.014670342761836687,0.028693965077095884,76,90,14,1,2,2,11,13,19,33,24
297,174,275,87,94,7,224,224,87,87,0,174,175,87,87,0,0.019878144252697506,0.019878144252697506,80,80,0,5,2,2,11,12,19,37,58
298,153,153,92,92,0,80,80,97,97,0,80,80,97,97,0,0.02900030634126417,0.02900030634126417,90,90,0,-1,2,2,2,18,89,5,84
299,0,206,1,87,86,0,35,1,29,28,0,8,1,33,32,0.0,0.001157289220191293,1,37,36,3,-1,4,16,0,9,79,83
300,0,206,1,87,86,0,43,1,32,31,0,6,1,28,27,0.0,0.0013955546478777359,1,39,38,3,-1,4,14,0,16,87,94
301,8,214,33,90,57,24,28,31,33,2,8,20,33,39,6,0.00030634126416828345,0.004969536063174376,33,51,18,3,4,4,6,2,71,56,62
302,50,666,66,100,34,12,22,40,48,8,12,22,42,52,10,0.00704584907587052,0.020014295925661188,66,85,19,2,4,3,2,9,90,31,5
303,6,212,30,92,62,24,38,32,33,1,6,21,30,40,10,0.0002723033459273631,0.0030293747234419145,33,48,15,3,4,4,9,1,35,60,22
304,16,16,33,33,0,136,136,61,61,0,16,16,33,33,0,0.0027911092957554717,0.0027911092957554717,48,48,0,-1,3,3,15,2,7,94,82
305,190,806,86,100,14,246,256,84,86,2,190,250,86,90,4,0.014874570271282209,0.021614078082984444,75,84,9,2,2,2,14,8,17,8,21
306,499,499,99,99,0,216,216,99,99,0,216,216,99,99,0,0.05194186323564451,0.05194186323564451,98,98,0,-1,2,2,6,36,44,2,97
307,334,334,95,95,0,216,216,85,85,0,216,216,87,87,0,0.03441233534157051,0.03441233534157051,94,94,0,-1,2,2,12,29,2,0,93
308,6,107,29,73,44,26,26,30,30,0,6,6,29,29,0,0.00017018959120460194,0.00017018959120460194,30,30,0,5,4,4,10,1,11,65,68
309,120,120,76,76,0,116,116,68,68,0,120,120,77,77,0,0.007216038667075122,0.007216038667075122,59,59,0,-1,2,2,7,6,24,13,36
310,0,616,1,100,99,0,50,1,44,43,0,50,1,57,56,0.0,0.010415602981721638,1,69,68,2,-1,3,5,0,63,67,33
311,100,100,62,62,0,100,100,43,43,0,100,100,62,62,0,0.04949113312229824,0.04949113312229824,98,98,0,-1,1,1,12,29,14,11,76
312,0,0,1,1,0,0,0,1,1,0,0,0,1,1,0,0.0,0.0,1,1,0,-1,-1,-1,8,0,10,76,59
313,163,369,89,100,11,88,88,84,84,0,88,88,84,84,0,0.023690391095680587,0.041594336090404714,87,97,10,3,2,2,4,20,67,23,1
314,144,144,85,85,0,284,284,86,86,0,144,144,85,85,0,0.009939072126348753,0.009939072126348753,67,67,0,-1,2,2,16,7,4,21,84
315,88,88,61,61,0,122,122,69,69,0,88,88,61,61,0,0.007726607440688927,0.007726607440688927,62,62,0,-1,2,2,8,4,27,72,50
316,16,222,35,93,58,21,22,34,35,1,16,22,35,40,5,0.0004765308553728854,0.006841621566424997,32,60,28,3,3,3,4,1,67,60,24
317,0,206,1,92,91,0,24,1,39,38,0,20,1,50,49,0.0,0.005003573981415297,1,57,56,3,-1,4,4,0,78,92,38
318,22,228,50,97,47,28,28,46,46,0,22,28,50,52,2,0.0034037918240920387,0.017597603730555838,51,80,29,3,3,3,3,2,81,75,16
319,24,230,47,94,47,60,60,48,48,0,24,60,47,60,13,0.0021784267674189047,0.005548180673270023,47,57,10,3,3,3,5,3,63,54,35
320,132,132,83,83,0,216,216,96,96,0,132,132,83,83,0,0.012900371013308825,0.012900371013308825,74,74,0,-1,2,2,9,5,35,25,85
321,16,16,33,33,0,66,66,44,44,0,16,16,33,33,0,0.004152626025392287,0.004152626025392287,49,49,0,-1,3,3,6,1,51,90,84
322,1,617,25,100,75,6,30,25,39,14,1,30,25,47,22,0.0,0.005718370264474625,1,55,54,2,6,3,6,1,69,68,48
323,0,102,1,80,79,0,5,1,28,27,0,3,1,30,29,0.0,0.0006126825283365669,1,35,34,4,-1,5,3,0,55,93,51
324,0,616,1,100,99,0,36,1,35,34,0,29,1,47,46,0.0,0.003948398515946765,1,49,48,2,-1,3,7,0,43,36,41
325,6,622,28,100,72,43,118,30,54,24,6,87,28,55,27,0.00017018959120460194,0.011913271384322134,29,72,43,2,4,3,16,1,4,60,37
326,0,206,1,90,89,0,22,1,33,32,0,15,1,38,37,0.0,0.002825147213996392,1,49,48,3,-1,4,5,0,80,84,22
327,22,638,43,100,57,58,108,39,65,26,22,108,43,77,34,0.002484768031587188,0.03369753905851118,47,92,45,2,3,3,8,2,30,75,3
328,0,616,1,100,99,0,34,1,42,41,0,34,1,51,50,0.0,0.00796487286837537,1,64,63,2,-1,3,4,0,83,81,24
329,134,334,80,95,15,176,176,85,85,0,134,176,80,88,8,0.008747744987916539,0.015657442390823378,64,78,14,3,2,2,8,6,42,13,8
330,112,214,84,94,10,32,32,58,58,0,32,32,60,60,0,0.018857006705469893,0.019265461724360937,84,85,1,4,3,3,2,17,91,6,63
331,6,212,27,86,59,42,48,34,34,0,6,12,27,32,5,0.00010211375472276115,0.0006807583648184077,29,36,7,3,4,4,12,1,2,4,49
332,6,212,30,94,64,12,12,32,32,0,6,12,30,36,6,0.0019741992579733825,0.00878178290615746,45,64,19,3,4,4,2,2,91,94,17
333,80,80,69,69,0,84,84,74,74,0,84,84,75,75,0,0.010687906327649,0.010687906327649,73,73,0,-1,2,2,5,6,45,77,66
334,100,100,62,62,0,100,100,43,43,0,100,100,62,62,0,0.05834099186493754,0.06987984614860955,100,100,0,2,1,1,12,40,14,3,5
335,16,16,32,32,0,110,110,56,56,0,16,16,32,32,0,0.0007488342013002485,0.0007488342013002485,36,36,0,-1,3,3,17,1,20,49,80
336,230,830,92,100,8,208,208,85,85,0,208,208,91,91,0,0.016270124919159943,0.020865243881684196,78,82,4,2,2,2,10,14,18,14,44
337,0,1640,1,100,99,0,134,1,58,57,0,110,1,76,75,0.0,0.012730181422104225,1,74,73,1,-1,2,16,0,4,80,24
338,0,206,1,92,91,0,13,1,29,28,0,7,1,34,33,0.0,0.0005786446100956465,1,35,34,3,-1,4,5,0,63,97,56
339,0,206,1,88,87,0,30,1,33,32,0,14,1,34,33,0.0,0.002144388849177984,1,45,44,3,-1,4,7,1,24,69,70
340,42,42,58,58,0,52,52,78,78,0,42,42,65,65,0,0.00803294870485721,0.00803294870485721,63,63,0,-1,2,2,3,2,85,74,67
341,0,616,1,100,99,0,124,1,57,56,0,100,1,60,59,0.0,0.010483678818203479,1,69,68,2,-1,3,14,0,8,85,19
342,54,260,54,95,41,54,54,56,56,0,54,54,57,57,0,0.006535280302256714,0.010517716736444398,55,68,13,3,3,3,4,7,67,62,34
343,58,58,66,66,0,28,28,45,45,0,28,28,49,49,0,0.008169100377820893,0.008169100377820893,66,66,0,-1,3,3,3,7,60,48,66
344,10,216,40,94,54,24,24,38,38,0,10,24,40,50,10,0.0009190237925048504,0.0040845501889104465,38,52,14,3,4,4,4,3,72,43,22
345,2,104,29,77,48,9,10,29,30,1,2,4,29,32,3,6.807583648184077e-05,0.00088498587426393,28,37,9,4,5,5,5,1,49,95,71
346,0,0,1,1,0,0,0,1,1,0,0,0,1,1,0,0.0,0.0,1,1,0,-1,-1,-1,12,0,2,80,99
347,0,616,1,100,99,0,58,1,33,32,0,24,1,42,41,0.0,0.0024507301133462676,1,46,45,2,-1,3,10,0,0,79,70
348,98,98,77,77,0,78,78,77,77,0,78,78,79,79,0,0.014432077334150244,0.014432077334150244,78,78,0,-1,2,2,4,8,78,8,81
349,0,0,1,1,0,0,0,1,1,0,0,0,1,1,0,0.0,0.0,1,1,0,-1,-1,-1,12,0,6,96,86
350,100,100,64,64,0,100,100,45,45,0,100,100,64,64,0,0.03175737771877872,0.032540249838319886,90,91,1,3,1,1,10,8,18,8,71
351,78,78,58,58,0,122,122,72,72,0,78,78,58,58,0,0.00793083495013445,0.00793083495013445,62,62,0,-1,2,2,8,4,10,38,67
352,16,632,43,100,57,54,64,62,67,5,16,64,43,70,27,0.005446066918547262,0.022430988120766535,59,85,26,2,3,3,4,1,72,90,39
353,6,6,29,29,0,16,16,30,30,0,6,6,29,29,0,6.807583648184077e-05,6.807583648184077e-05,27,27,0,-1,4,4,6,1,59,65,50
354,0,206,1,91,90,0,15,1,27,26,0,8,1,34,33,0.0,0.001157289220191293,1,36,35,3,-1,4,6,0,56,81,51
355,134,750,89,100,11,56,56,85,85,0,56,56,85,85,0,0.02028659927158855,0.028149358385241158,86,90,4,2,2,2,2,18,90,5,75
356,0,616,1,100,99,0,38,1,50,49,0,38,1,53,52,0.0,0.016882807447496512,1,83,82,2,-1,3,3,0,82,99,5
357,232,232,93,93,0,120,120,79,79,0,120,120,81,81,0,0.023554239422716908,0.023554239422716908,86,86,0,-1,2,2,6,19,44,15,87
358,100,100,66,66,0,100,100,66,66,0,100,100,69,69,0,0.021818305592429966,0.021818305592429966,83,83,0,-1,1,1,7,2,62,74,84
359,0,0,1,1,0,0,0,1,1,0,0,0,1,1,0,0.0,0.0,1,1,0,-1,-1,-1,10,1,18,50,89
360,0,616,1,100,99,0,154,1,64,63,0,154,1,86,85,0.0,0.021784267674189048,1,85,84,2,-1,3,14,0,8,86,0
361,40,656,52,100,48,62,76,49,58,9,40,74,52,65,13,0.0024166921951053475,0.008747744987916539,47,67,20,2,2,2,6,1,34,49,62
362,0,102,1,84,83,0,3,1,26,25,0,2,1,26,25,0.0,0.0002382654276864427,1,32,31,4,-1,5,2,0,98,92,88
363,221,323,93,98,5,72,72,80,80,0,72,72,80,80,0,0.03359542530378842,0.03454848701453419,91,91,0,4,2,2,3,29,76,0,71
364,226,226,90,90,0,192,192,86,86,0,192,192,89,89,0,0.018006058749446885,0.018006058749446885,79,79,0,-1,2,2,9,18,28,5,97
365,97,1737,79,100,21,32,56,64,81,17,32,56,64,81,17,0.013819394805813677,0.09193641716872596,76,99,23,1,3,2,2,15,89,19,3
366,1,617,26,100,74,4,34,26,45,19,1,34,26,51,25,0.00010211375472276115,0.020558902617515914,29,83,54,2,6,3,4,1,73,78,7
367,0,616,1,100,99,0,36,1,37,36,0,36,1,51,50,0.0,0.012287688484972258,1,73,72,2,-1,3,5,0,63,80,6
368,121,222,84,97,13,62,62,82,82,0,62,62,82,82,0,0.018142210422410564,0.018176248340651485,78,78,0,6,2,2,3,13,81,33,58
369,82,288,72,97,25,22,22,42,42,0,22,22,46,46,0,0.01334286395044079,0.015521290717859695,76,79,3,3,3,3,2,8,68,20,70
370,335,335,99,99,0,96,96,92,92,0,96,96,92,92,0,0.05051227066952585,0.05051227066952585,96,96,0,-1,2,2,3,36,96,2,91
371,91,191,63,86,23,144,144,65,65,0,91,91,63,63,0,0.007318152421797883,0.007454304094761564,61,61,0,4,2,2,10,6,18,35,88
372,100,100,69,69,0,100,100,87,87,0,100,100,87,87,0,0.06341264168283468,0.08856666326287484,100,100,0,2,1,1,4,18,83,5,11
373,0,206,1,94,93,0,10,1,31,30,0,8,1,34,33,0.0,0.0013955546478777359,1,40,39,3,-1,4,3,0,96,40,52
374,0,206,1,97,96,0,12,1,38,37,0,12,1,43,42,0.0,0.0088498587426393,1,68,67,3,-1,4,2,1,97,45,14
375,214,414,96,100,4,56,56,82,82,0,56,56,82,82,0,0.03887130263113108,0.04755097178256578,97,98,1,3,2,2,2,27,89,10,30
376,72,1712,54,100,46,148,182,65,70,5,72,144,55,83,28,0.002484768031587188,0.015997821573232582,46,74,28,1,2,2,14,3,25,43,27
377,0,206,1,94,93,0,14,1,31,30,0,8,1,34,33,0.0,0.001157289220191293,1,40,39,3,-1,4,3,0,96,84,43
378,0,616,1,100,99,0,104,1,54,53,0,46,1,51,50,0.0,0.006297014874570271,1,57,56,2,-1,3,14,0,16,36,25
379,145,351,83,95,12,204,204,79,79,0,145,157,83,83,0,0.009973110044589673,0.011811157629599374,65,72,7,3,2,2,11,8,5,44,75
380,38,244,49,93,44,90,90,50,50,0,38,74,49,60,11,0.003199564314646516,0.006501242384015794,49,60,11,3,3,3,9,6,23,70,13
381,110,1750,74,100,26,126,150,77,84,7,110,150,76,88,12,0.007420266176520644,0.0422410565369822,57,96,39,1,2,2,7,6,46,13,10
382,94,300,62,94,32,120,120,77,77,0,94,120,63,83,20,0.006739507811702236,0.007726607440688927,57,61,4,3,2,2,6,5,40,47,61
383,16,632,47,100,53,22,22,49,49,0,16,22,48,49,1,0.002382654276864427,0.0265495762279179,47,89,42,2,3,3,2,1,93,53,1
384,249,249,93,93,0,278,278,94,94,0,278,278,94,94,0,0.018380475850097007,0.018380475850097007,78,78,0,-1,2,2,12,15,3,19,80
385,100,100,64,64,0,100,100,44,44,0,100,100,64,64,0,0.028047244630518397,0.028047244630518397,90,90,0,-1,1,1,13,8,13,8,59
386,106,106,76,76,0,60,60,51,51,0,60,60,62,62,0,0.009054086252084823,0.009054086252084823,68,68,0,-1,3,3,5,13,80,24,66
387,0,616,1,100,99,0,66,1,48,47,0,66,1,56,55,0.0,0.02365635317743967,1,87,86,2,-1,3,6,0,41,89,1
388,44,44,56,56,0,64,64,64,64,0,44,44,58,58,0,0.007182000748834201,0.007182000748834201,61,61,0,-1,3,3,4,7,77,62,80
389,0,616,1,100,99,0,34,1,35,34,0,34,1,46,45,0.0,0.0088498587426393,1,64,63,2,-1,3,6,0,56,89,14
390,130,336,80,96,16,86,86,56,56,0,86,86,62,62,0,0.014534191088873005,0.02723033459273631,78,89,11,3,3,3,6,15,51,19,23
391,0,206,1,88,87,0,32,1,33,32,0,10,1,35,34,0.0,0.0015657442390823377,1,40,39,3,-1,4,8,0,10,99,54
392,182,798,89,100,11,104,104,73,73,0,104,104,79,79,0,0.019878144252697506,0.048844412675720754,84,97,13,2,2,2,5,18,52,30,3
393,102,308,84,100,16,56,56,82,82,0,56,56,82,82,0,0.01783586915824228,0.02130773681881616,81,85,4,3,2,2,2,8,89,17,13
394,168,168,90,90,0,96,96,93,93,0,96,96,93,93,0,0.02569862827189489,0.02569862827189489,91,91,0,-1,2,2,3,18,66,30,93
395,0,0,1,1,0,0,0,1,1,0,0,0,1,1,0,0.0,0.0,1,1,0,-1,-1,-1,4,0,83,87,67
396,67,67,60,60,0,76,76,57,57,0,76,76,61,61,0,0.007318152421797883,0.007318152421797883,62,62,0,-1,3,3,6,8,74,44,96
397,0,616,1,100,99,0,44,1,35,34,0,16,1,37,36,0.0,0.00353994349705572,1,49,48,2,-1,3,9,0,54,99,90
398,32,32,53,53,0,22,22,48,48,0,32,32,70,70,0,0.004663194799006093,0.004663194799006093,55,55,0,-1,3,3,2,3,95,29,66
399,136,238,79,91,12,238,238,87,87,0,136,138,79,80,1,0.010075223799312433,0.010211375472276116,66,67,1,4,2,2,11,4,5,38,65
400,16,1656,34,100,66,156,190,67,71,4,16,106,34,74,40,0.0030293747234419145,0.014806494434800367,49,74,25,1,3,2,16,3,9,46,21
401,0,616,1,100,99,0,74,1,41,40,0,74,1,60,59,0.0,0.012764219340345145,1,70,69,2,-1,3,9,0,23,96,37
402,100,100,64,64,0,100,100,49,49,0,100,100,64,64,0,0.038939378467612924,0.060417304877633686,94,99,5,2,1,1,8,18,42,5,7
403,0,0,1,1,0,0,0,1,1,0,0,0,1,1,0,0.0,0.0,1,1,0,-1,-1,-1,6,0,51,99,89
404,174,380,86,98,12,164,164,69,69,0,174,164,87,86,-1,0.009156200006807584,0.009870996289866912,66,69,3,3,2,2,10,13,0,24,71
405,0,616,1,99,98,0,92,1,34,33,0,52,1,50,49,0.0,0.005956635692161067,1,55,54,2,-1,3,17,0,20,82,48
406,0,0,1,1,0,0,0,1,1,0,0,0,1,1,0,0.0,0.0,1,1,0,-1,-1,-1,2,0,86,80,93
407,0,206,1,88,87,0,38,1,31,30,0,6,1,28,27,0.0,0.0019741992579733825,1,42,41,3,-1,4,11,0,33,67,94
408,23,23,48,48,0,36,36,40,40,0,23,23,48,48,0,0.0012934408931549745,0.0012934408931549745,40,40,0,-1,3,3,5,4,37,64,86
409,0,616,1,100,99,0,38,1,45,44,0,38,1,50,49,0.0,0.016712617856291908,1,81,80,2,-1,3,3,0,96,66,5
410,63,63,66,66,0,38,38,59,59,0,38,38,62,62,0,0.007250076585316042,0.007250076585316042,65,65,0,-1,3,3,3,8,92,57,36
411,0,616,1,100,99,0,116,1,58,57,0,95,1,57,56,0.0,0.007862759113652609,1,57,56,2,-1,3,16,0,9,91,24
412,16,632,39,100,61,42,56,41,46,5,16,32,39,50,11,0.0013274788113958951,0.005956635692161067,42,57,15,2,3,3,6,1,32,71,90
413,49,665,57,100,43,60,60,48,48,0,49,60,57,60,3,0.004799346471969774,0.013955546478777357,54,76,22,2,3,3,5,4,63,22,17
414,0,616,1,100,99,0,28,1,45,44,0,28,1,52,51,0.0,0.018040096667687803,1,83,82,2,-1,3,3,0,81,92,30
415,104,310,72,94,22,124,124,85,85,0,104,124,75,88,13,0.012287688484972258,0.014840532353041287,74,77,3,3,2,2,6,5,40,25,73
416,0,101,1,80,79,0,3,1,24,23,0,1,1,24,23,0.0,3.4037918240920386e-05,1,26,25,6,-1,7,3,0,87,40,78
417,0,206,1,93,92,0,12,1,35,34,0,12,1,36,35,0.0,0.007250076585316042,1,61,60,3,-1,4,2,0,68,59,32
418,152,152,84,84,0,88,88,73,73,0,88,88,74,74,0,0.017052997038701112,0.017052997038701112,82,82,0,-1,2,2,4,8,83,8,50
419,66,272,67,98,31,38,38,57,57,0,38,38,60,60,0,0.008169100377820893,0.019639878825011062,65,85,20,3,3,3,3,9,85,31,15
420,0,1640,1,100,99,0,56,1,83,82,0,56,1,84,83,0.0,0.07951257701079002,1,98,97,1,-1,2,2,0,98,85,23
421,16,632,41,100,59,28,28,42,42,0,16,28,41,50,9,0.002212464685659825,0.008475441641989176,47,67,20,2,3,3,3,2,64,94,72
422,125,1765,83,100,17,60,84,53,73,20,60,84,60,73,13,0.014329963579427483,0.05323530412879948,76,98,22,1,3,2,5,15,49,19,1
423,232,232,94,94,0,72,72,80,80,0,72,72,80,80,0,0.03315293236665646,0.03315293236665646,90,90,0,-1,2,2,3,27,76,10,92
424,144,760,85,100,15,284,284,86,86,0,144,184,85,87,2,0.009939072126348753,0.013513053541645392,67,75,8,2,2,2,16,7,4,21,47
425,16,16,39,39,0,66,66,49,49,0,16,16,39,39,0,0.0034037918240920387,0.0034037918240920387,51,51,0,-1,3,3,6,1,44,90,76
426,0,1640,1,100,99,0,58,1,64,63,0,58,1,65,64,0.0,0.030702202253310187,1,91,90,1,-1,2,4,1,47,69,44
427,18,18,45,45,0,34,34,43,43,0,18,18,45,45,0,0.0016338200755641784,0.0016338200755641784,43,43,0,-1,3,3,4,2,79,61,81
428,0,0,1,1,0,0,0,1,1,0,0,0,1,1,0,0.0,0.0,1,1,0,-1,-1,-1,2,0,86,84,92
429,146,762,85,100,15,80,80,59,59,0,80,80,63,63,0,0.02215868477483917,0.028728002995336805,85,87,2,2,3,3,5,15,61,16,21
430,118,1758,80,100,20,104,128,82,92,10,104,128,82,92,10,0.012219612648490419,0.03550154872527996,73,93,20,1,2,2,5,9,80,31,28
431,12,628,37,100,63,14,28,34,46,12,12,28,37,52,15,0.0007488342013002485,0.029306647605432452,36,92,56,2,4,3,3,2,55,74,11
432,119,325,89,100,11,46,46,87,87,0,46,46,88,88,0,0.025494400762449368,0.02828551005820484,87,90,3,3,2,2,2,18,97,5,75
433,299,299,100,100,0,72,72,85,85,0,72,72,85,85,0,0.04663194799006093,0.04663194799006093,97,97,0,-1,2,2,3,36,60,2,69
434,42,658,58,100,42,48,48,59,59,0,48,48,63,63,0,0.007862759113652609,0.0141938119064638,63,79,16,2,3,3,3,5,75,25,72
435,88,294,74,99,25,48,48,72,72,0,48,48,74,74,0,0.015214949453691413,0.018278362095374246,79,84,5,3,3,3,3,13,60,33,28
436,491,691,99,100,1,288,288,98,98,0,288,288,98,98,0,0.04190067735457299,0.044045066203750975,97,97,0,3,2,2,9,29,54,11,29
437,24,126,46,82,36,98,98,41,41,0,24,26,46,46,0,0.002314578440382586,0.0025188059498281084,44,44,0,4,3,3,13,3,13,54,88
438,29,130,52,88,36,22,22,49,49,0,22,22,50,50,0,0.003710133088260322,0.0038462847612240037,51,52,1,5,3,3,2,4,93,22,60
439,100,100,65,65,0,100,100,75,75,0,100,100,77,77,0,0.04979747438646653,0.06120017699717485,98,99,1,3,1,1,5,18,61,30,37
440,6,212,32,93,61,8,8,32,32,0,6,12,32,36,4,0.00034037918240920387,0.0009530617107457708,34,38,4,3,4,4,2,1,68,88,49
441,100,100,73,73,0,100,100,82,82,0,100,100,82,82,0,0.06286803499097995,0.09707614282310494,100,100,0,2,1,1,5,29,88,0,2
442,100,100,76,76,0,100,100,96,96,0,100,100,96,96,0,0.0597705844310562,0.067973722727118,98,99,1,3,1,1,3,13,87,24,39
443,0,0,1,1,0,0,0,1,1,0,0,0,1,1,0,0.0,0.0,1,1,0,-1,-1,-1,17,0,20,93,85
444,100,100,59,59,0,100,100,45,45,0,100,100,59,59,0,0.035875965825930084,0.045746962115797,92,95,3,2,1,1,10,16,0,18,17
445,342,342,96,96,0,176,176,99,99,0,176,176,99,99,0,0.039994553933081455,0.039994553933081455,93,93,0,-1,2,2,5,27,80,10,99
446,277,1917,98,100,2,112,136,94,98,4,112,136,94,98,4,0.03638653459954389,0.06637394056979475,94,98,4,1,2,2,4,29,78,0,57
447,147,247,89,99,10,56,56,82,82,0,56,56,82,82,0,0.026889955410327106,0.03104258143571939,88,94,6,4,2,2,2,15,89,16,31
448,26,26,50,50,0,40,40,44,44,0,26,26,50,50,0,0.00353994349705572,0.00353994349705572,50,50,0,-1,3,3,5,6,70,73,85
449,40,142,47,83,36,108,108,58,58,0,40,42,47,48,1,0.0022465026039007454,0.002314578440382586,43,43,0,4,2,2,12,1,2,71,95
450,0,616,1,100,99,0,132,1,66,65,0,132,1,81,80,0.0,0.0370672929643623,1,97,96,2,-1,3,12,0,2,99,3
451,6,6,29,29,0,52,52,34,34,0,6,6,29,29,0,0.0005446066918547262,0.0005446066918547262,35,35,0,-1,4,4,10,1,22,49,36
452,80,696,73,100,27,56,56,93,93,0,56,56,93,93,0,0.0156914803090643,0.031076619353960312,79,95,16,2,2,2,2,6,99,77,23
453,48,149,58,88,30,58,58,69,69,0,48,49,59,59,0,0.007658531604207087,0.007692569522448007,64,64,0,5,2,2,4,4,84,64,65
454,184,184,90,90,0,254,254,92,92,0,184,184,90,90,0,0.015997821573232582,0.015997821573232582,78,78,0,-1,2,2,12,8,6,20,50
455,250,866,92,100,8,168,168,97,97,0,168,168,97,97,0,0.021546002246502605,0.026821879573845263,84,87,3,2,2,2,6,18,51,5,35
456,46,252,53,95,42,102,102,66,66,0,46,102,54,76,22,0.0036760951700194017,0.013819394805813677,50,74,24,3,2,2,8,2,39,83,14
457,100,100,70,70,0,100,100,53,53,0,100,100,70,70,0,0.05544776881445931,0.07675550563327548,100,100,0,2,1,1,9,29,31,0,7
458,142,1782,83,100,17,158,182,74,81,7,142,182,83,87,4,0.011675005956635693,0.043704687021341775,75,95,20,1,2,2,9,9,28,27,10
459,40,246,47,91,44,170,170,68,68,0,40,48,47,52,5,0.004799346471969774,0.005650294427992784,53,55,2,3,2,2,16,1,9,90,51
460,190,396,89,97,8,166,166,86,86,0,166,166,88,88,0,0.015725518227305217,0.018210286258892407,79,81,2,3,2,2,8,14,57,14,41
461,0,102,1,75,74,0,10,1,27,26,0,4,1,29,28,0.0,0.0002723033459273631,1,30,29,4,-1,5,6,0,65,40,56
462,25,231,52,96,44,22,22,48,48,0,22,22,51,51,0,0.004288777698355968,0.0051397256543789785,53,56,3,3,3,3,2,6,95,73,49
463,100,100,63,63,0,100,100,45,45,0,100,100,63,63,0,0.044759862486810305,0.044759862486810305,95,95,0,-1,1,1,11,22,19,9,86
464,16,222,41,94,53,40,40,43,43,0,16,40,41,52,11,0.002144388849177984,0.0141938119064638,47,78,31,3,3,3,5,1,49,53,18
465,188,188,85,85,0,132,132,72,72,0,132,132,79,79,0,0.012968446849790666,0.012968446849790666,71,71,0,-1,2,2,8,14,27,32,79
466,2,104,29,87,58,4,4,30,30,0,2,4,29,32,3,0.0002042275094455223,0.0002382654276864427,31,32,1,4,5,5,2,1,97,65,4
467,6,212,31,92,61,13,14,31,33,2,6,16,31,37,6,0.00017018959120460194,0.0030293747234419145,30,49,19,3,4,4,5,1,37,65,41
468,16,632,35,100,65,90,100,45,46,1,16,50,35,52,17,0.0028932230504782326,0.008237176214302734,48,64,16,2,3,3,10,2,22,94,62
469,100,100,66,66,0,100,100,45,45,0,100,100,66,66,0,0.06007692569522448,0.06719085060757685,99,100,1,2,1,1,10,40,1,3,77
470,16,222,35,87,52,64,64,40,40,0,16,35,35,46,11,0.002314578440382586,0.0053439531638245,42,55,13,3,3,3,8,2,27,94,22
471,50,256,60,93,33,54,54,55,55,0,54,54,60,60,0,0.005480104836788182,0.01317267435923619,56,73,17,3,3,3,4,5,84,47,17
472,0,206,1,92,91,0,32,1,34,33,0,28,1,46,45,0.0,0.0053099152455835805,1,55,54,3,-1,4,6,0,65,79,21
473,348,948,98,100,2,200,200,94,94,0,200,200,94,94,0,0.03318697028489737,0.04527043126042411,91,97,6,2,2,2,8,29,10,0,15
474,6,107,31,83,52,7,7,31,31,0,6,7,31,37,6,0.0006807583648184077,0.0006807583648184077,36,36,0,6,4,4,2,2,99,42,68
475,12,114,35,82,47,18,18,35,35,0,12,18,35,45,10,0.0017018959120460194,0.003267640151128357,41,48,7,4,4,4,3,2,94,52,70
476,22,638,47,100,53,28,38,42,52,10,22,38,47,54,7,0.0026889955410327104,0.025834779944858572,50,90,40,2,3,3,3,2,64,75,1
477,16,16,33,33,0,94,94,37,37,0,16,16,33,33,0,0.0007147962830593281,0.0007147962830593281,36,36,0,-1,3,3,16,2,4,42,98
478,16,222,45,93,48,28,28,46,46,0,16,28,44,50,6,0.001940161339732462,0.020354675108070392,43,84,41,3,3,3,3,1,85,53,11
479,6,6,33,33,0,24,24,40,40,0,6,6,33,33,0,0.00176997174852786,0.00176997174852786,44,44,0,-1,4,4,4,2,47,94,36
480,100,100,59,59,0,100,100,46,46,0,100,100,59,59,0,0.01872085503250621,0.0195377650702883,78,82,4,3,1,1,11,6,5,41,43
481,494,1110,99,100,1,240,240,98,98,0,240,240,98,98,0,0.04785731304673406,0.051363218625548865,97,98,1,2,2,2,9,36,29,2,73
482,100,100,74,74,0,100,100,87,87,0,100,100,87,87,0,0.07525783723067497,0.07808298444467136,100,100,0,3,1,1,4,30,47,7,73
483,0,0,1,1,0,0,0,1,1,0,0,0,1,1,0,0.0,0.0,1,1,0,-1,-1,-1,3,0,64,89,81
484,96,296,75,95,20,48,48,63,63,0,48,48,64,64,0,0.007998910786616291,0.010687906327649,66,74,8,3,3,3,3,13,82,24,22
485,77,693,57,100,43,88,88,49,49,0,77,88,57,60,3,0.006671431975220395,0.011028285510058205,59,68,9,2,3,3,8,8,27,57,47
486,6,622,30,100,70,13,50,30,44,14,6,50,30,56,26,3.4037918240920386e-05,0.008066986623098132,26,67,41,2,4,3,5,1,63,95,44
487,298,504,95,100,5,160,160,93,93,0,160,160,94,94,0,0.02900030634126417,0.034140031995643146,89,91,2,3,2,2,7,22,62,9,24
488,242,858,93,100,7,184,184,94,94,0,184,184,94,94,0,0.02467749072466728,0.026107083290785937,87,88,1,2,2,2,7,17,43,6,64
489,0,206,1,90,89,0,14,1,30,29,0,14,1,38,37,0.0,0.0024166921951053475,1,46,45,3,-1,4,5,0,80,59,35
490,0,616,1,100,99,0,56,1,41,40,0,56,1,53,52,0.0,0.017937982912965042,1,80,79,2,-1,3,6,0,51,67,37
491,376,582,98,100,2,270,270,99,99,0,270,270,99,99,0,0.03114469519044215,0.03226794649239253,89,89,0,3,2,2,10,22,36,9,51
492,47,1687,57,100,43,34,58,45,68,23,34,58,53,69,16,0.007522379931243405,0.04499812791449675,63,96,33,1,3,2,4,8,84,44,6
493,174,174,87,87,0,196,196,94,94,0,174,174,91,91,0,0.014908608189523128,0.014908608189523128,75,75,0,-1,2,2,9,8,23,17,69
494,100,202,66,91,25,72,72,49,49,0,72,72,61,61,0,0.008373327887266415,0.00891793457912114,64,67,3,4,3,3,7,13,62,24,88
495,280,280,96,96,0,160,160,94,94,0,160,160,95,95,0,0.024064808196330712,0.024064808196330712,88,88,0,-1,2,2,7,19,46,15,85
496,12,218,37,96,59,18,18,36,36,0,12,18,37,44,7,0.0009530617107457708,0.012287688484972258,39,77,38,3,4,4,3,2,75,74,37
497,0,0,1,1,0,0,0,1,1,0,0,0,1,1,0,0.0,0.0,1,1,0,-1,-1,-1,17,0,20,89,40
498,16,222,32,91,59,70,70,40,40,0,16,22,32,37,5,0.0023486163586235067,0.0029612988869600733,43,47,4,3,3,3,9,2,29,94,42
499,2,208,27,94,67,5,18,28,35,7,2,18,27,44,17,3.4037918240920386e-05,0.008679669151434699,26,68,42,3,5,4,3,1,66,95,33
500,0,102,1,81,80,0,6,1,28,27,0,4,1,30,29,0.0,0.0010211375472276116,1,37,36,4,-1,5,3,1,66,50,43
501,173,789,90,100,10,112,112,95,95,0,112,112,95,95,0,0.02644746247319514,0.031212771026923995,89,91,2,2,2,2,4,16,73,18,46
502,38,654,52,100,48,54,64,52,59,7,38,64,52,62,10,0.00176997174852786,0.030634126416828347,43,90,47,2,3,3,4,4,83,64,2
503,112,728,75,100,25,220,220,82,82,0,112,130,75,81,6,0.009122162088566664,0.01065386840940808,68,69,1,2,2,2,12,4,6,38,61
504,46,148,63,90,27,28,28,46,46,0,28,28,53,53,0,0.005650294427992784,0.007998910786616291,58,67,9,4,3,3,3,6,81,13,70
505,377,993,98,100,2,152,152,94,94,0,152,152,94,94,0,0.03832669593927635,0.05871540896558766,94,98,4,2,2,2,5,29,52,11,10
506,22,22,45,45,0,50,50,48,48,0,22,22,45,45,0,0.0016678579938050988,0.0016678579938050988,43,43,0,-1,3,3,5,2,49,52,76
507,0,0,1,1,0,0,0,1,1,0,0,0,1,1,0,0.0,0.0,1,1,0,-1,-1,-1,6,0,34,86,89
508,118,118,82,82,0,110,110,81,81,0,110,110,85,85,0,0.01330882603219987,0.01330882603219987,76,76,0,-1,2,2,6,9,32,27,86
509,16,632,36,100,64,30,40,36,41,5,16,40,36,52,16,0.003880322679464924,0.02219272269308009,52,85,33,2,4,3,5,6,61,73,7
510,0,0,1,1,0,0,0,1,1,0,0,0,1,1,0,0.0,0.0,1,1,0,-1,-1,-1,7,0,24,67,80
511,0,1640,1,100,99,0,128,1,71,70,0,128,1,82,81,0.0,0.041798563599850236,1,96,95,1,-1,2,9,0,35,66,2
512,140,140,85,85,0,128,128,90,90,0,128,128,90,90,0,0.018754892950747133,0.018754892950747133,81,81,0,-1,2,2,5,8,63,20,81
513,148,1788,88,100,12,88,112,82,95,13,88,112,82,95,13,0.022465026039007456,0.052758773273426596,85,96,11,1,2,2,4,18,72,30,34
514,252,868,95,100,5,64,64,64,64,0,64,64,67,67,0,0.03100854351747847,0.0479253888832159,90,96,6,2,3,3,4,29,77,1,15
515,40,656,58,100,42,52,52,81,81,0,40,52,67,81,14,0.0088498587426393,0.0300554818067327,68,91,23,2,2,2,3,1,81,90,7
516,548,648,99,100,1,304,304,98,98,0,304,304,98,98,0,0.04996766397767113,0.04996766397767113,97,97,0,4,2,2,10,36,12,2,4
517,0,616,1,100,99,0,22,1,48,47,0,22,1,49,48,0.0,0.013989584397018279,1,77,76,2,-1,3,2,0,93,36,31
518,88,704,63,100,37,190,190,80,80,0,88,130,63,81,18,0.007998910786616291,0.014670342761836687,64,73,9,2,2,2,11,4,33,38,48
519,104,206,82,92,10,38,38,55,55,0,38,38,58,58,0,0.011334626774226489,0.011606930120153852,73,73,0,4,3,3,3,14,76,32,88
520,84,1724,63,100,37,90,124,67,90,23,84,124,66,89,23,0.007011811157629599,0.025256135334762925,58,85,27,1,2,2,6,5,71,47,60
521,128,334,85,99,14,94,94,75,75,0,94,94,75,75,0,0.018925082541951733,0.019912182170938427,81,82,1,3,2,2,5,9,49,39,52
522,62,678,61,100,39,64,64,64,64,0,64,64,67,67,0,0.008713707069675619,0.012185574730249497,65,74,9,2,3,3,4,6,77,34,52
523,38,140,51,82,31,40,40,45,45,0,38,40,51,51,0,0.002927260968719153,0.0031314884781646754,49,49,0,4,3,3,5,6,37,70,55
524,28,28,45,45,0,88,88,41,41,0,28,28,45,45,0,0.001940161339732462,0.001940161339732462,43,43,0,-1,3,3,12,3,3,43,84
525,135,135,81,81,0,178,178,82,82,0,135,135,81,81,0,0.008713707069675619,0.008713707069675619,66,66,0,-1,2,2,10,8,1,57,93
526,606,707,100,100,0,400,400,99,99,0,400,400,99,99,0,0.052554545763981074,0.05269069743694476,99,99,0,5,2,2,13,36,13,2,55
527,0,102,1,82,81,0,6,1,28,27,0,3,1,32,31,0.0,0.0002723033459273631,1,32,31,4,-1,5,3,0,75,99,56
528,100,100,62,62,0,100,100,48,48,0,100,100,62,62,0,0.033765614894993023,0.033765614894993023,93,93,0,-1,1,1,10,17,11,6,81
529,106,106,83,83,0,64,64,68,68,0,64,64,69,69,0,0.009973110044589673,0.009973110044589673,70,70,0,-1,3,3,4,13,73,24,92
530,0,0,1,1,0,0,0,1,1,0,0,0,1,1,0,0.0,0.0,1,1,0,-1,-1,-1,3,0,81,36,69
531,405,405,98,98,0,190,190,91,91,0,190,190,91,91,0,0.036590762108989414,0.036590762108989414,96,96,0,-1,2,2,8,29,27,1,36
532,80,182,66,89,23,88,88,73,73,0,88,88,74,74,0,0.007590455767725246,0.007760645358929848,61,63,2,4,2,2,4,6,83,28,95
533,0,0,1,1,0,0,0,1,1,0,0,0,1,1,0,0.0,0.0,1,1,0,-1,-1,-1,5,0,50,59,92
534,0,206,1,96,95,0,18,1,35,34,0,18,1,44,43,0.0,0.007760645358929848,1,64,63,3,-1,4,3,0,75,80,27
535,6,212,31,92,61,14,14,36,36,0,6,14,31,42,11,0.0006467204465774873,0.005037611899656217,38,55,17,3,4,4,3,2,85,42,44
536,162,778,83,100,17,232,242,77,79,2,162,212,83,87,4,0.009939072126348753,0.015419176963136935,68,77,9,2,2,2,14,9,16,31,47
537,152,358,82,96,14,150,150,86,86,0,150,150,86,86,0,0.017869907076483203,0.019027196296674494,81,82,1,3,2,2,7,9,43,39,51
538,2,2,27,27,0,5,5,27,27,0,2,2,27,27,0,3.4037918240920386e-05,3.4037918240920386e-05,27,27,0,-1,5,5,3,2,87,58,98
539,0,0,1,1,0,0,0,1,1,0,0,0,1,1,0,0.0,0.0,1,1,0,-1,-1,-1,9,0,28,86,96
540,0,616,1,100,99,0,22,1,51,50,0,22,1,53,52,0.0,0.010279451308757957,1,68,67,2,-1,3,2,0,86,80,44
541,47,47,57,57,0,34,34,45,45,0,34,34,53,53,0,0.007522379931243405,0.007522379931243405,63,63,0,-1,3,3,4,8,84,44,96
542,190,806,88,100,12,228,228,89,89,0,190,228,88,91,3,0.015351101126655093,0.02396269444160795,78,85,7,2,2,2,11,9,38,27,33
543,100,100,62,62,0,206,206,75,75,0,100,100,62,62,0,0.009394465434494027,0.009394465434494027,65,65,0,-1,2,2,12,6,14,77,98
544,100,100,68,68,0,100,100,57,57,0,100,100,68,68,0,0.06807583648184078,0.06807583648184078,100,100,0,-1,1,1,8,36,39,2,82
545,0,616,1,100,99,0,44,1,48,47,0,44,1,53,52,0.0,0.018210286258892407,1,81,80,2,-1,3,4,0,53,76,15
546,100,100,78,78,0,100,100,88,88,0,100,100,88,88,0,0.04738078219136117,0.05408625208482249,96,98,2,2,1,1,4,8,78,44,8
547,20,20,45,45,0,40,40,43,43,0,20,20,45,45,0,0.0015657442390823377,0.0015657442390823377,43,43,0,-1,3,3,5,3,45,43,66
548,0,102,1,77,76,0,5,1,27,26,0,2,1,27,26,0.0,0.00017018959120460194,1,30,29,4,-1,5,4,0,84,87,4
549,0,616,1,99,98,0,54,1,33,32,0,16,1,33,32,0.0,0.002314578440382586,1,46,45,2,-1,3,12,0,14,99,46
550,0,616,1,100,99,0,74,1,45,44,0,74,1,64,63,0.0,0.016133973246196264,1,80,79,2,-1,3,8,0,39,36,15
551,100,100,63,63,0,100,100,45,45,0,100,100,63,63,0,0.0597705844310562,0.06024711528642908,100,100,0,3,1,1,11,40,19,3,56
552,101,717,77,100,23,88,88,71,71,0,88,88,71,71,0,0.009734844616903231,0.01841451376833793,69,81,12,2,2,2,4,8,53,44,27
553,0,102,1,78,77,0,12,1,28,27,0,2,1,26,25,0.0,0.00088498587426393,1,38,37,4,-1,5,6,1,48,69,71
554,0,1640,1,100,99,0,52,1,73,72,0,52,1,74,73,0.0,0.05105687736138058,1,97,96,1,-1,2,3,0,64,79,11
555,28,644,43,100,57,124,124,60,60,0,28,72,43,54,11,0.0025188059498281084,0.008373327887266415,47,63,16,2,3,3,14,3,16,54,48
556,22,22,40,40,0,74,74,35,35,0,22,22,40,40,0,0.001497668402600497,0.001497668402600497,40,40,0,-1,3,3,12,3,6,51,45
557,0,1640,1,100,99,0,110,1,60,59,0,110,1,75,74,0.0,0.017018959120460194,1,78,77,1,-1,2,11,0,19,79,14
558,6,108,32,80,48,22,22,33,33,0,6,8,32,35,3,0.0010892133837094523,0.0017359338302869397,39,43,4,4,4,4,5,1,45,71,42
559,160,366,85,96,11,176,176,85,85,0,160,166,87,87,0,0.01494264610776405,0.01507879778072773,78,78,0,3,2,2,8,8,42,17,4
560,133,233,87,94,7,48,48,62,62,0,48,48,64,64,0,0.01579359406378706,0.01592974573675074,80,80,0,4,3,3,3,18,64,5,88
561,152,358,89,100,11,96,96,91,91,0,96,96,91,91,0,0.022396950202525613,0.023418087749753225,85,87,2,3,2,2,3,14,76,14,61
562,0,1640,1,100,99,0,46,1,86,85,0,46,1,87,86,0.0,0.054494707103713534,1,98,97,1,-1,2,2,0,97,91,62
563,128,128,84,84,0,318,318,91,91,0,128,128,84,84,0,0.011913271384322134,0.011913271384322134,72,72,0,-1,2,2,16,5,4,25,96
564,2,104,28,75,47,12,12,30,30,0,2,6,28,31,3,0.00013615167296368154,0.0010211375472276116,30,37,7,4,5,5,6,1,44,65,51
565,22,228,49,97,48,22,22,49,49,0,22,22,50,50,0,0.0037441710065012424,0.007828721195411689,52,65,13,3,3,3,2,3,93,29,28
566,0,206,1,89,88,0,13,1,28,27,0,7,1,35,34,0.0,0.00037441710065012424,1,34,33,3,-1,4,5,0,61,96,63
567,112,112,75,75,0,242,242,80,80,0,112,112,75,75,0,0.00881582082439838,0.00881582082439838,64,64,0,-1,2,2,14,4,16,38,93
568,0,102,1,83,82,0,3,1,28,27,0,3,1,32,31,0.0,0.00013615167296368154,1,30,29,4,-1,5,2,0,90,98,56
569,90,706,63,100,37,110,110,78,78,0,90,110,69,81,12,0.008066986623098132,0.01606589740971442,64,78,14,2,2,2,6,6,51,13,31
570,12,218,36,92,56,36,36,36,36,0,12,20,36,44,8,0.0009870996289866913,0.0023486163586235067,37,46,9,3,4,4,6,2,44,74,61
571,66,272,57,94,37,66,66,49,49,0,66,66,57,57,0,0.007250076585316042,0.007760645358929848,60,62,2,3,3,3,6,6,41,34,49
572,100,100,64,64,0,100,100,44,44,0,100,100,64,64,0,0.01147077844719017,0.01929949964260186,72,80,8,2,1,1,13,2,13,56,77
573,16,632,37,100,63,50,74,38,42,4,16,74,37,56,19,0.000442492937131965,0.013581129378127233,36,75,39,2,3,3,8,1,10,49,18
574,2,103,27,82,55,4,4,27,27,0,2,3,27,29,2,3.4037918240920386e-05,0.00017018959120460194,26,30,4,5,5,5,2,1,91,95,65
575,66,682,61,100,39,32,32,58,58,0,32,32,59,59,0,0.005582218591510943,0.022567139793730217,58,89,31,2,3,3,2,6,68,28,16
576,100,100,66,66,0,100,100,49,49,0,100,100,66,66,0,0.03563770039824364,0.06603356138738554,93,100,7,2,1,1,9,18,54,5,2
577,30,646,46,100,54,90,100,46,46,0,30,88,46,59,13,0.0040845501889104465,0.012219612648490419,53,72,19,2,3,3,10,6,36,73,77
578,281,487,94,97,3,310,310,91,91,0,281,310,94,94,0,0.022635215630212056,0.023588277340957826,82,84,2,3,2,2,14,20,16,23,53
579,266,472,95,99,4,240,240,98,98,0,240,240,98,98,0,0.023894618605126112,0.028489737567650362,86,88,2,3,2,2,9,16,23,18,38
580,0,0,1,1,0,0,0,1,1,0,0,0,1,1,0,0.0,0.0,1,1,0,-1,-1,-1,3,0,55,98,50
581,106,106,84,84,0,62,62,80,80,0,62,62,80,80,0,0.018210286258892407,0.018210286258892407,82,82,0,-1,2,2,3,8,55,44,45
582,215,215,96,96,0,72,72,84,84,0,72,72,84,84,0,0.03703325504612138,0.03703325504612138,94,94,0,-1,2,2,3,29,81,0,84
583,0,616,1,100,99,0,56,1,41,40,0,56,1,53,52,0.0,0.029851254297287178,1,92,91,2,-1,3,6,0,51,85,2
584,2,2,27,27,0,14,14,28,28,0,2,2,27,27,0,6.807583648184077e-05,6.807583648184077e-05,27,27,0,-1,5,5,8,1,39,95,86
585,54,670,53,100,47,76,86,54,58,4,54,86,53,62,9,0.006535280302256714,0.020933319718166036,59,83,24,2,3,3,6,7,41,62,6
586,6,6,29,29,0,24,24,29,29,0,6,6,29,29,0,0.0002723033459273631,0.0002723033459273631,33,33,0,-1,4,4,10,1,1,55,92
587,16,222,42,93,51,22,22,42,42,0,16,22,42,45,3,0.002484768031587188,0.00616086320160659,49,58,9,3,3,3,2,3,68,46,22
588,16,16,43,43,0,34,34,44,44,0,16,16,43,43,0,0.001055175465468532,0.001055175465468532,40,40,0,-1,3,3,4,1,72,49,91
589,0,616,1,100,99,0,50,1,48,47,0,50,1,54,53,0.0,0.012968446849790666,1,76,75,2,-1,3,5,1,61,69,6
590,38,38,50,50,0,78,78,45,45,0,38,38,50,50,0,0.0021784267674189047,0.0021784267674189047,45,45,0,-1,3,3,8,3,15,54,76
591,6,108,32,81,49,10,10,32,32,0,6,9,32,37,5,0.0002382654276864427,0.000442492937131965,31,36,5,4,4,4,3,1,81,88,56
592,0,616,1,100,99,0,28,1,37,36,0,22,1,43,42,0.0,0.005548180673270023,1,55,54,2,-1,3,5,0,37,85,83
593,52,668,54,100,46,84,84,64,64,0,52,84,54,68,14,0.004663194799006093,0.008951972497362062,52,67,15,2,2,2,5,6,50,70,28
594,34,34,45,45,0,86,86,43,43,0,34,34,45,45,0,0.004935498144933456,0.004935498144933456,53,53,0,-1,3,3,10,6,12,73,85
595,0,616,1,100,99,0,52,1,44,43,0,52,1,51,50,0.0,0.008237176214302734,1,65,64,2,-1,3,6,0,59,82,31
596,6,1646,28,100,72,27,134,28,66,38,6,134,28,83,55,0.00034037918240920387,0.03168930188229688,32,90,58,1,4,2,10,1,36,65,0
597,94,94,77,77,0,32,32,69,69,0,32,32,69,69,0,0.021035433472888797,0.021035433472888797,86,86,0,-1,3,3,2,20,93,23,91
598,16,16,36,36,0,68,68,42,42,0,16,16,36,36,0,0.0023486163586235067,0.0023486163586235067,45,45,0,-1,3,3,8,1,39,53,98
599,414,1030,97,100,3,192,192,94,94,0,192,192,94,94,0,0.034684638687497875,0.03883726471289016,93,95,2,2,2,2,9,29,29,1,73
600,210,826,89,100,11,182,182,83,83,0,182,182,86,86,0,0.014023622315259198,0.022839443139657578,75,82,7,2,2,2,9,14,54,14,17
601,118,324,74,95,21,176,176,70,70,0,118,124,74,75,1,0.01415977398822288,0.016236087000919025,74,74,0,3,3,3,11,9,5,39,90
602,38,654,49,100,51,90,90,50,50,0,38,90,49,63,14,0.003199564314646516,0.017393376221110316,49,80,31,2,3,3,9,6,23,70,5
603,0,102,1,77,76,0,10,1,26,25,0,2,1,25,24,0.0,0.00013615167296368154,1,29,28,4,-1,5,8,0,30,84,60
604,100,100,78,78,0,100,100,97,97,0,100,100,97,97,0,0.08642227441369686,0.08723918445147895,99,99,0,4,1,1,3,27,96,10,51
605,0,0,1,1,0,0,0,1,1,0,0,0,1,1,0,0.0,0.0,1,1,0,-1,-1,-1,4,0,83,40,86
606,397,397,99,99,0,224,224,98,98,0,224,224,98,98,0,0.035875965825930084,0.035875965825930084,93,93,0,-1,2,2,8,29,21,11,66
607,0,616,1,100,99,0,40,1,38,37,0,31,1,49,48,0.0,0.004731270635487933,1,52,51,2,-1,3,7,0,62,93,28
608,335,1935,97,100,3,152,152,82,82,0,152,152,86,86,0,0.033221008203138294,0.07086694577759624,92,99,7,1,2,2,8,29,10,11,3
609,2,2,27,27,0,5,5,27,27,0,2,2,27,27,0,0.0,0.0,1,1,0,-1,5,5,4,1,53,68,93
610,144,760,89,100,11,48,48,70,70,0,48,48,72,72,0,0.017052997038701112,0.030361823070900983,79,93,14,2,3,3,3,18,94,5,27
611,0,101,1,76,75,0,9,1,25,24,0,1,1,25,24,0.0,0.0,1,1,0,5,-1,6,9,0,35,89,95
612,0,206,1,92,91,0,20,1,34,33,0,20,1,45,44,0.0,0.006977773239388679,1,61,60,3,-1,4,4,0,47,92,77
613,90,706,64,100,36,94,94,68,68,0,94,94,71,71,0,0.007726607440688927,0.02038871302631131,63,83,20,2,2,2,5,6,50,13,19
614,94,300,68,94,26,100,100,66,66,0,94,100,68,71,3,0.006739507811702236,0.009632730862180468,60,67,7,3,2,2,6,5,44,47,29
615,122,122,79,79,0,176,176,74,74,0,122,122,79,79,0,0.009190237925048503,0.009190237925048503,64,64,0,-1,2,2,12,8,2,44,79
616,100,100,67,67,0,100,100,54,54,0,100,100,67,67,0,0.023179822322066782,0.04595118962524252,85,97,12,1,1,1,9,6,35,26,12
617,6,108,28,77,49,31,31,31,31,0,6,8,28,32,4,0.0002042275094455223,0.00037441710065012424,29,33,4,4,4,4,10,1,36,4,55
618,12,628,37,100,63,14,34,34,55,21,12,34,37,58,21,0.0007488342013002485,0.025324211171244768,36,88,52,2,4,3,3,2,55,74,10
619,240,240,94,94,0,198,198,86,86,0,198,198,92,92,0,0.018891044623710815,0.018891044623710815,79,79,0,-1,2,2,10,18,12,5,87
620,1,207,26,94,68,2,12,26,39,13,1,12,26,41,15,3.4037918240920386e-05,0.004629156880765172,27,55,28,3,6,4,2,2,90,58,57
621,0,0,1,1,0,0,0,1,1,0,0,0,1,1,0,0.0,0.0,1,1,0,-1,-1,-1,10,0,0,97,99
622,152,768,85,100,15,120,120,79,79,0,120,120,81,81,0,0.014329963579427483,0.039279757650022125,79,93,14,2,2,2,6,13,44,33,0
623,135,341,88,99,11,38,38,46,46,0,38,38,51,51,0,0.019095272133156337,0.02573266619013581,83,89,6,3,3,3,3,16,96,18,77
624,0,0,1,1,0,0,0,1,1,0,0,0,1,1,0,0.0,0.0,1,1,0,-1,-1,-1,9,0,26,76,86
625,100,100,59,59,0,100,100,45,45,0,100,100,59,59,0,0.047789237210252224,0.054018176248340655,96,98,2,2,1,1,10,22,0,9,27
626,431,637,99,100,1,256,256,95,95,0,256,256,95,95,0,0.03437829742332959,0.03618230709009837,93,95,2,3,2,2,10,29,18,11,94
627,60,676,58,100,42,112,112,75,75,0,60,112,58,77,19,0.009462541270975866,0.015180911535450491,67,76,9,2,3,3,7,5,43,25,13
628,140,756,91,100,9,56,56,84,84,0,56,56,84,84,0,0.026243234963749616,0.04309200449300521,88,96,8,2,2,2,2,20,86,23,18
629,22,123,43,79,36,50,50,37,37,0,22,23,43,48,5,0.0005446066918547262,0.0005786446100956465,36,36,0,5,3,3,8,2,21,63,95
630,126,126,78,78,0,206,206,75,75,0,126,126,78,78,0,0.012764219340345145,0.012764219340345145,73,73,0,-1,2,2,12,8,14,17,84
631,158,758,84,100,16,164,164,69,69,0,158,164,85,85,0,0.009598692943939549,0.012696143503863304,69,74,5,2,2,2,10,9,0,31,41
632,2,208,29,93,64,8,20,30,34,4,2,20,29,47,18,6.807583648184077e-05,0.005173763572619898,27,56,29,3,5,4,4,1,73,95,44
633,16,16,38,38,0,44,44,39,39,0,16,16,38,38,0,0.0010892133837094523,0.0010892133837094523,38,38,0,-1,3,3,7,2,62,42,85
634,22,638,40,100,60,94,114,49,63,14,22,114,40,80,40,0.0020082371762143027,0.02978317846080534,44,87,43,2,3,3,9,2,31,61,3
635,46,147,62,88,26,22,22,47,47,0,22,22,52,52,0,0.005071649817897137,0.005173763572619898,58,58,0,5,3,3,2,6,89,26,95
636,18,224,40,93,53,62,66,36,38,2,18,24,40,43,3,0.0007488342013002485,0.002382654276864427,36,45,9,3,3,3,10,2,36,63,71
637,28,234,45,92,47,74,74,42,42,0,28,34,45,48,3,0.001940161339732462,0.004322815616596889,44,53,9,3,3,3,9,3,28,43,46
638,184,286,90,97,7,88,88,71,71,0,88,88,71,71,0,0.021648116001225366,0.021852343510670887,87,87,0,4,2,2,4,16,53,18,88
639,176,277,91,95,4,48,48,63,63,0,48,48,64,64,0,0.023315973995030465,0.023350011913271386,87,87,0,5,3,3,3,15,82,16,58
640,2,1642,28,100,72,12,90,30,58,28,2,90,28,65,37,0.00017018959120460194,0.03703325504612138,31,92,61,1,5,2,6,1,44,60,7
641,22,22,45,45,0,52,52,42,42,0,22,22,45,45,0,0.002144388849177984,0.002144388849177984,45,45,0,-1,3,3,7,2,62,83,87
642,22,638,45,100,55,56,66,46,53,7,22,66,45,59,14,0.0020763130126961434,0.01596378365499166,46,79,33,2,3,3,6,2,74,52,5
643,294,294,98,98,0,136,136,98,98,0,136,136,98,98,0,0.04128799482623643,0.04128799482623643,95,95,0,-1,2,2,4,27,77,10,96
644,0,206,1,93,92,0,24,1,37,36,0,24,1,50,49,0.0,0.013036522686272508,1,76,75,3,-1,4,4,1,72,69,18
645,275,1875,94,100,6,246,246,95,95,0,246,246,96,96,0,0.018857006705469893,0.05374587290241329,79,98,19,1,2,2,10,15,22,19,2
646,2,104,28,77,49,15,16,29,30,1,2,6,28,30,2,3.4037918240920386e-05,0.000442492937131965,27,35,8,4,5,5,8,1,57,95,51
647,6,622,30,100,70,15,56,31,45,14,6,56,30,57,27,0.00010211375472276115,0.01855066544130161,30,80,50,2,4,3,6,1,74,65,23
648,23,639,53,100,47,24,34,40,46,6,24,34,53,54,1,0.0038462847612240037,0.016133973246196264,53,79,26,2,4,3,4,6,78,35,14
649,63,663,62,100,38,38,38,46,46,0,38,38,51,51,0,0.006841621566424997,0.026923993328568024,58,91,33,2,3,3,3,8,96,57,9
650,6,6,33,33,0,12,12,37,37,0,6,6,33,33,0,0.0007488342013002485,0.0007488342013002485,38,38,0,-1,4,4,2,2,89,42,85
651,0,206,1,88,87,0,78,1,34,33,0,6,1,27,26,0.0,0.0016338200755641784,1,39,38,3,-1,4,17,0,20,66,53
652,0,616,1,100,99,0,50,1,49,48,0,50,1,54,53,0.0,0.019061234214915415,1,82,81,2,-1,3,5,0,70,91,16
653,0,616,1,100,99,0,66,1,39,38,0,66,1,56,55,0.0,0.015317063208414174,1,77,76,2,-1,3,9,0,29,97,6
654,100,100,79,79,0,100,100,98,98,0,100,100,98,98,0,0.09074509003029375,0.09765478743320058,99,99,0,2,1,1,2,15,68,19,26
655,94,710,68,100,32,100,100,66,66,0,94,100,68,71,3,0.006739507811702236,0.01855066544130161,60,82,22,2,2,2,6,5,44,47,19
656,80,696,60,100,40,142,142,71,71,0,80,142,60,81,21,0.010347527145239796,0.02546036284420845,68,87,19,2,2,2,8,6,15,77,6
657,82,282,72,97,25,22,22,42,42,0,22,22,46,46,0,0.01334286395044079,0.016372238673882704,76,80,4,3,3,3,2,8,68,20,28
658,6,6,29,29,0,35,35,31,31,0,6,6,29,29,0,0.0002042275094455223,0.0002042275094455223,31,31,0,-1,4,4,15,1,7,65,87
659,182,388,92,99,7,102,102,94,94,0,102,102,94,94,0,0.026243234963749616,0.027026107083290785,88,89,1,3,2,2,4,20,73,23,42
660,262,468,96,100,4,120,120,100,100,0,120,120,100,100,0,0.04615541713468804,0.05412029000306341,95,99,4,3,2,2,3,27,92,10,39
661,0,101,1,77,76,0,4,1,24,23,0,1,1,24,23,0.0,0.00010211375472276115,1,29,28,5,-1,6,4,0,79,89,60
662,209,809,92,100,8,88,88,84,84,0,88,88,84,84,0,0.02648150039143606,0.04642772048061541,89,98,9,2,2,2,4,15,67,16,11
663,154,154,88,88,0,88,88,82,82,0,88,88,82,82,0,0.024166921951053473,0.024166921951053473,86,86,0,-1,2,2,4,20,78,23,80
664,22,638,40,99,59,76,122,36,61,25,22,92,40,58,18,0.0007488342013002485,0.010790020082371761,37,69,32,2,3,3,12,2,6,63,27
665,0,0,1,1,0,0,0,1,1,0,0,0,1,1,0,0.0,0.0,1,1,0,-1,-1,-1,6,0,51,36,96
666,6,622,30,100,70,14,56,30,45,15,6,56,30,57,27,0.0002042275094455223,0.0141938119064638,32,76,44,2,4,3,6,1,74,55,15
667,141,347,85,97,12,80,80,68,68,0,80,80,72,72,0,0.022669253548452978,0.026073045372545015,85,86,1,3,3,3,5,15,88,16,47
668,6,622,29,100,71,24,58,30,38,8,6,40,29,50,21,6.807583648184077e-05,0.008066986623098132,29,62,33,2,4,3,8,1,30,95,77
669,101,717,76,100,24,164,174,77,83,6,101,174,76,89,13,0.008271214132543654,0.013104598522754349,64,75,11,2,2,2,10,8,36,57,62
670,2,2,27,27,0,6,6,27,27,0,2,2,27,27,0,6.807583648184077e-05,6.807583648184077e-05,28,28,0,-1,5,5,5,1,63,68,87
671,265,265,96,96,0,88,88,80,80,0,88,88,81,81,0,0.03420810783212499,0.03420810783212499,92,92,0,-1,2,2,4,30,77,7,92
672,6,6,32,32,0,20,20,34,34,0,6,6,32,32,0,0.00013615167296368154,0.00013615167296368154,30,30,0,-1,4,4,4,1,84,88,45
673,100,100,72,72,0,100,100,71,71,0,100,100,75,75,0,0.043704687021341775,0.0440791041219919,93,93,0,4,1,1,6,17,32,6,49
674,0,0,1,1,0,0,0,1,1,0,0,0,1,1,0,0.0,0.0,1,1,0,-1,-1,-1,6,0,74,81,89
675,12,218,36,92,56,66,66,37,37,0,12,18,36,40,4,0.002110350930937064,0.002314578440382586,43,44,1,3,4,4,11,2,19,83,49
676,0,206,1,91,90,0,20,1,33,32,0,20,1,46,45,0.0,0.008101024541339052,1,65,64,3,-1,4,4,0,84,92,32
677,100,100,70,70,0,100,100,73,73,0,100,100,74,74,0,0.024371149460498995,0.027026107083290785,86,88,2,3,1,1,6,1,71,60,83
678,16,16,36,36,0,72,72,45,45,0,16,16,36,36,0,0.002484768031587188,0.002484768031587188,45,45,0,-1,3,3,7,2,46,94,45
679,0,0,1,1,0,0,0,1,1,0,0,0,1,1,0,0.0,0.0,1,1,0,-1,-1,-1,6,0,51,97,79
680,6,622,29,100,71,24,58,31,39,8,6,58,29,60,31,0.00030634126416828345,0.009564655025698629,33,69,36,2,4,3,8,1,39,4,19
681,136,342,85,96,11,88,88,77,77,0,88,88,77,77,0,0.01504475986248681,0.01592974573675074,79,80,1,3,2,2,4,13,79,33,74
682,322,938,95,100,5,168,168,93,93,0,168,168,94,94,0,0.03352734946730658,0.037339596310289665,91,92,1,2,2,2,6,22,44,9,47
683,106,106,79,79,0,88,88,77,77,0,88,88,77,77,0,0.010041185881071514,0.010041185881071514,72,72,0,-1,2,2,4,7,79,48,97
684,86,292,60,93,33,142,142,66,66,0,86,92,60,61,1,0.009122162088566664,0.00970080669866231,69,69,0,3,3,3,12,6,3,34,42
685,126,228,77,90,13,136,136,77,77,0,126,136,78,82,4,0.011334626774226489,0.011606930120153852,72,72,0,4,2,2,7,8,24,17,65
686,6,622,30,100,70,24,56,34,43,9,6,56,30,57,27,0.0008169100377820892,0.012798257258586064,36,74,38,2,4,3,6,2,34,42,32
687,42,248,51,93,42,94,94,45,45,0,40,94,47,59,12,0.004152626025392287,0.016202049082678104,51,77,26,3,3,3,9,6,29,41,37
688,204,820,92,100,8,204,214,97,97,0,204,214,97,97,0,0.01872085503250621,0.02927260968719153,80,89,9,2,2,2,8,8,21,8,5
689,38,654,49,100,51,90,100,45,46,1,38,54,49,52,3,0.0024507301133462676,0.003812246842983083,47,50,3,2,3,3,10,3,22,54,42
690,2,208,28,96,68,4,12,29,34,5,2,12,28,42,14,0.00017018959120460194,0.007692569522448007,32,64,32,3,5,4,2,1,86,55,27
691,96,302,74,98,24,88,88,81,81,0,88,88,81,81,0,0.01606589740971442,0.018686817114265293,77,81,4,3,2,2,4,8,73,20,41
692,101,1741,74,100,26,250,274,79,83,4,101,149,74,85,11,0.007352190340038803,0.014840532353041287,61,78,17,1,2,2,16,8,4,57,64
693,42,143,59,89,30,46,46,81,81,0,42,46,81,81,0,0.012968446849790666,0.013002484768031588,77,77,0,5,2,2,2,2,90,75,65
694,0,0,1,1,0,0,0,1,1,0,0,0,1,1,0,0.0,0.0,1,1,0,-1,-1,-1,4,0,73,96,36
695,100,100,63,63,0,100,100,47,47,0,100,100,63,63,0,0.050784574015453214,0.050784574015453214,97,97,0,-1,1,1,10,29,36,11,80
696,32,32,43,43,0,124,124,57,57,0,32,32,43,43,0,0.0013615167296368155,0.0013615167296368155,39,39,0,-1,3,3,16,2,4,74,92
697,335,1975,97,100,3,152,176,82,90,8,152,176,86,92,6,0.033221008203138294,0.04482793832329215,92,96,4,1,2,2,8,29,10,11,90
698,22,638,47,100,53,18,18,47,47,0,22,18,54,49,-5,0.0020422750944552232,0.021069471391129718,43,85,42,2,3,3,2,2,99,52,9
699,12,114,35,76,41,30,30,36,36,0,12,14,35,36,1,0.0012594029749140542,0.0012594029749140542,39,39,0,4,4,4,5,2,63,74,95
700,16,16,43,43,0,44,44,48,48,0,16,16,43,43,0,0.0034718676605738795,0.0034718676605738795,51,51,0,-1,3,3,4,3,47,46,86
701,66,272,69,100,31,32,32,64,64,0,32,32,64,64,0,0.010892133837094524,0.013785356887572755,71,76,5,3,3,3,2,9,89,27,35
702,0,0,1,1,0,0,0,1,1,0,0,0,1,1,0,0.0,0.0,1,1,0,-1,-1,-1,13,0,13,82,80
703,138,239,86,92,6,102,102,92,92,0,102,102,92,92,0,0.014398039415909322,0.014500153170632085,76,76,0,5,2,2,4,13,79,24,60
704,2,1642,26,100,74,13,136,26,64,38,2,136,26,84,58,0.00010211375472276115,0.026787841655604345,30,89,59,1,5,2,12,1,3,78,23
705,34,34,58,58,0,22,22,52,52,0,22,22,55,55,0,0.006637394056979475,0.006637394056979475,61,61,0,-1,3,3,2,4,98,38,82
706,419,419,98,98,0,168,168,93,93,0,168,168,94,94,0,0.038428809693999116,0.038428809693999116,92,92,0,-1,2,2,6,29,44,1,86
707,79,285,66,95,29,78,78,73,73,0,78,78,73,73,0,0.007794683277170768,0.008475441641989176,64,64,0,3,2,2,4,6,79,28,74
708,20,20,48,48,0,18,18,48,48,0,18,18,49,49,0,0.0017359338302869397,0.0017359338302869397,42,42,0,-1,3,3,2,3,93,43,84
709,100,100,67,67,0,100,100,54,54,0,100,100,67,67,0,0.030463936825623743,0.03100854351747847,90,90,0,3,1,1,9,14,35,32,42
710,100,100,68,68,0,100,100,57,57,0,100,100,68,68,0,0.0425814357193914,0.057558119745396374,96,98,2,2,1,1,8,20,39,23,30
711,100,100,64,64,0,100,100,44,44,0,100,100,64,64,0,0.02641342455495422,0.02906838217774601,87,90,3,3,1,1,13,14,13,14,90
712,64,680,55,100,45,136,146,67,69,2,64,108,55,74,19,0.006501242384015794,0.012594029749140543,58,70,12,2,2,2,12,6,2,73,48
713,84,700,58,100,42,206,206,75,75,0,84,116,58,76,18,0.009939072126348753,0.014227849824704722,67,75,8,2,2,2,12,5,14,25,26
714,362,568,98,100,2,200,200,95,95,0,200,200,95,95,0,0.03727152047380782,0.037645937574457944,94,94,0,3,2,2,8,29,21,0,49
715,50,256,64,97,33,28,28,46,46,0,28,28,53,53,0,0.005820484019197386,0.010279451308757957,60,72,12,3,3,3,3,5,81,47,38
716,6,622,29,100,71,30,60,35,48,13,6,60,29,53,24,0.002382654276864427,0.010517716736444398,46,71,25,2,4,3,5,2,52,94,21
717,2,104,25,79,54,7,7,25,25,0,2,4,25,26,1,6.807583648184077e-05,0.00013615167296368154,25,27,2,4,5,5,4,1,67,95,68
718,22,228,47,94,47,28,28,42,42,0,22,28,47,50,3,0.0026889955410327104,0.00527587732734266,50,57,7,3,3,3,3,2,64,75,29
719,100,100,59,59,0,100,100,40,40,0,100,100,59,59,0,0.037509785901494265,0.037509785901494265,94,94,0,-1,1,1,15,22,7,9,40
720,0,0,1,1,0,0,0,1,1,0,0,0,1,1,0,0.0,0.0,1,1,0,-1,-1,-1,6,0,69,79,92
721,32,648,42,100,58,102,116,56,57,1,32,60,42,52,10,0.001157289220191293,0.003642057251778481,40,51,11,2,3,3,14,2,25,74,70
722,0,206,1,91,90,0,26,1,34,33,0,26,1,47,46,0.0,0.005684332346233704,1,56,55,3,-1,4,7,0,62,76,24
723,0,102,1,84,83,0,6,1,30,29,0,6,1,30,29,0.0,0.007522379931243405,1,66,65,4,-1,5,3,0,92,99,32
724,26,232,51,94,43,40,40,43,43,0,25,40,51,52,1,0.00353994349705572,0.008475441641989176,51,65,14,3,3,3,5,6,49,41,21
725,0,102,1,80,79,0,6,1,28,27,0,3,1,31,30,0.0,0.0005786446100956465,1,34,33,4,-1,5,3,0,87,89,74
726,86,702,63,100,37,86,86,59,59,0,86,86,63,63,0,0.005956635692161067,0.018006058749446885,55,80,25,2,3,3,6,6,41,13,37
727,0,0,1,1,0,0,0,1,1,0,0,0,1,1,0,0.0,0.0,1,1,0,-1,-1,-1,10,0,1,91,97
728,316,316,98,98,0,144,144,95,95,0,144,144,95,95,0,0.03478675244222063,0.03478675244222063,94,94,0,-1,2,2,6,27,65,10,97
729,8,108,35,75,40,28,28,33,33,0,8,8,35,35,0,0.0005446066918547262,0.0009530617107457708,34,37,3,4,4,4,6,2,65,63,49
730,242,242,94,94,0,216,216,93,93,0,216,216,94,94,0,0.02413288403281255,0.02413288403281255,86,86,0,-1,2,2,9,16,28,18,45
731,196,812,87,100,13,120,120,85,85,0,120,120,87,87,0,0.020695054290479593,0.026923993328568024,82,86,4,2,2,2,6,18,74,5,72
732,22,638,43,100,57,40,50,40,44,4,22,50,43,51,8,0.0024166921951053475,0.011334626774226489,47,73,26,2,3,3,5,2,52,83,8
733,48,664,52,100,48,148,158,64,64,0,48,64,52,53,1,0.0022465026039007454,0.003267640151128357,45,49,4,2,2,2,14,4,16,64,49
734,86,702,63,100,37,86,96,59,62,3,86,96,63,67,4,0.005956635692161067,0.027604751693386432,55,88,33,2,3,3,6,6,41,13,11
735,34,650,49,100,51,90,120,43,64,21,34,120,49,78,29,0.001599782157323258,0.0245413390517036,42,87,45,2,3,3,10,4,1,64,10
736,0,616,1,99,98,0,98,1,41,40,0,54,1,54,53,0.0,0.006671431975220395,1,60,59,2,-1,3,12,0,14,97,38
737,0,206,1,92,91,0,22,1,28,27,0,8,1,35,34,0.0,0.0002382654276864427,1,33,32,3,-1,4,11,1,19,69,63
738,64,270,58,93,35,134,134,72,72,0,64,70,58,58,0,0.007352190340038803,0.007624493685966166,62,62,0,3,3,3,9,4,31,72,60
739,0,0,1,1,0,0,0,1,1,0,0,0,1,1,0,0.0,0.0,1,1,0,-1,-1,-1,9,0,28,36,79
740,96,712,59,100,41,202,212,72,73,1,96,118,59,76,17,0.0035059055788147996,0.007284114503556962,51,62,11,2,2,2,14,6,8,70,29
741,124,330,83,94,11,114,114,64,64,0,114,114,81,81,0,0.010721944245889922,0.011300588855985567,71,73,2,3,3,3,9,14,31,32,49
742,8,214,35,94,59,32,32,37,37,0,8,14,35,38,3,0.00034037918240920387,0.0020763130126961434,34,45,11,3,4,4,6,2,32,56,94
743,102,308,74,93,19,118,118,88,88,0,102,118,83,88,5,0.01242384015793594,0.016338200755641786,73,81,8,3,2,2,5,7,61,62,26
744,114,114,78,78,0,134,134,88,88,0,114,114,84,84,0,0.013683243132849994,0.013683243132849994,75,75,0,-1,2,2,6,6,59,77,89
745,32,648,48,100,52,78,78,45,45,0,32,78,48,59,11,0.003608019333537561,0.010279451308757957,51,69,18,2,3,3,8,2,15,75,48
746,16,16,33,33,0,59,59,34,34,0,16,16,33,33,0,0.00034037918240920387,0.00034037918240920387,33,33,0,-1,3,3,15,1,7,88,85
747,22,123,53,84,31,22,22,52,52,0,22,22,54,54,0,0.0020763130126961434,0.0022465026039007454,47,47,0,5,3,3,2,2,86,52,55
748,0,616,1,100,99,0,86,1,43,42,0,81,1,55,54,0.0,0.013683243132849994,1,77,76,2,-1,3,10,0,0,66,37
749,37,139,56,87,31,28,28,44,44,0,28,28,54,54,0,0.005582218591510943,0.006739507811702236,61,62,1,4,3,3,3,6,76,35,71
750,228,844,91,100,9,192,192,86,86,0,192,192,89,89,0,0.019639878825011062,0.025256135334762925,82,88,6,2,2,2,9,17,28,6,47
751,62,1702,56,100,44,132,166,64,68,4,62,152,56,86,30,0.0042547397801150485,0.016712617856291908,55,79,24,1,3,2,12,6,14,35,13
752,6,6,30,30,0,14,14,30,30,0,6,6,30,30,0,0.00017018959120460194,0.00017018959120460194,30,30,0,-1,4,4,6,1,34,55,89
753,297,398,97,100,3,88,88,81,81,0,88,88,81,81,0,0.03628442084482113,0.03631845876306205,94,94,0,6,2,2,4,29,73,1,68
754,12,114,32,81,49,20,20,30,30,0,12,14,32,34,2,0.001157289220191293,0.0034718676605738795,36,45,9,4,4,4,4,3,67,51,90
755,0,206,1,91,90,0,28,1,33,32,0,26,1,44,43,0.0,0.0034037918240920387,1,47,46,3,-1,4,6,0,56,40,47
756,136,752,82,100,18,276,276,87,87,0,136,180,82,85,3,0.008543517478471017,0.013717281051090916,63,72,9,2,2,2,14,7,16,62,38
757,32,32,54,54,0,38,38,61,61,0,32,32,62,62,0,0.004356853534837809,0.004356853534837809,55,55,0,-1,3,3,3,3,81,29,97
758,78,284,70,98,28,22,22,42,42,0,22,22,45,45,0,0.01065386840940808,0.018006058749446885,68,83,15,3,3,3,2,14,91,14,77
759,392,598,100,100,0,120,120,100,100,0,120,120,100,100,0,0.0567752476258552,0.059804622349297114,99,99,0,3,2,2,3,36,58,2,90
760,40,246,58,97,39,28,28,46,46,0,28,28,53,53,0,0.0057524081827155455,0.021035433472888797,59,85,26,3,3,3,3,6,81,26,9
761,324,940,96,100,4,368,368,97,97,0,324,368,97,97,0,0.024166921951053473,0.029340685523673374,87,90,3,2,2,2,14,16,16,18,34
762,6,212,29,93,64,14,18,32,35,3,6,18,29,44,15,0.000442492937131965,0.008509479560230097,34,67,33,3,4,4,3,1,82,49,39
763,100,100,73,73,0,100,100,94,94,0,100,100,94,94,0,0.0475850097008067,0.0475850097008067,98,98,0,-1,1,1,4,9,67,27,92
764,22,22,48,48,0,38,38,57,57,0,22,22,48,48,0,0.0045270431260424114,0.0045270431260424114,54,54,0,-1,3,3,3,3,85,29,79
765,291,497,98,100,2,72,72,79,79,0,72,72,80,80,0,0.03808843051158991,0.047993464719697745,95,95,0,3,2,2,3,29,75,1,6
766,0,616,1,100,99,0,20,1,41,40,0,20,1,45,44,0.0,0.012015385139044895,1,75,74,2,-1,3,3,0,55,92,5
767,192,398,89,100,11,104,104,85,85,0,104,104,85,85,0,0.023384049831512304,0.026651689982640663,84,85,1,3,2,2,5,19,70,15,29
768,156,362,85,98,13,176,176,85,85,0,156,176,88,88,0,0.012900371013308825,0.016270124919159943,76,78,2,3,2,2,8,9,30,27,35
769,100,100,59,59,0,100,100,40,40,0,100,100,59,59,0,0.012185574730249497,0.012185574730249497,68,68,0,-1,1,1,15,1,7,53,67
770,1,207,26,92,66,4,24,26,36,10,1,24,26,53,27,6.807583648184077e-05,0.00707988699411144,29,61,32,3,6,4,4,1,77,68,17
771,2,618,27,100,73,12,46,29,42,13,2,46,27,51,24,0.00034037918240920387,0.017121072875182955,31,80,49,2,5,3,6,1,65,88,9
772,22,228,40,93,53,76,76,36,36,0,22,35,40,47,7,0.0007488342013002485,0.0018380475850097008,37,44,7,3,3,3,12,2,6,63,64
773,0,616,1,100,99,0,38,1,38,37,0,28,1,51,50,0.0,0.004629156880765172,1,55,54,2,-1,3,6,0,44,96,26
774,0,206,1,93,92,0,22,1,32,31,0,13,1,39,38,0.0,0.002382654276864427,1,48,47,3,-1,4,5,0,45,99,70
775,6,1646,29,100,71,18,64,33,53,20,6,64,29,59,30,0.00034037918240920387,0.02580074202661765,34,87,53,1,4,2,5,1,61,49,20
776,16,222,48,97,49,18,18,51,51,0,16,18,51,53,2,0.0011913271384322134,0.004833384390210695,39,57,18,3,3,3,2,2,98,42,47
777,22,124,43,77,34,62,62,43,43,0,22,24,43,46,3,0.0019061234214915416,0.001940161339732462,43,43,0,4,3,3,7,2,43,52,65
778,0,206,1,93,92,0,18,1,39,38,0,18,1,44,43,0.0,0.008713707069675619,1,67,66,3,-1,4,3,0,92,87,33
779,58,264,64,97,33,48,48,64,64,0,48,48,66,66,0,0.010892133837094524,0.013751318969331836,68,76,8,3,3,3,3,6,85,34,29
780,0,0,1,1,0,0,0,1,1,0,0,0,1,1,0,0.0,0.0,1,1,0,-1,-1,-1,5,0,88,99,85
781,6,212,34,97,63,12,12,39,39,0,6,12,34,43,9,0.0020422750944552232,0.008543517478471017,45,67,22,3,4,4,2,2,97,94,48
782,22,1662,43,100,57,54,102,39,65,26,22,102,43,75,32,0.0021784267674189047,0.03012355764321454,46,91,45,1,3,2,8,2,21,83,15
783,66,66,53,53,0,190,190,69,69,0,64,64,53,53,0,0.004016474352428605,0.004016474352428605,51,51,0,-1,2,2,16,6,4,41,98
784,39,655,51,100,49,38,38,46,46,0,38,38,51,51,0,0.00439089145307873,0.017495489975833077,51,81,30,2,3,3,3,4,96,22,19
785,102,718,71,100,29,124,134,85,87,2,102,134,74,88,14,0.00970080669866231,0.023281936076789543,67,86,19,2,2,2,6,7,40,62,5
786,58,159,52,86,34,96,96,53,53,0,58,59,52,53,1,0.003914360597705844,0.004050512270669526,50,50,0,5,2,2,7,3,46,54,55
787,6,622,29,100,71,26,44,34,35,1,6,26,29,46,17,0.00030634126416828345,0.0035059055788147996,33,48,15,2,4,3,7,1,43,88,70
788,1,617,25,100,75,4,44,25,48,23,1,44,25,54,29,6.807583648184077e-05,0.026923993328568024,28,88,60,2,6,3,4,1,79,68,3
789,58,674,59,100,41,52,62,76,79,3,52,62,77,79,2,0.008271214132543654,0.019878144252697506,63,85,22,2,2,2,3,4,55,38,44
790,74,74,62,62,0,138,138,75,75,0,74,74,62,62,0,0.00616086320160659,0.00616086320160659,60,60,0,-1,2,2,9,6,31,26,76
791,16,117,41,80,39,40,40,44,44,0,16,17,41,47,6,0.0012253650566731338,0.0012594029749140542,41,41,0,6,3,3,5,1,70,71,58
792,102,718,83,100,17,32,32,58,58,0,32,32,59,59,0,0.017495489975833077,0.02651553830967698,83,89,6,2,3,3,2,17,68,6,21
793,16,16,32,32,0,88,88,37,37,0,16,16,32,32,0,0.0008509479560230097,0.0008509479560230097,37,37,0,-1,3,3,14,2,8,42,98
794,58,58,59,59,0,52,52,76,76,0,52,52,77,77,0,0.008271214132543654,0.008271214132543654,63,63,0,-1,2,2,3,4,55,38,79
795,2,104,29,77,48,9,9,29,29,0,2,4,29,32,3,6.807583648184077e-05,0.0004765308553728854,28,35,7,4,5,5,5,1,49,95,42
796,122,122,76,76,0,104,104,73,73,0,104,104,79,79,0,0.012151536812008578,0.012151536812008578,75,75,0,-1,2,2,5,9,52,27,98
797,97,303,74,97,23,72,72,80,80,0,72,72,80,80,0,0.010007147962830594,0.01589570781850982,69,79,10,3,2,2,3,8,87,57,48
798,6,212,30,94,64,22,30,33,35,2,6,30,30,50,20,0.0002723033459273631,0.013036522686272508,31,73,42,3,4,4,5,1,63,4,15
799,172,378,84,95,11,204,204,79,79,0,172,180,84,85,1,0.011743081793117532,0.012730181422104225,72,72,0,3,2,2,11,9,5,31,61
800,100,100,67,67,0,100,100,55,55,0,100,100,67,67,0,0.01960584090677014,0.0228734810578985,82,85,3,2,1,1,9,2,23,94,29
801,0,101,1,75,74,0,10,1,25,24,0,1,1,25,24,0.0,0.0,1,1,0,5,-1,6,10,1,12,45,58
802,100,716,80,100,20,32,32,64,64,0,32,32,64,64,0,0.017087034956942034,0.02750263793866367,80,90,10,2,3,3,2,18,89,30,48
803,0,616,1,100,99,0,70,1,41,40,0,58,1,55,54,0.0,0.009156200006807584,1,68,67,2,-1,3,9,0,31,93,17
804,0,0,1,1,0,0,0,1,1,0,0,0,1,1,0,0.0,0.0,1,1,0,-1,-1,-1,2,0,68,98,76
805,100,100,65,65,0,100,100,47,47,0,100,100,65,65,0,0.035603662480002726,0.038530923448721874,94,94,0,3,1,1,11,19,38,15,90
806,76,76,61,61,0,104,104,66,66,0,76,76,61,61,0,0.00616086320160659,0.00616086320160659,56,56,0,-1,3,3,9,6,26,13,85
807,111,727,77,100,23,132,132,70,70,0,111,132,77,78,1,0.00796487286837537,0.009564655025698629,62,67,5,2,2,2,8,8,42,57,43
808,18,224,48,93,45,38,38,55,55,0,18,38,47,57,10,0.0017359338302869397,0.00976888253514415,41,69,28,3,3,3,3,2,76,61,20
809,0,616,1,100,99,0,40,1,47,46,0,40,1,56,55,0.0,0.011402702610708328,1,75,74,2,-1,3,4,0,47,66,8
810,0,616,1,100,99,0,38,1,36,35,0,38,1,47,46,0.0,0.008441403723748256,1,63,62,2,-1,3,6,0,71,66,31
811,0,1640,1,100,99,0,66,1,48,47,0,66,1,56,55,0.0,0.024949794070594642,1,86,85,1,-1,2,6,0,41,80,32
812,174,774,83,100,17,142,142,78,78,0,142,142,82,82,0,0.018822968787228972,0.023724429013921508,78,85,7,2,2,2,8,15,27,19,38
813,362,978,95,100,5,224,224,99,99,0,224,224,99,99,0,0.03104258143571939,0.039824364341876854,90,97,7,2,2,2,8,22,27,9,17
814,56,672,52,100,48,66,66,50,50,0,56,72,52,65,13,0.005241839409101739,0.009905034208107831,51,68,17,2,3,3,6,6,56,28,90
815,88,88,67,67,0,132,132,79,79,0,88,88,67,67,0,0.00878178290615746,0.00878178290615746,67,67,0,-1,2,2,8,7,39,62,67
816,344,445,96,97,1,352,352,96,96,0,352,352,96,96,0,0.02644746247319514,0.02648150039143606,88,88,0,5,2,2,13,15,13,16,68
817,25,641,53,100,47,18,22,48,48,0,18,22,51,52,1,0.004356853534837809,0.015521290717859695,55,80,25,2,3,3,2,6,90,73,17
818,9,9,38,38,0,18,18,38,38,0,9,9,38,38,0,0.0013274788113958951,0.0013274788113958951,40,40,0,-1,4,4,3,4,81,64,82
819,28,644,46,100,54,96,96,44,44,0,28,72,46,59,13,0.002110350930937064,0.010211375472276116,44,67,23,2,3,3,11,3,38,54,20
820,193,193,92,92,0,112,112,94,94,0,112,112,94,94,0,0.026855917492086184,0.026855917492086184,88,88,0,-1,2,2,4,17,78,6,81
821,343,343,100,100,0,134,134,90,90,0,134,134,90,90,0,0.03567173831648456,0.03567173831648456,96,96,0,-1,2,2,6,30,56,7,87
822,86,686,81,100,19,32,32,67,67,0,32,32,68,68,0,0.017359338302869398,0.04836788182034787,81,97,16,2,3,3,2,18,97,30,2
823,16,222,36,93,57,36,40,38,39,1,16,40,36,49,13,0.0007147962830593281,0.007420266176520644,36,58,22,3,3,3,5,2,52,42,24
824,199,199,89,89,0,144,144,91,91,0,144,144,91,91,0,0.026379386636713298,0.026379386636713298,86,86,0,-1,2,2,6,20,74,23,82
825,0,616,1,100,99,0,90,1,38,37,0,84,1,56,55,0.0,0.014261887742945642,1,72,71,2,-1,3,14,0,8,76,30
826,0,102,1,80,79,0,6,1,28,27,0,2,1,26,25,0.0,0.001497668402600497,1,42,41,4,-1,5,3,0,87,81,94
827,128,334,78,96,18,182,182,82,82,0,128,140,79,82,3,0.008203138296061813,0.009632730862180468,63,67,4,3,2,2,9,5,28,47,51
828,0,616,1,100,99,0,110,1,58,57,0,110,1,77,76,0.0,0.023111746485584943,1,86,85,2,-1,3,10,1,36,50,10
829,0,1640,1,100,99,0,46,1,86,85,0,46,1,87,86,0.0,0.06422955172061677,1,98,97,1,-1,2,2,0,97,82,37
830,38,244,46,93,47,100,100,45,45,0,38,44,46,49,3,0.0012594029749140542,0.0017018959120460194,39,41,2,3,3,3,10,4,0,64,49
831,0,206,1,88,87,0,28,1,34,33,0,28,1,45,44,0.0,0.005548180673270023,1,54,53,3,-1,4,6,0,41,92,44
832,16,16,38,38,0,50,50,50,50,0,16,16,38,38,0,0.0016678579938050988,0.0016678579938050988,44,44,0,-1,3,3,5,1,37,53,97
833,7,7,36,36,0,16,16,34,34,0,7,7,36,36,0,0.00030634126416828345,0.00030634126416828345,33,33,0,-1,4,4,4,2,77,56,98
834,24,230,50,93,43,44,44,50,50,0,24,30,50,50,0,0.002757071377514551,0.004356853534837809,49,52,3,3,3,3,4,3,73,54,94
835,106,106,79,79,0,88,88,77,77,0,88,88,77,77,0,0.010041185881071514,0.010041185881071514,72,72,0,-1,2,2,4,7,79,48,97
836,56,157,55,86,31,94,94,70,70,0,56,57,54,56,2,0.006331052792811192,0.006331052792811192,59,59,0,5,2,2,5,3,37,29,68
837,190,806,89,100,11,192,192,86,86,0,192,192,89,89,0,0.0156914803090643,0.022328874366043774,78,84,6,2,2,2,9,13,28,33,62
838,0,206,1,92,91,0,22,1,33,32,0,22,1,44,43,0.0,0.009156200006807584,1,69,68,3,-1,4,5,1,88,50,39
839,0,101,1,76,75,0,3,1,25,24,0,1,1,25,24,0.0,0.0,1,1,0,6,-1,7,3,0,64,40,58
840,76,76,63,63,0,70,70,58,58,0,70,70,64,64,0,0.008305252050784574,0.008305252050784574,67,67,0,-1,3,3,5,7,63,21,59
841,32,648,47,100,53,96,106,43,57,14,32,64,47,55,8,0.0030974505599237552,0.007624493685966166,50,61,11,2,3,3,11,2,19,75,26
842,16,117,42,85,43,24,24,42,42,0,16,17,42,44,2,0.0007147962830593281,0.0008169100377820892,37,38,1,5,3,3,3,1,75,88,60
843,98,98,60,60,0,222,222,74,74,0,98,98,60,60,0,0.006126825283365669,0.006126825283365669,58,58,0,-1,2,2,14,4,8,22,69
844,122,738,76,100,24,104,104,73,73,0,104,104,79,79,0,0.012151536812008578,0.04132203274447735,75,94,19,2,2,2,5,9,52,27,3
845,46,252,48,90,42,130,134,59,59,0,46,54,48,50,2,0.0016338200755641784,0.0020082371762143027,40,42,2,3,2,2,17,3,20,51,63
846,46,46,57,57,0,62,62,74,74,0,46,46,63,63,0,0.0051397256543789785,0.0051397256543789785,57,57,0,-1,2,2,3,2,64,52,89
847,100,100,64,64,0,100,100,57,57,0,100,100,65,65,0,0.04435140746791926,0.04435140746791926,97,97,0,-1,1,1,8,20,10,23,84
848,0,616,1,100,99,0,58,1,33,32,0,26,1,42,41,0.0,0.004220701861874128,1,53,52,2,-1,3,14,1,17,45,73
849,76,177,74,91,17,38,38,59,59,0,38,38,62,62,0,0.00789679703189353,0.00789679703189353,68,68,0,6,3,3,3,13,92,24,78
850,16,16,35,35,0,34,34,39,39,0,16,16,35,35,0,0.002144388849177984,0.002144388849177984,40,40,0,-1,3,3,4,1,67,53,59
851,2,2,27,27,0,7,7,27,27,0,2,2,27,27,0,0.00010211375472276115,0.00010211375472276115,29,29,0,-1,5,5,6,1,41,68,93
852,42,1682,52,100,48,132,196,64,71,7,40,196,49,87,38,0.0033357159876101976,0.03458252493277511,51,93,42,1,3,2,12,6,14,41,1
853,118,734,77,100,23,280,280,81,81,0,118,192,77,87,10,0.00616086320160659,0.018108172504169646,56,81,25,2,2,2,17,6,20,28,39
854,0,616,1,100,99,0,18,1,50,49,0,18,1,53,52,0.0,0.008645631233193778,1,66,65,2,-1,3,2,0,98,82,57
855,0,101,1,77,76,0,5,1,24,23,0,1,1,24,23,0.0,0.0,1,1,0,5,-1,6,5,0,50,84,58
856,100,100,64,64,0,100,100,59,59,0,100,100,64,64,0,0.04190067735457299,0.05429047959426801,96,98,2,2,1,1,6,13,40,33,5
857,149,149,84,84,0,190,190,80,80,0,149,149,84,84,0,0.016338200755641786,0.016338200755641786,75,75,0,-1,2,2,11,12,33,37,66
858,49,255,62,99,37,18,22,47,53,6,18,22,49,53,4,0.004969536063174376,0.010721944245889922,54,69,15,3,3,3,2,4,99,22,25
859,16,632,39,100,61,38,38,51,51,0,16,38,39,53,14,0.0024507301133462676,0.021920419347152727,48,86,38,2,3,3,3,1,82,53,9
860,100,100,61,61,0,100,100,44,44,0,100,100,61,61,0,0.034140031995643146,0.03631845876306205,91,92,1,3,1,1,12,16,6,12,41
861,0,0,1,1,0,0,0,1,1,0,0,0,1,1,0,0.0,0.0,1,1,0,-1,-1,-1,2,0,90,98,59
862,142,348,83,99,16,110,110,81,81,0,110,110,82,82,0,0.0123557643214541,0.0230436706491031,73,85,12,3,2,2,6,9,65,27,6
863,325,531,95,100,5,120,120,78,78,0,120,120,78,78,0,0.03264236359304265,0.03298274277545185,91,91,0,3,2,2,6,29,41,11,49
864,96,712,65,100,35,124,124,75,75,0,96,124,65,83,18,0.006297014874570271,0.013104598522754349,60,71,11,2,3,3,9,6,23,13,62
865,54,260,62,94,32,48,48,63,63,0,48,48,64,64,0,0.006875659484665918,0.008441403723748256,62,66,4,3,3,3,3,7,82,62,53
866,0,101,1,79,78,0,4,1,25,24,0,1,1,25,24,0.0,6.807583648184077e-05,1,26,25,6,-1,7,4,1,73,50,78
867,54,54,58,58,0,98,98,52,52,0,54,54,58,58,0,0.006773545729943157,0.006773545729943157,64,64,0,-1,3,3,8,4,39,38,59
868,0,102,1,82,81,0,3,1,26,25,0,2,1,26,25,0.0,0.0002042275094455223,1,30,29,4,-1,5,2,1,91,45,78
869,106,706,79,100,21,78,78,73,73,0,78,78,73,73,0,0.014534191088873005,0.030566050580346504,77,90,13,2,2,2,4,8,79,20,16
870,2,618,27,100,73,14,74,28,45,17,2,74,27,64,37,6.807583648184077e-05,0.014840532353041287,27,78,51,2,5,3,8,1,39,95,30
871,0,0,1,1,0,0,0,1,1,0,0,0,1,1,0,0.0,0.0,1,1,0,-1,-1,-1,8,0,42,92,36
872,136,136,84,84,0,104,104,82,82,0,104,104,82,82,0,0.015180911535450491,0.015180911535450491,78,78,0,-1,2,2,5,8,80,17,50
873,6,622,29,100,71,32,50,34,37,3,6,22,29,40,11,0.0007488342013002485,0.0037441710065012424,38,52,14,2,4,3,8,2,10,42,94
874,404,1020,99,100,1,128,128,92,92,0,128,128,92,92,0,0.04418121787671466,0.05565199632390483,97,97,0,2,2,2,5,40,50,3,30
875,240,446,97,100,3,96,96,92,92,0,96,96,92,92,0,0.03669287586371218,0.039279757650022125,95,95,0,3,2,2,3,22,96,9,94
876,0,102,1,73,72,0,6,1,25,24,0,2,1,25,24,0.0,3.4037918240920386e-05,1,26,25,4,-1,5,5,0,61,76,95
877,54,260,62,94,32,48,48,63,63,0,48,48,64,64,0,0.00704584907587052,0.013002484768031588,64,77,13,3,3,3,3,4,82,72,34
878,170,376,87,96,9,150,150,86,86,0,150,150,86,86,0,0.01592974573675074,0.01943565131556554,78,82,4,3,2,2,7,13,43,33,26
879,405,611,98,100,2,160,160,86,86,0,160,160,88,88,0,0.03400388032267947,0.03478675244222063,93,93,0,3,2,2,7,29,24,1,74
880,126,742,82,100,18,108,118,69,74,5,108,118,77,80,3,0.008543517478471017,0.020014295925661188,66,83,17,2,3,3,8,13,39,24,5
881,2,618,28,100,72,3,22,28,41,13,2,22,28,45,17,0.0002723033459273631,0.014670342761836687,31,78,47,2,5,3,2,1,68,65,30
882,42,248,55,94,39,82,82,48,48,0,40,48,52,55,3,0.003642057251778481,0.004765308553728854,51,56,5,3,3,3,7,6,24,41,61
883,24,24,46,46,0,52,52,40,40,0,24,24,46,46,0,0.0010211375472276116,0.0010211375472276116,39,39,0,-1,3,3,7,4,24,64,84
884,22,638,39,100,61,82,114,35,55,20,22,114,39,76,37,0.001055175465468532,0.012525953912658701,38,72,34,2,3,3,14,3,8,51,5
885,0,206,1,93,92,0,13,1,29,28,0,8,1,35,34,0.0,0.0006467204465774873,1,35,34,3,-1,4,6,0,34,40,63
886,100,100,66,66,0,100,100,52,52,0,100,100,66,66,0,0.040505122706695255,0.043568535348378096,94,95,1,2,1,1,8,16,15,18,22
887,0,101,1,79,78,0,3,1,25,24,0,1,1,25,24,0.0,0.0,1,1,0,5,-1,6,3,0,94,96,95
888,358,358,95,95,0,200,200,94,94,0,200,200,94,94,0,0.0352292453793526,0.0352292453793526,91,91,0,-1,2,2,8,29,57,0,79
889,370,576,97,100,3,88,88,73,73,0,88,88,74,74,0,0.04094761564382722,0.05320126621055856,94,97,3,3,2,2,4,40,83,3,23
890,100,100,70,70,0,100,100,53,53,0,100,100,70,70,0,0.03985840226011777,0.04853807141155247,94,97,3,2,1,1,9,15,31,16,17
891,16,117,41,81,40,48,48,62,62,0,16,17,41,46,5,0.0031314884781646754,0.003165526396405596,51,51,0,5,3,3,3,3,64,46,68
892,34,34,46,46,0,44,44,44,44,0,34,34,46,46,0,0.0033357159876101976,0.0033357159876101976,45,45,0,-1,3,3,4,3,67,54,79
893,18,634,41,100,59,46,66,43,50,7,18,66,41,60,19,0.0014295925661186562,0.02324789815854862,42,85,43,2,3,3,6,2,65,61,10
894,100,100,63,63,0,100,100,56,56,0,100,100,63,63,0,0.056673133871132444,0.056673133871132444,99,99,0,-1,1,1,7,29,24,0,79
895,6,212,29,92,63,23,40,29,32,3,6,24,29,42,13,0.00010211375472276115,0.005412029000306341,31,52,21,3,4,4,10,1,0,60,73
896,42,658,56,100,44,22,22,48,48,0,22,22,51,51,0,0.007216038667075122,0.0247115286429082,61,87,26,2,3,3,2,6,95,34,12
897,0,206,1,97,96,0,7,1,33,32,0,7,1,40,39,0.0,0.0025188059498281084,1,48,47,3,-1,4,2,0,97,79,75
898,396,996,98,100,2,192,192,99,99,0,192,192,99,99,0,0.04571292419755608,0.06351475543755744,95,98,3,2,2,2,6,30,32,7,9
899,72,72,71,71,0,56,56,88,88,0,56,56,88,88,0,0.018006058749446885,0.018006058749446885,82,82,0,-1,2,2,2,6,93,34,76
900,40,246,59,98,39,22,22,49,49,0,22,22,50,50,0,0.004969536063174376,0.011096361346540046,55,71,16,3,3,3,2,5,93,47,32
901,324,924,96,100,4,368,368,97,97,0,324,368,97,97,0,0.024166921951053473,0.027706865448109193,87,89,2,2,2,2,14,16,16,18,47
902,6,622,29,100,71,31,72,32,41,9,6,38,29,45,16,0.0002042275094455223,0.0040845501889104465,32,52,20,2,4,3,10,1,0,55,29
903,16,632,36,100,64,52,72,39,45,6,16,72,36,58,22,0.001055175465468532,0.016712617856291908,38,81,43,2,3,3,7,1,43,71,16
904,0,0,1,1,0,0,0,1,1,0,0,0,1,1,0,0.0,0.0,1,1,0,-1,-1,-1,4,0,77,99,91
905,420,1036,100,100,0,280,280,100,100,0,280,280,100,100,0,0.036624800027230335,0.050954763606657814,93,98,5,2,2,2,10,27,36,10,16
906,22,228,50,97,47,28,28,46,46,0,22,28,50,52,2,0.002586881786309949,0.005377991082065421,47,58,11,3,3,3,3,2,81,83,35
907,0,102,1,82,81,0,6,1,28,27,0,2,1,26,25,0.0,0.0007828721195411688,1,38,37,4,-1,5,3,0,85,89,71
908,0,616,1,100,99,0,34,1,54,53,0,34,1,56,55,0.0,0.010415602981721638,1,72,71,2,-1,3,3,0,76,84,38
909,0,206,1,91,90,0,32,1,34,33,0,26,1,44,43,0.0,0.004186663943633207,1,49,48,3,-1,4,6,0,56,76,26
910,0,206,1,93,92,0,14,1,33,32,0,14,1,40,39,0.0,0.005922597773920147,1,56,55,3,-1,4,3,1,60,50,24
911,106,1746,74,100,26,184,208,82,87,5,106,208,74,88,14,0.009598692943939549,0.03495694203342523,66,94,28,1,2,2,10,7,22,48,18
912,34,240,55,94,39,48,48,66,66,0,34,48,57,66,9,0.003948398515946765,0.008407365805507334,54,67,13,3,3,3,3,6,76,70,13
913,22,22,42,42,0,60,60,35,35,0,22,22,42,42,0,0.0004765308553728854,0.0004765308553728854,36,36,0,-1,3,3,11,2,19,63,67
914,160,776,84,100,16,242,242,83,83,0,160,242,84,90,6,0.014806494434800367,0.023622315259198747,72,86,14,2,2,2,14,8,25,20,39
915,100,100,63,63,0,100,100,56,56,0,100,100,63,63,0,0.02811532046700024,0.028149358385241158,89,89,0,5,1,1,7,6,24,35,78
916,125,331,82,97,15,84,84,74,74,0,84,84,75,75,0,0.017869907076483203,0.024200959869294394,81,87,6,3,2,2,5,12,45,37,27
917,82,698,76,100,24,46,56,83,92,9,46,56,83,92,9,0.013104598522754349,0.027026107083290785,73,90,17,2,2,2,2,7,99,48,51
918,82,282,61,94,33,66,66,47,47,0,66,66,55,55,0,0.008373327887266415,0.013376901868681712,63,73,10,3,3,3,6,7,71,48,25
919,0,0,1,1,0,0,0,1,1,0,0,0,1,1,0,0.0,0.0,1,1,0,-1,-1,-1,3,0,55,86,81
920,0,616,1,100,99,0,38,1,50,49,0,38,1,53,52,0.0,0.018074134585928724,1,83,82,2,-1,3,3,0,82,96,5
921,80,80,58,58,0,200,200,81,81,0,80,80,58,58,0,0.010211375472276116,0.010211375472276116,66,66,0,-1,2,2,11,5,19,25,59
922,0,206,1,92,91,0,42,1,34,33,0,42,1,53,52,0.0,0.005548180673270023,1,54,53,3,-1,4,9,0,35,66,24
923,16,1656,34,100,66,112,146,59,66,7,16,86,34,59,25,0.0037441710065012424,0.019197385887879097,52,78,26,1,3,2,12,1,3,90,77
924,0,0,1,1,0,0,0,1,1,0,0,0,1,1,0,0.0,0.0,1,1,0,-1,-1,-1,2,0,86,40,45
925,379,585,100,100,0,128,128,95,95,0,128,128,95,95,0,0.048504033493311546,0.050614384424248614,97,97,0,3,2,2,5,36,45,2,41
926,0,0,1,1,0,0,0,1,1,0,0,0,1,1,0,0.0,0.0,1,1,0,-1,-1,-1,3,0,81,86,85
927,16,16,36,36,0,56,56,37,37,0,16,16,36,36,0,0.0002723033459273631,0.0002723033459273631,35,35,0,-1,3,3,9,1,28,49,67
928,112,112,78,78,0,94,94,68,68,0,94,94,73,73,0,0.011913271384322134,0.011913271384322134,72,72,0,-1,2,2,5,9,61,27,69
929,125,331,76,95,19,204,204,79,79,0,125,132,76,77,1,0.00891793457912114,0.00970080669866231,61,62,1,3,2,2,11,8,5,57,51
930,77,77,64,64,0,44,44,49,49,0,44,44,54,54,0,0.007182000748834201,0.007182000748834201,61,61,0,-1,3,3,4,8,53,57,96
931,0,102,1,83,82,0,3,1,28,27,0,3,1,32,31,0.0,0.0006807583648184077,1,37,36,4,-1,5,2,0,90,36,74
932,6,6,30,30,0,32,32,31,31,0,6,6,30,30,0,0.00017018959120460194,0.00017018959120460194,30,30,0,-1,4,4,11,1,38,65,92
933,0,0,1,1,0,0,0,1,1,0,0,0,1,1,0,0.0,0.0,1,1,0,-1,-1,-1,7,0,62,97,69
934,6,1646,30,100,70,15,72,30,51,21,6,70,30,60,30,0.00013615167296368154,0.028149358385241158,29,90,61,1,4,2,6,1,65,60,41
935,121,223,82,92,10,230,230,75,75,0,121,123,82,82,0,0.008543517478471017,0.008747744987916539,64,64,0,4,2,2,16,8,4,44,88
936,22,1662,43,100,57,80,138,44,70,26,22,138,43,80,37,0.0028932230504782326,0.04060723646141802,49,96,47,1,3,2,9,2,54,75,3
937,2,208,26,93,67,5,18,28,35,7,2,18,26,44,18,0.0002723033459273631,0.0038462847612240037,33,51,18,3,5,4,3,1,82,55,28
938,0,616,1,100,99,0,36,1,41,40,0,36,1,51,50,0.0,0.010721944245889922,1,72,71,2,-1,3,5,0,45,82,17
939,123,739,85,100,15,62,62,77,77,0,62,62,78,78,0,0.01579359406378706,0.023281936076789543,78,86,8,2,2,2,3,14,58,32,26
940,174,790,87,100,13,196,196,94,94,0,174,196,91,94,3,0.014908608189523128,0.026175159127267776,75,87,12,2,2,2,9,8,23,17,27
941,449,655,98,100,2,320,320,98,98,0,320,320,98,98,0,0.035569624561761805,0.046223492971169886,92,95,3,3,2,2,11,29,33,11,18
942,100,100,61,61,0,100,100,40,40,0,100,100,61,61,0,0.03652268627250757,0.03652268627250757,94,94,0,-1,1,1,14,19,8,15,80
943,80,182,74,93,19,48,48,59,59,0,48,48,63,63,0,0.008475441641989176,0.008577555396711936,67,67,0,4,3,3,3,9,75,31,4
944,22,228,41,93,52,44,48,36,38,2,22,28,41,46,5,0.0004084550188910446,0.002484768031587188,34,44,10,3,3,3,9,2,23,63,46
945,16,222,33,90,57,42,42,36,36,0,16,31,33,40,7,0.0032336022328874367,0.006331052792811192,45,55,10,3,3,3,6,3,51,46,22
946,6,6,28,28,0,43,43,30,30,0,6,6,28,28,0,0.00017018959120460194,0.00017018959120460194,29,29,0,-1,4,4,16,1,4,65,97
947,54,1694,59,100,41,80,104,70,85,15,54,104,60,85,25,0.007794683277170768,0.059838660267538035,64,99,35,1,3,2,5,4,45,72,3
948,1,1,26,26,0,3,3,26,26,0,1,1,26,26,0,3.4037918240920386e-05,3.4037918240920386e-05,26,26,0,-1,6,6,3,2,55,58,45
949,1,617,26,100,74,4,44,26,53,27,1,44,26,57,31,3.4037918240920386e-05,0.01674665577453283,27,83,56,2,6,3,4,1,77,78,12
950,7,213,36,93,57,18,18,36,36,0,7,18,36,46,10,0.0004765308553728854,0.012491915994417782,36,74,38,3,4,4,3,2,64,56,30
951,6,212,30,94,64,22,30,33,35,2,6,18,30,41,11,0.0008509479560230097,0.004118588107151367,37,52,15,3,4,4,5,2,63,42,29
952,372,988,97,100,3,152,152,94,94,0,152,152,94,94,0,0.0348888661969434,0.0651145375948807,92,98,6,2,2,2,5,27,52,10,3
953,0,616,1,100,99,0,42,1,37,36,0,42,1,50,49,0.0,0.01330882603219987,1,74,73,2,-1,3,6,1,41,69,37
954,159,775,86,100,14,234,234,91,91,0,159,234,86,92,6,0.009020048333843901,0.01684876952925559,68,77,9,2,2,2,12,8,3,57,33
955,400,1016,97,100,3,224,224,96,96,0,224,224,96,96,0,0.03652268627250757,0.04152626025392287,93,95,2,2,2,2,8,27,15,10,72
956,88,1688,60,100,40,164,164,77,77,0,88,89,60,62,2,0.008475441641989176,0.015351101126655093,65,79,14,1,2,2,10,4,36,22,58
957,100,100,61,61,0,100,100,43,43,0,100,100,61,61,0,0.024575376969944517,0.024779604479390042,86,86,0,4,1,1,12,9,2,27,63
958,100,100,59,59,0,100,100,39,39,0,100,100,59,59,0,0.047074440927192894,0.047074440927192894,97,97,0,-1,1,1,14,29,16,0,89
959,2,618,29,100,71,7,44,29,47,18,2,44,29,57,28,0.00013615167296368154,0.012185574730249497,32,76,44,2,5,3,4,1,47,65,33
960,12,1652,34,100,66,28,62,34,43,9,12,59,34,53,19,0.0012594029749140542,0.019027196296674494,37,80,43,1,4,2,6,3,71,51,43
961,0,206,1,94,93,0,8,1,32,31,0,8,1,37,36,0.0,0.0035059055788147996,1,51,50,3,-1,4,2,0,90,79,22
962,420,1020,100,100,0,176,176,100,100,0,176,176,100,100,0,0.04380680077606454,0.05408625208482249,96,97,1,2,2,2,5,27,50,10,12
963,16,632,37,100,63,24,50,35,44,9,16,50,37,57,20,0.00037441710065012424,0.015453214881377854,35,78,43,2,3,3,5,1,63,88,16
964,125,741,79,100,21,102,102,65,65,0,102,102,74,74,0,0.016202049082678104,0.02648150039143606,79,89,10,2,3,3,7,12,46,37,33
965,88,88,73,73,0,72,72,80,80,0,72,72,80,80,0,0.014227849824704722,0.014227849824704722,78,78,0,-1,2,2,3,4,87,38,59
966,0,206,1,93,92,0,18,1,34,33,0,18,1,45,44,0.0,0.009054086252084823,1,64,63,3,-1,4,3,0,58,81,19
967,0,0,1,1,0,0,0,1,1,0,0,0,1,1,0,0.0,0.0,1,1,0,-1,-1,-1,4,0,72,36,99
968,0,0,1,1,0,0,0,1,1,0,0,0,1,1,0,0.0,0.0,1,1,0,-1,-1,-1,8,0,27,76,67
969,8,208,38,95,57,8,8,33,33,0,8,8,38,38,0,0.0013274788113958951,0.002552843868069029,41,46,5,3,4,4,2,3,89,51,94
970,100,100,70,70,0,100,100,73,73,0,100,100,74,74,0,0.024371149460498995,0.024371149460498995,86,86,0,-1,1,1,6,1,71,60,59
971,419,519,98,100,2,168,168,93,93,0,168,168,94,94,0,0.038428809693999116,0.03859899928520372,92,92,0,4,2,2,6,29,44,1,4
972,0,102,1,77,76,0,8,1,28,27,0,2,1,26,25,0.0,0.00030634126416828345,1,33,32,4,-1,5,5,0,37,82,42
973,6,622,28,100,72,42,84,33,41,8,6,84,28,57,29,0.0002382654276864427,0.014908608189523128,30,78,48,2,4,3,9,1,29,88,16
974,88,704,61,100,39,158,168,82,86,4,88,168,61,88,27,0.007658531604207087,0.02130773681881616,61,82,21,2,2,2,9,4,35,72,18
975,0,0,1,1,0,0,0,1,1,0,0,0,1,1,0,0.0,0.0,1,1,0,-1,-1,-1,14,0,16,76,89
976,77,693,68,100,32,62,62,77,77,0,62,62,78,78,0,0.010858095918853602,0.03805439259334899,67,94,27,2,2,2,3,8,58,57,3
977,2,208,27,88,61,12,38,27,31,4,2,16,27,33,6,0.0,0.0010892133837094523,1,37,36,3,5,4,11,1,33,68,64
978,0,616,1,100,99,0,120,1,57,56,0,110,1,74,73,0.0,0.014908608189523128,1,77,76,2,-1,3,14,0,16,89,23
979,6,212,31,92,61,17,30,31,34,3,6,26,31,47,16,6.807583648184077e-05,0.003914360597705844,30,50,20,3,4,4,7,1,62,65,38
980,100,100,71,71,0,100,100,79,79,0,100,100,79,79,0,0.0392457197317812,0.039824364341876854,94,94,0,3,1,1,5,9,70,31,71
981,175,381,86,100,14,104,104,85,85,0,104,104,85,85,0,0.025290173253003846,0.027638789611627353,85,85,0,3,2,2,5,20,70,23,90
982,208,824,93,100,7,144,144,90,90,0,144,144,90,90,0,0.02215868477483917,0.031076619353960312,85,91,6,2,2,2,6,16,59,18,77
983,100,100,59,59,0,100,100,40,40,0,100,100,59,59,0,0.018142210422410564,0.018142210422410564,80,80,0,-1,1,1,15,7,7,21,89
984,16,118,35,81,46,34,34,39,39,0,16,18,35,40,5,0.0026209197045508697,0.005071649817897137,43,51,8,4,3,3,4,3,67,46,90
985,0,1640,1,100,99,0,118,1,63,62,0,118,1,74,73,0.0,0.029851254297287178,1,91,90,1,-1,2,9,0,28,81,23
986,16,222,33,92,59,66,66,36,36,0,16,26,33,42,9,0.0006126825283365669,0.0016678579938050988,36,41,5,3,3,3,10,1,0,49,43
987,82,82,74,74,0,56,56,84,84,0,56,56,84,84,0,0.01681473161101467,0.01681473161101467,78,78,0,-1,2,2,2,6,86,34,69
988,100,100,79,79,0,100,100,97,97,0,100,100,97,97,0,0.05269069743694476,0.05800061268252834,98,99,1,3,1,1,3,6,60,73,57
989,46,46,49,49,0,98,98,42,42,0,46,46,49,49,0,0.002552843868069029,0.002552843868069029,46,46,0,-1,2,2,12,3,2,51,82
990,0,101,1,76,75,0,9,1,25,24,0,1,1,25,24,0.0,0.0,1,1,0,5,-1,6,9,1,35,45,95
991,22,123,47,81,34,34,34,44,44,0,22,23,47,51,4,0.002927260968719153,0.0029612988869600733,49,49,0,5,3,3,4,2,47,75,55
992,319,919,95,100,5,104,104,81,81,0,104,104,84,84,0,0.03465060076925695,0.04234317029170496,89,94,5,2,2,2,5,30,61,7,14
993,77,177,74,93,19,22,22,49,49,0,22,22,50,50,0,0.015385139044896015,0.015657442390823378,79,79,0,4,3,3,2,12,93,37,49
994,42,248,54,93,39,98,98,53,53,0,40,52,54,59,5,0.0034718676605738795,0.005684332346233704,51,59,8,3,3,3,8,6,57,41,70
995,32,238,48,93,45,78,78,45,45,0,32,58,48,54,6,0.003608019333537561,0.007624493685966166,51,61,10,3,3,3,8,2,15,75,26
996,174,790,91,100,9,144,144,91,91,0,144,144,91,91,0,0.02314578440382586,0.030429898907382825,87,90,3,2,2,2,6,16,32,18,14
997,208,414,94,100,6,144,144,88,88,0,144,144,89,89,0,0.023179822322066782,0.026958031246808945,87,88,1,3,2,2,6,16,34,18,13
998,0,206,1,93,92,0,11,1,32,31,0,6,1,32,31,0.0,0.0006467204465774873,1,36,35,3,-1,4,4,0,73,89,88
999,67,273,62,95,33,54,54,55,55,0,54,54,60,60,0,0.007862759113652609,0.011062323428299126,62,74,12,3,3,3,4,8,73,44,26
