,FreeNet_pre_score,FreeNet_post_score,FreeNet_pre_rank,FreeNet_post_rank,FreeNet_delta_ranks,Reversed_pre_score,Reversed_post_score,Reversed_pre_rank,Reversed_post_rank,Reversed_delta_ranks,Independent_pre_score,Independent_post_score,Independent_pre_rank,Independent_post_rank,Independent_delta_ranks,Random_pre_score,Random_post_score,Random_pre_rank,Random_post_rank,Random_delta_ranks,dist_victim_relayer,dist_victim_vilain_pre,dist_victim_vilain_post,out_deg_victim,in_deg_villain,victim,villain,relayer
0,0,616,1,100,99,0,26,1,44,43,0,24,1,53,52,0.0,0.007113924912352361,1,60,59,2,-1,3,4,0,77,87,73
1,2,2,27,27,0,7,7,28,28,0,2,2,27,27,0,0.0002042275094455223,0.0002042275094455223,31,31,0,-1,5,5,4,1,79,60,86
2,16,222,41,94,53,40,40,43,43,0,16,40,41,52,11,0.002144388849177984,0.0141938119064638,47,78,31,3,3,3,5,1,49,53,18
3,102,308,75,96,21,134,134,90,90,0,102,114,79,86,7,0.0123557643214541,0.014568229007113924,71,75,4,3,2,2,6,7,74,62,75
4,0,102,1,84,83,0,4,1,28,27,0,4,1,31,30,0.0,0.0019741992579733825,1,45,44,4,-1,5,2,0,98,92,70
5,606,812,100,100,0,400,400,99,99,0,400,400,99,99,0,0.052554545763981074,0.054154327921304334,99,99,0,3,2,2,13,36,13,2,41
6,12,628,34,100,66,28,38,34,36,2,12,42,34,50,16,0.0012594029749140542,0.00622893903808843,37,55,18,2,4,3,6,3,71,51,38
7,30,30,49,49,0,66,66,48,48,0,30,30,49,49,0,0.004152626025392287,0.004152626025392287,50,50,0,-1,3,3,6,6,59,73,97
8,0,206,1,93,92,0,10,1,30,29,0,10,1,40,39,0.0,0.00445896728956057,1,51,50,3,-1,4,3,0,92,97,34
9,40,40,50,50,0,144,144,72,72,0,40,40,50,50,0,0.004663194799006093,0.004663194799006093,54,54,0,-1,2,2,10,3,22,46,96
10,0,206,1,94,93,0,18,1,37,36,0,18,1,45,44,0.0,0.00616086320160659,1,62,61,3,-1,4,3,0,81,92,44
11,22,638,44,100,56,40,50,45,49,4,22,50,44,53,9,0.001497668402600497,0.017018959120460194,43,81,38,2,3,3,5,2,37,61,12
12,88,189,62,87,25,152,152,76,76,0,88,89,62,63,1,0.00803294870485721,0.00803294870485721,62,62,0,5,2,2,8,4,15,72,68
13,159,365,87,97,10,104,104,82,82,0,104,104,82,82,0,0.018040096667687803,0.021954457265393648,82,84,2,3,2,2,5,15,80,19,72
14,12,12,35,35,0,30,30,36,36,0,12,12,35,35,0,0.0014295925661186562,0.0014295925661186562,42,42,0,-1,4,4,5,3,63,51,69
15,0,206,1,92,91,0,28,1,32,31,0,8,1,33,32,0.0,0.0015657442390823377,1,42,41,3,-1,4,6,1,65,50,52
16,6,108,31,79,48,15,15,31,31,0,6,10,31,36,5,6.807583648184077e-05,0.0008509479560230097,29,37,8,4,4,4,6,1,32,65,74
17,158,358,89,98,9,104,104,86,86,0,104,104,86,86,0,0.022601177711971135,0.0313829606181286,84,90,6,3,2,2,5,18,45,30,19
18,116,732,81,100,19,104,104,86,86,0,104,104,87,87,0,0.0176997174852786,0.032914666938970015,80,92,12,2,2,2,5,8,49,20,23
19,56,157,53,84,31,120,120,57,57,0,56,57,53,53,0,0.0035739814152966403,0.003642057251778481,49,50,1,6,2,2,14,2,17,83,78
20,228,228,100,100,0,56,56,92,92,0,56,56,92,92,0,0.054154327921304334,0.054154327921304334,98,98,0,-1,2,2,2,36,97,2,36
21,197,397,94,100,6,22,22,48,48,0,22,22,51,51,0,0.028455699649409444,0.030463936825623743,90,93,3,3,3,3,2,30,95,7,47
22,114,320,78,98,20,134,134,88,88,0,114,134,84,88,4,0.013683243132849994,0.015487252799618776,75,78,3,3,2,2,6,6,59,77,83
23,262,468,98,100,2,56,56,84,84,0,56,56,85,85,0,0.04115184315327275,0.04465774873208755,96,96,0,3,2,2,2,29,98,1,44
24,174,174,90,90,0,72,72,77,77,0,72,72,77,77,0,0.020150447598624867,0.020150447598624867,85,85,0,-1,2,2,3,17,82,6,59
25,0,616,1,100,99,0,46,1,34,33,0,34,1,45,44,0.0,0.005786446100956465,1,58,57,2,-1,3,8,0,42,92,34
26,0,616,1,100,99,0,42,1,35,34,0,42,1,51,50,0.0,0.007828721195411689,1,61,60,2,-1,3,6,0,51,79,20
27,100,100,58,58,0,100,100,38,38,0,100,100,58,58,0,0.04782327512849314,0.05463085877667722,97,98,1,2,1,1,16,29,9,1,33
28,24,24,52,52,0,28,28,46,46,0,24,24,52,52,0,0.0015657442390823377,0.0015657442390823377,42,42,0,-1,3,3,3,3,81,43,79
29,6,6,29,29,0,19,19,29,29,0,6,6,29,29,0,0.00017018959120460194,0.00017018959120460194,31,31,0,-1,4,4,8,1,42,65,80
30,0,616,1,100,99,0,24,1,44,43,0,24,1,50,49,0.0,0.010041185881071514,1,67,66,2,-1,3,3,1,85,69,8
31,0,206,1,92,91,0,20,1,32,31,0,21,1,41,40,0.0,0.002484768031587188,1,46,45,3,-1,4,6,0,65,86,28
32,22,22,45,45,0,46,46,40,40,0,22,22,45,45,0,0.002382654276864427,0.002382654276864427,47,47,0,-1,3,3,6,2,44,75,67
33,100,100,77,77,0,100,100,97,97,0,100,100,97,97,0,0.06759930562646789,0.07321556213621976,99,99,0,3,1,1,3,12,55,37,31
34,52,668,49,100,51,126,154,59,62,3,52,154,49,80,31,0.0022465026039007454,0.0158616699002689,46,77,31,2,2,2,15,3,7,43,30
35,0,206,1,93,92,0,12,1,35,34,0,12,1,36,35,0.0,0.0036760951700194017,1,52,51,3,-1,4,2,0,68,80,22
36,152,253,86,93,7,256,256,90,90,0,152,153,86,86,0,0.01596378365499166,0.016133973246196264,76,76,0,5,2,2,13,9,13,39,55
37,2,2,28,28,0,7,7,28,28,0,2,2,28,28,0,0.00017018959120460194,0.00017018959120460194,31,31,0,-1,5,5,4,1,84,95,76
38,0,102,1,74,73,0,17,1,25,24,0,2,1,25,24,0.0,0.00017018959120460194,1,28,27,4,-1,5,16,0,4,66,55
39,194,810,91,100,9,222,232,90,94,4,194,232,91,96,5,0.020456788862793153,0.024983831988835564,84,87,3,2,2,2,10,12,36,37,22
40,24,230,44,93,49,58,58,40,40,0,24,50,44,55,11,0.0013955546478777359,0.004799346471969774,41,56,15,3,3,3,8,3,39,43,26
41,129,335,87,99,12,78,78,75,75,0,78,78,77,77,0,0.015214949453691413,0.02573266619013581,79,87,8,3,2,2,4,14,77,32,5
42,10,216,41,93,52,18,18,40,40,0,10,18,41,44,3,0.001157289220191293,0.007250076585316042,40,67,27,3,4,4,3,3,92,43,27
43,0,0,1,1,0,0,0,1,1,0,0,0,1,1,0,0.0,0.0,1,1,0,-1,-1,-1,10,0,11,84,86
44,0,101,1,77,76,0,4,1,24,23,0,1,1,24,23,0.0,0.00013615167296368154,1,29,28,5,-1,6,4,0,84,81,55
45,282,488,95,100,5,342,342,95,95,0,282,286,95,95,0,0.024881718234112803,0.02546036284420845,89,89,0,3,2,2,16,20,9,23,71
46,188,394,92,100,8,48,48,63,63,0,48,48,64,64,0,0.0230436706491031,0.025051907825317403,86,88,2,3,3,3,3,19,82,15,70
47,464,566,98,100,2,288,288,98,98,0,288,288,98,98,0,0.03727152047380782,0.0374076721467715,96,96,0,4,2,2,9,30,54,7,60
48,0,616,1,100,99,0,38,1,38,37,0,38,1,54,53,0.0,0.008679669151434699,1,65,64,2,-1,3,6,1,44,50,8
49,0,102,1,75,74,0,21,1,27,26,0,2,1,25,24,0.0,0.0002723033459273631,1,30,29,4,-1,5,14,1,8,50,88
50,0,206,1,89,88,0,19,1,28,27,0,6,1,28,27,0.0,0.0004084550188910446,1,35,34,3,-1,4,9,0,28,93,42
51,122,328,87,98,11,96,96,92,92,0,96,96,92,92,0,0.020354675108070392,0.021477926410020762,86,88,2,3,2,2,3,13,96,33,43
52,0,101,1,75,74,0,6,1,25,24,0,1,1,25,24,0.0,0.00010211375472276115,1,26,25,5,-1,6,6,0,56,36,78
53,83,1727,80,100,20,32,56,67,91,24,32,56,68,91,23,0.013376901868681712,0.07433881343817011,76,98,22,1,3,2,2,15,97,19,37
54,0,101,1,75,74,0,6,1,25,24,0,1,1,25,24,0.0,0.0,1,1,0,5,-1,6,6,0,56,89,68
55,8,214,37,92,55,20,24,34,37,3,8,24,37,49,12,0.0023486163586235067,0.009122162088566664,46,67,21,3,4,4,4,2,79,83,77
56,82,82,61,61,0,66,66,47,47,0,66,66,55,55,0,0.008373327887266415,0.008373327887266415,63,63,0,-1,3,3,6,7,71,48,98
57,1,617,26,100,74,3,38,26,52,26,1,38,26,54,28,0.0,0.011675005956635693,1,74,73,2,6,3,3,2,64,58,17
58,162,368,88,98,10,128,128,90,90,0,128,128,90,90,0,0.01766567956703768,0.019061234214915415,79,81,2,3,2,2,5,13,63,33,52
59,94,300,67,94,27,90,90,61,61,0,94,90,67,66,-1,0.007284114503556962,0.009939072126348753,61,70,9,3,2,2,6,5,41,47,73
60,124,324,79,97,18,114,114,87,87,0,124,114,90,87,-3,0.010790020082371761,0.01681473161101467,67,79,12,3,2,2,6,7,71,21,27
61,0,0,1,1,0,0,0,1,1,0,0,0,1,1,0,0.0,0.0,1,1,0,-1,-1,-1,8,0,21,96,91
62,16,222,40,97,57,19,28,43,44,1,16,28,40,51,11,0.0016338200755641784,0.005684332346233704,40,55,15,3,3,3,3,1,94,78,47
63,32,1672,51,100,49,76,120,54,86,32,32,120,51,88,37,0.004935498144933456,0.04734674427312026,54,97,43,1,3,2,6,3,32,29,10
64,2,618,27,99,72,12,88,27,41,14,2,64,27,55,28,6.807583648184077e-05,0.006909697402906838,27,61,34,2,5,3,11,1,19,78,21
65,63,263,57,94,37,132,132,70,70,0,63,132,57,79,22,0.005548180673270023,0.009905034208107831,57,66,9,3,2,2,8,4,15,22,44
66,192,192,87,87,0,120,120,77,77,0,120,120,84,84,0,0.01327478811395895,0.01327478811395895,76,76,0,-1,2,2,6,14,40,32,59
67,54,155,64,92,28,22,22,52,52,0,22,22,54,54,0,0.011300588855985567,0.011334626774226489,70,71,1,5,3,3,2,8,86,20,4
68,128,744,81,100,19,200,200,84,84,0,128,151,81,84,3,0.01242384015793594,0.0141938119064638,71,73,2,2,2,2,11,9,33,27,54
69,100,100,61,61,0,100,100,43,43,0,100,100,61,61,0,0.03536539705231628,0.03536539705231628,95,95,0,-1,1,1,12,19,2,15,82
70,0,616,1,100,99,0,28,1,33,32,0,24,1,46,45,0.0,0.003199564314646516,1,48,47,2,-1,3,5,0,52,67,54
71,0,102,1,77,76,0,8,1,29,28,0,2,1,27,26,0.0,0.0013274788113958951,1,40,39,4,-1,5,4,0,84,93,94
72,0,102,1,79,78,0,4,1,26,25,0,2,1,26,25,0.0,0.00017018959120460194,1,31,30,4,-1,5,3,0,58,66,55
73,84,700,66,100,34,70,80,58,64,6,70,80,63,67,4,0.010007147962830594,0.03880322679464924,68,95,27,2,2,2,6,9,69,31,2
74,0,206,1,92,91,0,26,1,34,33,0,26,1,46,45,0.0,0.004322815616596889,1,51,50,3,-1,4,5,0,88,89,47
75,343,943,97,100,3,152,152,95,95,0,152,152,95,95,0,0.039824364341876854,0.05235031825453555,95,99,4,2,2,2,5,29,88,1,18
76,16,632,35,100,65,68,68,43,43,0,16,38,35,46,11,0.0038462847612240037,0.007216038667075122,48,60,12,2,3,3,8,1,27,90,29
77,192,398,95,99,4,96,96,90,90,0,96,96,90,90,0,0.024371149460498995,0.029510875114877974,89,92,3,3,2,2,3,18,75,5,34
78,16,632,40,100,60,60,70,51,58,7,16,70,40,65,25,0.0018040096667687805,0.02661765206439974,43,86,43,2,3,3,5,1,80,53,11
79,0,206,1,93,92,0,12,1,35,34,0,12,1,36,35,0.0,0.006841621566424997,1,59,58,3,-1,4,2,0,68,98,44
80,16,16,39,39,0,46,46,43,43,0,16,16,39,39,0,0.0017359338302869397,0.0017359338302869397,43,43,0,-1,3,3,6,2,69,94,45
81,298,298,95,95,0,300,300,91,91,0,300,300,94,94,0,0.020252561353347628,0.020252561353347628,82,82,0,-1,2,2,14,18,17,5,76
82,0,0,1,1,0,0,0,1,1,0,0,0,1,1,0,0.0,0.0,1,1,0,-1,-1,-1,2,0,89,59,86
83,0,102,1,75,74,0,18,1,29,28,0,2,1,26,25,0.0,0.0018720855032506212,1,42,41,4,-1,5,9,0,54,92,46
84,28,28,46,46,0,96,96,44,44,0,28,28,46,46,0,0.002110350930937064,0.002110350930937064,44,44,0,-1,3,3,11,3,38,54,82
85,0,616,1,100,99,0,74,1,41,40,0,63,1,56,55,0.0,0.012117498893767658,1,75,74,2,-1,3,9,0,28,85,39
86,100,100,58,58,0,100,100,35,35,0,100,100,59,59,0,0.014772456516559448,0.01681473161101467,75,79,4,2,1,1,17,5,20,47,52
87,488,1104,100,100,0,216,216,96,96,0,216,216,97,97,0,0.045508696688110556,0.05997481194050172,97,99,2,2,2,2,9,40,35,3,23
88,6,622,28,100,72,20,82,28,36,8,6,46,28,51,23,0.00013615167296368154,0.004356853534837809,28,54,26,2,4,3,14,2,17,58,47
89,0,0,1,1,0,0,0,1,1,0,0,0,1,1,0,0.0,0.0,1,1,0,-1,-1,-1,2,1,86,45,98
90,100,100,62,62,0,100,100,48,48,0,100,100,62,62,0,0.033765614894993023,0.040913577725586306,93,95,2,2,1,1,10,17,11,6,48
91,61,61,56,56,0,100,100,45,45,0,61,61,56,56,0,0.004356853534837809,0.004356853534837809,54,54,0,-1,3,3,10,6,1,35,98
92,262,878,96,100,4,120,120,100,100,0,120,120,100,100,0,0.04615541713468804,0.05582218591510943,95,99,4,2,2,2,3,27,92,10,17
93,18,634,43,100,57,36,70,38,53,15,18,70,43,59,16,0.0006126825283365669,0.02757071377514551,36,87,51,2,3,3,5,2,61,63,10
94,121,737,82,100,18,230,240,75,76,1,121,167,82,86,4,0.008543517478471017,0.01242384015793594,64,73,9,2,2,2,16,8,4,44,13
95,12,628,34,100,66,24,52,31,39,8,12,52,34,51,17,0.0002042275094455223,0.022328874366043774,29,84,55,2,4,3,6,2,71,63,10
96,0,616,1,100,99,0,50,1,36,35,0,50,1,55,54,0.0,0.007250076585316042,1,62,61,2,-1,3,8,0,21,96,31
97,63,269,61,93,32,64,64,60,60,0,64,64,63,63,0,0.007658531604207087,0.01327478811395895,63,77,14,3,3,3,4,8,83,57,34
98,22,638,41,100,59,40,50,40,45,5,22,50,41,52,11,0.002314578440382586,0.012559991830899623,46,75,29,2,3,3,5,2,50,83,33
99,88,294,60,96,36,164,164,76,76,0,88,96,60,61,1,0.008101024541339052,0.009905034208107831,63,65,2,3,2,2,10,4,11,38,75
100,48,254,61,94,33,62,62,75,75,0,48,62,64,76,12,0.00445896728956057,0.005377991082065421,53,57,4,3,2,2,3,4,82,64,42
101,0,102,1,81,80,0,5,1,27,26,0,4,1,28,27,0.0,0.001055175465468532,1,37,36,4,-1,5,3,0,82,79,51
102,0,616,1,100,99,0,82,1,34,33,0,40,1,46,45,0.0,0.004322815616596889,1,52,51,2,-1,3,16,0,4,40,26
103,116,322,78,94,16,120,120,79,79,0,120,120,81,81,0,0.01415977398822288,0.01575955614554614,78,80,2,3,2,2,6,8,44,17,54
104,442,1042,100,100,0,168,168,99,99,0,168,168,99,99,0,0.04935498144933456,0.06133632867013854,99,100,1,2,2,2,6,36,71,2,15
105,0,616,1,100,99,0,22,1,46,45,0,22,1,50,49,0.0,0.024064808196330712,1,88,87,2,-1,3,2,0,89,99,10
106,100,100,61,61,0,100,100,43,43,0,100,100,61,61,0,0.023520201504475986,0.05408625208482249,84,100,16,1,1,1,12,5,2,25,10
107,174,774,83,100,17,142,142,78,78,0,142,142,82,82,0,0.018822968787228972,0.023724429013921508,78,85,7,2,2,2,8,15,27,19,38
108,0,616,1,100,99,0,74,1,40,39,0,74,1,61,60,0.0,0.013989584397018279,1,74,73,2,-1,3,9,0,54,89,12
109,112,728,78,100,22,252,262,85,87,2,112,262,78,90,12,0.008441403723748256,0.03104258143571939,64,92,28,2,2,2,14,4,25,38,11
110,0,616,1,100,99,0,106,1,55,54,0,72,1,55,54,0.0,0.008679669151434699,1,64,63,2,-1,3,14,0,8,36,20
111,16,222,44,92,48,34,34,45,45,0,16,34,44,52,8,0.004152626025392287,0.010619830491167161,52,68,16,3,3,3,4,1,84,90,20
112,266,882,96,100,4,256,256,96,96,0,256,256,96,96,0,0.024166921951053473,0.03716940671908506,85,95,10,2,2,2,10,16,1,18,6
113,100,100,58,58,0,100,100,35,35,0,100,100,59,59,0,0.04431736954967834,0.04431736954967834,98,98,0,-1,1,1,17,29,20,1,45
114,0,616,1,100,99,0,38,1,34,33,0,18,1,39,38,0.0,0.002484768031587188,1,45,44,2,-1,3,8,0,42,76,52
115,32,238,46,92,46,112,112,58,58,0,32,38,46,47,1,0.002280540522141666,0.004322815616596889,46,55,9,3,3,3,12,2,14,75,90
116,16,1656,34,100,66,82,116,40,61,21,16,116,34,75,41,0.0029612988869600733,0.020456788862793153,49,79,30,1,3,2,12,3,2,46,19
117,0,0,1,1,0,0,0,1,1,0,0,0,1,1,0,0.0,0.0,1,1,0,-1,-1,-1,8,0,15,36,98
118,0,616,1,100,99,0,38,1,39,38,0,16,1,38,37,0.0,0.004561081044283332,1,53,52,2,-1,3,6,0,32,66,90
119,22,638,51,100,49,44,44,53,53,0,22,44,51,57,6,0.004016474352428605,0.011096361346540046,55,74,19,2,3,3,4,3,78,29,31
120,135,751,84,100,16,128,128,90,90,0,128,128,90,90,0,0.01242384015793594,0.022703291466693896,73,88,15,2,2,2,5,8,63,44,33
121,100,300,75,98,23,54,54,55,55,0,54,54,60,60,0,0.01055175465468532,0.018244324177133328,73,81,8,3,3,3,4,14,73,32,39
122,18,18,43,43,0,46,46,48,48,0,18,18,43,43,0,0.0018040096667687805,0.0018040096667687805,44,44,0,-1,3,3,5,2,61,74,81
123,54,260,58,95,37,98,98,52,52,0,54,98,58,67,9,0.006773545729943157,0.015589366554341537,64,78,14,3,3,3,8,4,39,38,33
124,132,132,84,84,0,72,72,77,77,0,72,72,77,77,0,0.01756356581231492,0.01756356581231492,81,81,0,-1,2,2,3,13,82,33,85
125,1,207,26,91,65,6,20,26,32,6,1,7,26,35,9,3.4037918240920386e-05,0.0005786446100956465,28,34,6,3,6,4,6,1,44,78,42
126,169,769,82,100,18,170,170,87,87,0,169,170,87,87,0,0.011300588855985567,0.019844106334456584,68,79,11,2,2,2,8,8,27,44,17
127,35,241,58,100,42,22,22,55,55,0,22,22,57,57,0,0.0048674223084516155,0.020831205963443275,55,84,29,3,3,3,2,6,97,28,23
128,0,206,1,92,91,0,31,1,30,29,0,9,1,33,32,0.0,0.00088498587426393,1,36,35,3,-1,4,10,0,36,79,64
129,0,0,1,1,0,0,0,1,1,0,0,0,1,1,0,0.0,0.0,1,1,0,-1,-1,-1,4,0,77,93,81
130,0,102,1,76,75,0,11,1,27,26,0,2,1,25,24,0.0,0.00034037918240920387,1,31,30,4,-1,5,6,0,56,84,49
131,8,214,38,97,59,12,12,35,35,0,8,12,38,41,3,0.0002723033459273631,0.005616256509751864,33,58,25,3,4,4,2,2,98,63,62
132,0,206,1,92,91,0,14,1,33,32,0,14,1,38,37,0.0,0.006943735321147759,1,61,60,3,-1,4,3,0,64,85,8
133,84,84,76,76,0,56,56,84,84,0,56,56,85,85,0,0.01494264610776405,0.01494264610776405,80,80,0,-1,2,2,2,7,98,48,81
134,6,212,33,92,59,20,20,35,35,0,6,20,33,45,12,0.0011913271384322134,0.008577555396711936,40,64,24,3,4,4,4,1,47,71,32
135,22,1662,43,100,57,50,92,37,50,13,22,92,43,66,23,0.0014295925661186562,0.0317233398005378,41,91,50,1,3,2,8,3,30,51,10
136,0,101,1,73,72,0,10,1,25,24,0,1,1,25,24,0.0,6.807583648184077e-05,1,27,26,5,-1,6,10,0,22,66,78
137,104,310,77,96,19,160,160,73,73,0,104,112,77,78,1,0.005582218591510943,0.006943735321147759,60,63,3,3,2,2,11,5,38,47,61
138,6,622,29,100,71,29,112,31,58,27,6,112,29,75,46,6.807583648184077e-05,0.021375812655298,27,83,56,2,4,3,12,1,3,60,10
139,84,290,58,96,38,126,126,77,77,0,84,126,59,83,24,0.010994247591817285,0.02117158514585248,73,86,13,3,2,2,7,5,46,25,37
140,16,1656,34,100,66,96,148,37,63,26,16,139,34,82,48,0.0008509479560230097,0.021682153919466287,36,80,44,1,3,2,14,2,16,42,6
141,15,221,49,97,48,12,12,35,35,0,12,12,43,43,0,0.0042547397801150485,0.01143674052894925,56,72,16,3,4,4,2,6,86,73,20
142,88,704,59,100,41,196,196,79,79,0,88,196,59,85,26,0.008441403723748256,0.0265495762279179,61,87,26,2,2,2,12,4,2,72,23
143,100,100,59,59,0,100,100,40,40,0,100,100,59,59,0,0.0631063004186664,0.0631063004186664,100,100,0,-1,1,1,15,36,7,2,93
144,0,616,1,100,99,0,78,1,43,42,0,78,1,57,56,0.0,0.015521290717859695,1,78,77,2,-1,3,8,1,10,50,12
145,0,206,1,95,94,0,18,1,34,33,0,18,1,45,44,0.0,0.015827631982027978,1,78,77,3,-1,4,3,0,94,66,9
146,100,100,69,69,0,100,100,57,57,0,100,100,69,69,0,0.03359542530378842,0.04053916062493618,88,96,8,3,1,1,8,16,57,12,20
147,300,1940,96,100,4,376,400,98,99,1,300,400,96,99,3,0.02542632492596753,0.05429047959426801,90,100,10,1,2,2,16,16,9,18,1
148,6,212,31,92,61,46,50,34,34,0,6,12,31,35,4,0.0002042275094455223,0.0007488342013002485,32,37,5,3,4,4,11,1,19,88,42
149,100,306,59,95,36,198,198,69,69,0,100,108,59,74,15,0.008169100377820893,0.00888389666088022,61,65,4,3,2,2,14,6,16,34,74
150,44,146,66,93,27,32,32,67,67,0,32,32,68,68,0,0.009224275843289425,0.013751318969331836,68,76,8,4,3,3,2,6,97,34,31
151,100,100,66,66,0,100,100,60,60,0,100,100,68,68,0,0.04472582456856938,0.0597705844310562,97,99,2,1,1,1,7,20,43,23,74
152,0,616,1,100,99,0,40,1,33,32,0,16,1,35,34,0.0,0.001940161339732462,1,43,42,2,-1,3,9,0,28,86,53
153,0,101,1,73,72,0,16,1,25,24,0,1,1,25,24,0.0,6.807583648184077e-05,1,25,24,5,-1,6,16,0,4,76,78
154,12,114,37,83,46,14,14,33,33,0,12,14,37,40,3,0.0005786446100956465,0.0016678579938050988,35,42,7,4,4,4,3,2,75,63,83
155,2,208,26,89,63,11,30,27,31,4,2,14,26,31,5,0.00010211375472276115,0.0016678579938050988,28,40,12,3,5,4,9,1,29,68,83
156,16,632,44,100,56,34,44,45,49,4,16,44,44,56,12,0.004152626025392287,0.019095272133156337,52,81,29,2,3,3,4,1,84,90,5
157,0,102,1,74,73,0,10,1,28,27,0,4,1,29,28,0.0,0.0004084550188910446,1,32,31,4,-1,5,6,0,41,85,74
158,16,222,36,90,54,62,66,44,46,2,16,66,36,54,18,0.0028932230504782326,0.00881582082439838,40,63,23,3,3,3,6,3,71,46,44
159,63,269,61,96,35,72,72,77,77,0,72,72,77,77,0,0.007352190340038803,0.014023622315259198,64,75,11,3,2,2,3,4,64,22,24
160,44,145,53,86,33,50,50,48,48,0,44,45,53,53,0,0.005956635692161067,0.005990673610401988,59,59,0,5,3,3,5,4,49,38,65
161,130,730,83,100,17,88,88,76,76,0,88,88,79,79,0,0.011709043874876613,0.024439225296980838,74,88,14,2,2,2,4,13,47,24,6
162,2,618,27,100,73,6,28,29,44,15,2,28,27,51,24,0.0005786446100956465,0.01507879778072773,34,77,43,2,5,3,3,2,94,42,37
163,36,652,52,100,48,38,38,47,47,0,38,38,53,53,0,0.0040845501889104465,0.009973110044589673,52,72,20,2,3,3,3,6,75,41,47
164,32,32,46,46,0,76,76,49,49,0,32,32,46,46,0,0.0025188059498281084,0.0025188059498281084,45,45,0,-1,3,3,6,2,40,52,86
165,0,0,1,1,0,0,0,1,1,0,0,0,1,1,0,0.0,0.0,1,1,0,-1,-1,-1,10,0,12,81,91
166,100,100,70,70,0,100,100,68,68,0,100,100,73,73,0,0.03264236359304265,0.06409340004765308,90,100,10,2,1,1,6,7,48,62,3
167,146,248,87,94,7,102,102,92,92,0,102,102,92,92,0,0.017869907076483203,0.018108172504169646,81,81,0,4,2,2,4,8,47,8,88
168,100,100,69,69,0,100,100,87,87,0,100,100,87,87,0,0.04649579631709724,0.05721774056298717,96,99,3,2,1,1,4,5,83,25,17
169,56,672,65,100,35,56,56,86,86,0,56,56,86,86,0,0.008305252050784574,0.03434425950508867,65,95,30,2,2,2,2,2,95,52,3
170,142,142,89,89,0,144,144,91,91,0,144,144,91,91,0,0.018754892950747133,0.018754892950747133,84,84,0,-1,2,2,6,9,32,39,80
171,38,244,53,94,41,68,68,46,46,0,38,68,53,58,5,0.0029612988869600733,0.00891793457912114,51,65,14,3,3,3,8,3,21,54,20
172,152,1792,86,100,14,256,280,90,92,2,152,192,86,88,2,0.01596378365499166,0.024166921951053473,76,84,8,1,2,2,13,9,13,39,56
173,32,32,47,47,0,66,66,49,49,0,32,32,47,47,0,0.0038462847612240037,0.0038462847612240037,51,51,0,-1,3,3,6,3,41,29,81
174,267,473,97,100,3,72,72,86,86,0,72,72,86,86,0,0.046904251335988294,0.0479253888832159,96,96,0,3,2,2,3,36,92,2,64
175,64,64,67,67,0,48,48,73,73,0,48,48,75,75,0,0.013989584397018279,0.013989584397018279,76,76,0,-1,3,3,3,9,92,39,86
176,237,338,93,98,5,96,96,87,87,0,96,96,87,87,0,0.027638789611627353,0.027638789611627353,90,90,0,6,2,2,3,19,87,15,78
177,0,616,1,100,99,0,158,1,65,64,0,158,1,86,85,0.0,0.031178733108683073,1,92,91,2,-1,3,13,0,13,92,2
178,0,616,1,100,99,0,40,1,39,38,0,40,1,49,48,0.0,0.007488342013002485,1,58,57,2,-1,3,5,0,52,80,27
179,0,101,1,80,79,0,3,1,24,23,0,1,1,24,23,0.0,6.807583648184077e-05,1,29,28,5,-1,6,3,0,87,99,55
180,2,2,28,28,0,4,4,29,29,0,2,2,28,28,0,0.00010211375472276115,0.00010211375472276115,31,31,0,-1,5,5,2,1,86,60,87
181,40,1680,47,100,53,52,138,35,73,38,40,138,47,85,38,0.0026549576227917903,0.021852343510670887,44,84,40,1,2,2,9,1,29,55,32
182,400,2000,97,100,3,224,224,96,96,0,224,224,96,96,0,0.03652268627250757,0.055413730896218386,93,99,6,1,2,2,8,27,15,10,33
183,6,6,33,33,0,8,8,33,33,0,6,6,33,33,0,0.00030634126416828345,0.00030634126416828345,36,36,0,-1,4,4,2,1,86,88,50
184,12,114,40,84,44,18,18,38,38,0,12,18,40,46,6,0.0018040096667687805,0.0020082371762143027,44,46,2,4,4,4,3,2,76,52,63
185,6,6,32,32,0,18,18,35,35,0,6,6,32,32,0,0.0013955546478777359,0.0013955546478777359,42,42,0,-1,4,4,3,1,58,71,45
186,100,100,64,64,0,100,100,57,57,0,100,100,65,65,0,0.04435140746791926,0.04455563497736478,97,97,0,4,1,1,8,20,10,23,63
187,2,618,26,100,74,10,50,27,36,9,2,39,26,50,24,3.4037918240920386e-05,0.006501242384015794,26,58,32,2,5,3,8,2,30,58,34
188,0,0,1,1,0,0,0,1,1,0,0,0,1,1,0,0.0,0.0,1,1,0,-1,-1,-1,11,0,19,36,97
189,102,308,83,99,16,72,72,84,84,0,72,72,84,84,0,0.014704380680077607,0.016984921202219273,78,81,3,3,2,2,3,7,85,48,75
190,0,1640,1,100,99,0,130,1,58,57,0,68,1,52,51,0.0,0.010007147962830594,1,64,63,1,-1,2,17,0,20,93,62
191,118,734,78,100,22,194,204,78,84,6,118,204,78,92,14,0.007216038667075122,0.014670342761836687,61,77,16,2,2,2,11,5,19,47,17
192,184,800,89,100,11,276,276,90,90,0,184,276,89,96,7,0.01504475986248681,0.031178733108683073,73,90,17,2,2,2,14,8,8,20,23
193,6,212,30,94,64,12,12,32,32,0,6,12,30,36,6,0.0005105687736138058,0.013581129378127233,35,77,42,3,4,4,2,2,91,42,18
194,146,146,83,83,0,176,176,87,87,0,146,146,83,83,0,0.013853432724054596,0.013853432724054596,77,77,0,-1,2,2,8,9,15,27,89
195,0,206,1,88,87,0,17,1,27,26,0,6,1,28,27,0.0,0.00010211375472276115,1,27,26,3,-1,4,11,0,33,81,4
196,168,374,87,97,10,112,112,70,70,0,112,112,77,77,0,0.012764219340345145,0.019673916743251984,76,86,10,3,3,3,7,14,46,32,77
197,179,280,91,95,4,80,80,65,65,0,80,80,69,69,0,0.01872085503250621,0.018788930868988054,83,83,0,5,3,3,5,18,37,5,95
198,16,16,33,33,0,82,82,35,35,0,16,16,33,33,0,0.0005446066918547262,0.0005446066918547262,34,34,0,-1,3,3,16,1,4,49,40
199,22,22,41,41,0,64,64,41,41,0,22,22,41,41,0,0.0021784267674189047,0.0021784267674189047,47,47,0,-1,3,3,9,2,28,75,92
200,0,0,1,1,0,0,0,1,1,0,0,0,1,1,0,0.0,0.0,1,1,0,-1,-1,-1,2,0,68,98,97
201,1,103,26,77,51,4,5,26,26,0,1,3,26,29,3,3.4037918240920386e-05,0.0002723033459273631,27,32,5,4,6,5,4,2,53,58,88
202,2,618,27,100,73,4,18,29,46,17,2,18,27,48,21,0.00030634126416828345,0.009292351679771264,31,67,36,2,5,3,2,1,99,60,17
203,104,104,75,75,0,240,240,77,77,0,104,104,75,75,0,0.005548180673270023,0.005548180673270023,56,56,0,-1,2,2,16,5,4,47,92
204,22,228,43,94,51,40,40,39,39,0,22,40,43,52,9,0.002552843868069029,0.007760645358929848,49,64,15,3,3,3,5,2,63,83,31
205,0,206,1,92,91,0,38,1,34,33,0,37,1,46,45,0.0,0.005922597773920147,1,55,54,3,-1,4,7,0,46,99,44
206,40,656,44,100,56,158,168,66,67,1,40,107,44,75,31,0.00445896728956057,0.016236087000919025,55,73,18,2,2,2,14,1,8,90,37
207,0,0,1,1,0,0,0,1,1,0,0,0,1,1,0,0.0,0.0,1,1,0,-1,-1,-1,8,0,42,76,89
208,100,100,71,71,0,100,100,80,80,0,100,100,81,81,0,0.031621226045815035,0.04047108478845434,90,95,5,3,1,1,5,2,49,61,33
209,0,206,1,92,91,0,14,1,31,30,0,14,1,37,36,0.0,0.003608019333537561,1,51,50,3,-1,4,3,0,82,40,26
210,32,238,49,92,43,40,40,41,41,0,32,38,49,51,2,0.0025188059498281084,0.003948398515946765,47,52,5,3,3,3,5,2,80,75,53
211,101,101,77,77,0,88,88,71,71,0,88,88,71,71,0,0.009734844616903231,0.009734844616903231,69,69,0,-1,2,2,4,8,53,44,82
212,22,22,43,43,0,50,50,37,37,0,22,22,43,43,0,0.0005446066918547262,0.0005446066918547262,36,36,0,-1,3,3,8,2,21,63,86
213,100,100,68,68,0,100,100,57,57,0,100,100,68,68,0,0.055107389632050106,0.05796657476428742,98,98,0,3,1,1,8,29,39,0,35
214,22,228,47,93,46,22,22,42,42,0,22,22,46,46,0,0.0014295925661186562,0.007488342013002485,42,60,18,3,3,3,2,2,68,74,34
215,96,96,71,71,0,94,94,70,70,0,94,94,72,72,0,0.012491915994417782,0.012491915994417782,73,73,0,-1,2,2,5,6,37,77,84
216,0,206,1,90,89,0,20,1,33,32,0,20,1,45,44,0.0,0.0030634126416828346,1,48,47,3,-1,4,4,0,79,96,35
217,326,532,98,98,0,348,348,94,94,0,326,332,98,98,0,0.019912182170938427,0.02038871302631131,82,82,0,3,2,2,17,16,20,12,42
218,0,206,1,90,89,0,24,1,29,28,0,8,1,34,33,0.0,0.0012934408931549745,1,39,38,3,-1,4,8,0,30,91,52
219,0,616,1,100,99,0,72,1,44,43,0,62,1,57,56,0.0,0.010211375472276116,1,68,67,2,-1,3,7,0,24,89,77
220,50,50,57,57,0,44,44,50,50,0,44,44,57,57,0,0.005241839409101739,0.005241839409101739,57,57,0,-1,3,3,4,6,73,26,50
221,0,0,1,1,0,0,0,1,1,0,0,0,1,1,0,0.0,0.0,1,1,0,-1,-1,-1,9,0,29,66,89
222,403,1003,100,100,0,120,120,100,100,0,120,120,100,100,0,0.06031519112291092,0.07338575172742436,97,97,0,2,2,2,3,36,66,2,18
223,217,423,89,98,9,160,160,86,86,0,160,160,88,88,0,0.017052997038701112,0.0176997174852786,79,81,2,3,2,2,7,15,24,19,64
224,18,224,41,90,49,50,62,38,42,4,18,62,41,58,17,0.0004765308553728854,0.008169100377820893,36,64,28,3,3,3,7,2,43,56,14
225,22,228,47,93,46,22,22,42,42,0,22,22,46,46,0,0.0014295925661186562,0.0024507301133462676,42,48,6,3,3,3,2,2,68,74,52
226,122,738,82,100,18,104,104,82,82,0,104,104,82,82,0,0.01494264610776405,0.021477926410020762,77,83,6,2,2,2,5,8,80,8,21
227,12,628,37,100,63,22,60,34,48,14,12,60,37,58,21,0.0006807583648184077,0.021341774737057083,36,85,49,2,4,3,5,2,88,56,7
228,0,102,1,83,82,0,4,1,28,27,0,4,1,30,29,0.0,0.0006126825283365669,1,35,34,4,-1,5,2,0,99,40,43
229,16,1656,41,100,59,50,84,48,73,25,16,84,41,73,32,0.00445896728956057,0.04305796657476429,53,97,44,1,3,2,5,1,49,90,1
230,0,616,1,100,99,0,76,1,39,38,0,76,1,62,61,0.0,0.011640968038394772,1,73,72,2,-1,3,10,0,12,98,5
231,0,0,1,1,0,0,0,1,1,0,0,0,1,1,0,0.0,0.0,1,1,0,-1,-1,-1,6,0,65,67,97
232,8,624,35,100,65,36,68,35,40,5,8,68,35,58,23,0.00037441710065012424,0.009973110044589673,34,68,34,2,4,3,8,2,30,63,20
233,86,86,66,66,0,122,122,76,76,0,86,86,66,66,0,0.00881582082439838,0.00881582082439838,68,68,0,-1,2,2,8,6,39,34,92
234,91,707,72,100,28,48,48,60,60,0,48,48,63,63,0,0.012525953912658701,0.0392457197317812,72,94,22,2,3,3,3,13,58,33,3
235,16,222,37,92,55,54,54,39,39,0,16,28,37,50,13,0.0011913271384322134,0.002757071377514551,40,49,9,3,3,3,8,1,21,71,52
236,248,864,92,100,8,168,168,96,96,0,168,168,96,96,0,0.02719629667449539,0.029647026787841656,89,89,0,2,2,2,6,15,40,16,43
237,0,616,1,100,99,0,18,1,37,36,0,16,1,42,41,0.0,0.003914360597705844,1,52,51,2,-1,3,3,0,81,85,42
238,174,790,87,100,13,144,144,70,70,0,144,144,84,84,0,0.01317267435923619,0.020048333843902106,76,82,6,2,3,3,9,14,28,32,34
239,6,622,30,100,70,34,60,33,36,3,6,28,30,44,14,0.00030634126416828345,0.003948398515946765,34,52,18,2,4,3,11,1,38,4,29
240,180,380,96,100,4,32,32,71,71,0,32,32,71,71,0,0.03352734946730658,0.04384083869430545,95,97,2,3,3,3,2,27,99,10,6
241,128,128,80,80,0,120,120,78,78,0,120,120,78,78,0,0.012559991830899623,0.012559991830899623,72,72,0,-1,2,2,6,9,41,27,82
242,2,2,27,27,0,6,6,27,27,0,2,2,27,27,0,6.807583648184077e-05,6.807583648184077e-05,28,28,0,-1,5,5,5,1,63,68,84
243,32,632,51,100,49,64,64,41,41,0,32,64,51,62,11,0.002825147213996392,0.009360427516253106,49,67,18,2,3,3,8,2,57,75,32
244,22,638,53,100,47,32,32,63,63,0,22,32,55,64,9,0.004901460226692535,0.02307770856734402,58,88,30,2,3,3,2,3,98,29,12
245,130,230,85,97,12,72,72,85,85,0,72,72,85,85,0,0.020456788862793153,0.021580040164743523,82,84,2,4,2,2,3,18,94,30,70
246,24,24,48,48,0,42,42,41,41,0,24,24,48,48,0,0.0012253650566731338,0.0012253650566731338,41,41,0,-1,3,3,6,4,32,64,84
247,0,0,1,1,0,0,0,1,1,0,0,0,1,1,0,0.0,0.0,1,1,0,-1,-1,-1,11,0,5,87,76
248,84,290,76,99,23,56,56,84,84,0,56,56,85,85,0,0.01494264610776405,0.017087034956942034,80,82,2,3,2,2,2,7,98,48,90
249,100,100,71,71,0,100,100,79,79,0,100,100,79,79,0,0.0392457197317812,0.039824364341876854,94,94,0,3,1,1,5,9,70,31,71
250,100,100,67,67,0,100,100,57,57,0,100,100,67,67,0,0.051533408216753465,0.05163552197147622,98,98,0,4,1,1,8,29,21,1,55
251,56,672,55,100,45,74,74,62,62,0,56,74,54,67,13,0.008237176214302734,0.02226079852956193,65,87,22,2,2,2,5,2,37,83,30
252,24,230,50,96,46,22,22,49,49,0,22,22,53,53,0,0.0018720855032506212,0.009394465434494027,44,70,26,3,3,3,2,4,90,64,33
253,62,678,63,100,37,48,48,59,59,0,48,48,63,63,0,0.008135062459579971,0.022294836447802852,64,88,24,2,3,3,3,6,75,34,12
254,0,616,1,100,99,0,54,1,61,60,0,54,1,67,66,0.0,0.03546751080703904,1,94,93,2,-1,3,4,1,72,45,2
255,100,100,73,73,0,100,100,87,87,0,100,100,87,87,0,0.055243541305013785,0.07372613090983356,98,100,2,3,1,1,4,15,79,19,0
256,232,232,91,91,0,320,320,92,92,0,232,232,91,91,0,0.019571802988529223,0.019571802988529223,80,80,0,-1,2,2,14,12,16,37,81
257,16,632,36,100,64,35,84,33,47,14,16,84,36,63,27,0.0009190237925048504,0.022669253548452978,37,85,48,2,3,3,9,1,23,55,11
258,40,141,48,84,36,176,176,70,70,0,40,41,48,52,4,0.003778208924742163,0.003812246842983083,52,52,0,5,2,2,12,3,6,46,78
259,126,126,81,81,0,120,120,85,85,0,120,120,85,85,0,0.018312400013615168,0.018312400013615168,83,83,0,-1,2,2,6,12,48,37,80
260,126,726,78,100,22,168,168,85,85,0,126,168,79,89,10,0.015283025290173252,0.036794989618434935,76,93,17,2,2,2,9,8,29,20,0
261,32,238,44,88,44,102,102,56,56,0,32,38,44,45,1,0.0025188059498281084,0.0030974505599237552,45,49,4,3,3,3,12,2,2,52,49
262,8,1648,37,100,63,10,52,32,77,45,8,52,37,79,42,0.00030634126416828345,0.038394771775758195,32,94,62,1,4,2,3,2,85,63,62
263,0,206,1,97,96,0,8,1,34,33,0,8,1,40,39,0.0,0.0030293747234419145,1,49,48,3,-1,4,2,1,97,45,28
264,100,100,65,65,0,100,100,45,45,0,100,100,65,65,0,0.050784574015453214,0.054528745021954456,99,100,1,3,1,1,10,27,12,10,26
265,90,192,61,88,27,112,112,70,70,0,90,92,62,62,0,0.006637394056979475,0.007147962830593281,59,60,1,4,2,2,8,6,10,28,42
266,110,212,77,89,12,104,104,81,81,0,104,104,84,84,0,0.010211375472276116,0.010381565063480718,70,70,0,4,2,2,5,7,61,21,49
267,122,738,81,100,19,94,94,70,70,0,94,94,72,72,0,0.013989584397018279,0.026958031246808945,77,88,11,2,2,2,5,9,37,27,30
268,0,616,1,100,99,0,60,1,51,50,0,60,1,61,60,0.0,0.026039007454304094,1,89,88,2,-1,3,5,0,45,98,23
269,80,182,78,97,19,32,32,67,67,0,32,32,68,68,0,0.017018959120460194,0.018278362095374246,80,82,2,4,3,3,2,9,97,39,46
270,6,6,27,27,0,20,20,28,28,0,6,6,27,27,0,0.0004084550188910446,0.0004084550188910446,33,33,0,-1,4,4,6,1,40,60,67
271,16,222,36,92,56,52,56,40,43,3,16,24,36,43,7,0.0013615167296368155,0.0031314884781646754,37,46,9,3,3,3,6,1,56,71,52
272,22,638,53,100,47,32,32,63,63,0,22,32,55,64,9,0.004901460226692535,0.028489737567650362,58,91,33,2,3,3,2,3,98,29,0
273,22,638,44,100,56,28,60,38,50,12,22,60,44,56,12,0.0004765308553728854,0.02297559481262126,35,88,53,2,3,3,5,2,37,63,11
274,529,1129,100,100,0,392,392,99,99,0,392,392,99,99,0,0.03478675244222063,0.038530923448721874,93,96,3,2,2,2,14,29,16,11,13
275,16,632,41,100,59,34,44,43,47,4,16,39,41,52,11,0.003437829742332959,0.006331052792811192,52,58,6,2,3,3,4,1,83,90,54
276,82,82,72,72,0,32,32,70,70,0,32,32,70,70,0,0.012764219340345145,0.012764219340345145,75,75,0,-1,3,3,2,6,95,77,66
277,0,102,1,75,74,0,9,1,25,24,0,2,1,25,24,0.0,0.0002042275094455223,1,31,30,4,-1,5,8,0,15,81,55
278,54,54,65,65,0,22,22,52,52,0,22,22,55,55,0,0.010449640899962559,0.010449640899962559,70,70,0,-1,3,3,2,8,98,8,36
279,22,1662,42,100,58,48,86,37,52,15,22,86,42,58,16,0.0014636304843595766,0.02219272269308009,43,85,42,1,3,2,7,3,24,51,8
280,1,1,26,26,0,5,5,26,26,0,1,1,26,26,0,0.0,0.0,1,1,0,-1,6,6,5,1,49,68,87
281,0,206,1,91,90,0,36,1,35,34,0,36,1,46,45,0.0,0.011777119711358454,1,70,69,3,-1,4,6,0,56,89,6
282,66,66,67,67,0,38,38,57,57,0,38,38,60,60,0,0.008169100377820893,0.008169100377820893,65,65,0,-1,3,3,3,9,85,31,99
283,0,616,1,100,99,0,100,1,42,41,0,91,1,60,59,0.0,0.007692569522448007,1,61,60,2,-1,3,12,1,2,69,24
284,295,895,96,100,4,120,120,88,88,0,120,120,87,87,0,0.033425235712583816,0.04111780523503183,94,97,3,2,2,2,6,29,71,11,32
285,2,618,27,100,73,6,28,29,44,15,2,28,27,49,22,0.0002042275094455223,0.02651553830967698,32,89,57,2,5,3,3,1,58,60,3
286,106,312,76,93,17,142,142,78,78,0,106,112,76,77,1,0.009394465434494027,0.010790020082371761,64,67,3,3,2,2,8,7,27,48,53
287,6,108,34,81,47,24,24,37,37,0,6,9,34,37,3,0.0015657442390823377,0.0023486163586235067,44,47,3,4,4,4,4,1,77,71,43
288,85,701,75,100,25,38,38,46,46,0,38,38,51,51,0,0.015351101126655093,0.020661016372238675,79,88,9,2,3,3,3,12,96,37,38
289,88,190,61,90,29,164,164,74,74,0,88,90,61,63,2,0.007726607440688927,0.008066986623098132,63,64,1,4,2,2,10,4,1,72,49
290,12,12,36,36,0,36,36,36,36,0,12,12,36,36,0,0.002382654276864427,0.002382654276864427,45,45,0,-1,4,4,6,2,48,83,86
291,8,8,38,38,0,8,8,33,33,0,8,8,38,38,0,0.0005105687736138058,0.0005105687736138058,34,34,0,-1,4,4,2,2,99,63,89
292,44,44,51,51,0,86,86,68,68,0,44,44,51,51,0,0.006875659484665918,0.006875659484665918,58,58,0,-1,3,3,6,4,69,72,97
293,16,222,42,94,52,28,28,45,45,0,16,24,42,48,6,0.003267640151128357,0.006535280302256714,50,59,9,3,3,3,3,3,58,46,29
294,1,103,25,78,53,4,7,25,27,2,1,4,25,31,6,6.807583648184077e-05,0.0015657442390823377,28,42,14,4,6,5,4,1,79,68,83
295,190,292,89,95,6,318,318,91,91,0,190,190,89,89,0,0.01330882603219987,0.013376901868681712,74,74,0,4,2,2,16,9,4,27,60
296,60,60,65,65,0,34,34,44,44,0,34,34,55,55,0,0.00704584907587052,0.00704584907587052,64,64,0,-1,3,3,4,9,72,31,40
297,0,616,1,100,99,0,78,1,35,34,0,44,1,49,48,0.0,0.005173763572619898,1,55,54,2,-1,3,14,1,17,50,48
298,132,338,90,100,10,56,56,84,84,0,56,56,85,85,0,0.020524864699274992,0.0374076721467715,84,95,11,3,2,2,2,15,98,19,9
299,246,862,92,100,8,112,112,92,92,0,112,112,92,92,0,0.028455699649409444,0.03434425950508867,88,91,3,2,2,2,4,19,83,15,48
300,0,101,1,79,78,0,5,1,24,23,0,1,1,24,23,0.0,0.00010211375472276115,1,28,27,6,-1,7,5,0,45,89,78
301,16,16,36,36,0,40,40,40,40,0,16,16,36,36,0,0.0004084550188910446,0.0004084550188910446,34,34,0,-1,3,3,5,1,52,49,80
302,180,386,90,99,9,94,94,75,75,0,94,94,75,75,0,0.023315973995030465,0.026719765819122502,84,88,4,3,2,2,5,16,49,12,13
303,232,438,94,100,6,72,72,80,80,0,72,72,80,80,0,0.03315293236665646,0.037679975492698865,90,93,3,3,2,2,3,27,76,10,21
304,63,165,57,86,29,84,84,64,64,0,63,65,60,61,1,0.006705469893461316,0.0068075836481840775,59,59,0,4,2,2,5,4,50,22,65
305,332,948,96,100,4,216,216,96,96,0,216,216,97,97,0,0.03274447734776541,0.04401102828551006,92,97,5,2,2,2,9,22,35,9,5
306,0,0,1,1,0,0,0,1,1,0,0,0,1,1,0,0.0,0.0,1,1,0,-1,-1,-1,2,0,86,66,82
307,100,100,61,61,0,100,100,43,43,0,100,100,61,61,0,0.03434425950508867,0.03434425950508867,93,93,0,-1,1,1,12,16,2,18,82
308,16,1656,34,100,66,84,146,39,63,24,16,146,34,85,51,0.0007147962830593281,0.024337111542258077,36,89,53,1,3,2,12,1,6,49,12
309,100,716,66,100,34,130,130,85,85,0,98,130,68,86,18,0.008645631233193778,0.02668572790088158,66,87,21,2,2,2,7,6,62,41,16
310,0,0,1,1,0,0,0,1,1,0,0,0,1,1,0,0.0,0.0,1,1,0,-1,-1,-1,6,0,40,79,59
311,72,688,67,100,33,38,38,55,55,0,38,38,58,58,0,0.008475441641989176,0.03008951972497362,67,88,21,2,3,3,3,7,76,48,9
312,0,206,1,89,88,0,13,1,28,27,0,8,1,35,34,0.0,0.0010211375472276116,1,38,37,3,-1,4,5,0,61,96,51
313,111,111,77,77,0,218,218,76,76,0,111,111,77,77,0,0.007454304094761564,0.007454304094761564,61,61,0,-1,2,2,14,8,25,57,85
314,22,228,43,91,48,56,56,45,45,0,22,56,43,58,15,0.0021784267674189047,0.006705469893461316,44,61,17,3,3,3,6,2,48,52,26
315,159,775,86,100,14,234,234,91,91,0,159,184,86,87,1,0.009020048333843901,0.011266550937744648,68,71,3,2,2,2,12,8,3,57,41
316,562,762,99,100,1,320,320,97,97,0,320,320,97,97,0,0.047993464719697745,0.05037611899656217,98,99,1,3,2,2,11,36,5,2,22
317,94,196,61,86,25,238,238,81,81,0,94,96,61,62,1,0.010926171755335444,0.010960209673576363,68,68,0,4,2,2,14,5,17,25,68
318,0,206,1,93,92,0,20,1,31,30,0,9,1,36,35,0.0,0.001055175465468532,1,38,37,3,-1,4,6,0,34,86,64
319,12,1652,33,100,67,52,112,35,59,24,12,104,33,73,40,0.0004084550188910446,0.016270124919159943,35,74,39,1,4,2,12,2,2,63,27
320,70,670,59,100,41,124,124,68,68,0,70,124,59,81,22,0.005684332346233704,0.02314578440382586,59,84,25,2,3,3,9,5,31,47,9
321,100,100,67,67,0,100,100,74,74,0,100,100,75,75,0,0.062357466217366146,0.07927431158310358,98,99,1,2,1,1,5,29,63,0,9
322,40,246,57,97,40,56,56,76,76,0,40,56,76,76,0,0.007113924912352361,0.012594029749140543,61,75,14,3,2,2,2,1,68,53,25
323,0,616,1,99,98,0,76,1,38,37,0,49,1,51,50,0.0,0.00803294870485721,1,65,64,2,-1,3,11,0,33,98,27
324,116,1756,77,100,23,88,112,73,91,18,88,112,74,91,17,0.015112835698968652,0.04949113312229824,78,97,19,1,2,2,4,8,83,20,14
325,0,0,1,1,0,0,0,1,1,0,0,0,1,1,0,0.0,0.0,1,1,0,-1,-1,-1,14,0,16,85,50
326,422,622,100,100,0,160,160,93,93,0,160,160,94,94,0,0.048844412675720754,0.05041015691480309,98,98,0,3,2,2,7,36,62,2,22
327,0,616,1,100,99,0,24,1,42,41,0,24,1,48,47,0.0,0.008577555396711936,1,63,62,2,-1,3,3,0,58,89,31
328,190,806,88,100,12,182,192,89,90,1,182,192,89,90,1,0.016338200755641786,0.019129310051397258,79,80,1,2,2,2,9,14,26,14,63
329,0,206,1,93,92,0,30,1,40,39,0,16,1,39,38,0.0,0.0046972327172470135,1,53,52,3,-1,4,5,0,45,36,38
330,0,206,1,96,95,0,12,1,36,35,0,12,1,41,40,0.0,0.010075223799312433,1,70,69,3,-1,4,2,0,99,82,33
331,46,252,54,94,40,60,60,53,53,0,46,60,54,59,5,0.00439089145307873,0.008066986623098132,52,63,11,3,3,3,5,6,49,28,47
332,54,54,51,51,0,86,86,63,63,0,54,54,51,51,0,0.007147962830593281,0.007147962830593281,59,59,0,-1,3,3,6,4,56,38,45
333,100,100,65,65,0,100,100,47,47,0,100,100,65,65,0,0.023179822322066782,0.024439225296980838,84,84,0,2,1,1,11,9,38,31,42
334,1,207,25,96,71,2,8,25,32,7,1,8,25,37,12,0.0,0.018244324177133328,1,83,82,3,6,4,2,2,99,58,1
335,8,214,36,91,55,44,44,36,36,0,8,14,36,38,2,0.000442492937131965,0.0015657442390823377,36,40,4,3,4,4,8,2,57,56,53
336,32,238,42,89,47,102,102,56,56,0,32,38,42,43,1,0.001157289220191293,0.0013955546478777359,40,41,1,3,3,3,14,2,25,74,49
337,84,290,71,99,28,72,72,85,85,0,72,72,85,85,0,0.012968446849790666,0.01776779332176044,74,79,5,3,2,2,3,6,94,26,72
338,295,911,97,100,3,120,120,86,86,0,120,120,86,86,0,0.03158718812757412,0.051873787399162666,91,98,7,2,2,2,6,29,65,11,10
339,16,1656,31,100,69,74,188,35,70,35,16,188,31,84,53,0.00037441710065012424,0.0340719561591613,35,95,60,1,3,2,14,1,25,49,1
340,434,434,98,98,0,288,288,100,100,0,288,288,100,100,0,0.0370672929643623,0.0370672929643623,94,94,0,-1,2,2,9,29,29,0,98
341,0,206,1,94,93,0,8,1,32,31,0,8,1,37,36,0.0,0.001157289220191293,1,42,41,3,-1,4,2,0,90,40,54
342,8,214,38,95,57,8,8,32,32,0,8,8,38,38,0,0.0006807583648184077,0.008066986623098132,35,63,28,3,4,4,2,2,95,74,33
343,13,219,41,93,52,18,18,35,35,0,13,18,41,45,4,0.0012253650566731338,0.019163347969638176,39,84,45,3,4,4,3,4,58,64,7
344,0,0,1,1,0,0,0,1,1,0,0,0,1,1,0,0.0,0.0,1,1,0,-1,-1,-1,3,0,85,66,79
345,206,307,94,100,6,72,72,85,85,0,72,72,85,85,0,0.03209775690118792,0.03209775690118792,92,92,0,5,2,2,3,22,60,9,95
346,268,884,96,100,4,216,216,93,93,0,216,216,94,94,0,0.025188059498281085,0.02831954797644576,88,90,2,2,2,2,9,15,28,16,13
347,0,616,1,100,99,0,42,1,37,36,0,42,1,51,50,0.0,0.013070560604513427,1,75,74,2,-1,3,6,0,65,85,15
348,62,268,52,95,43,154,154,66,66,0,62,70,52,53,1,0.003778208924742163,0.005446066918547262,51,53,2,3,2,2,10,6,0,70,75
349,100,100,66,66,0,100,100,49,49,0,100,100,66,66,0,0.029374723441914292,0.040709350216140784,89,96,7,2,1,1,9,6,54,77,33
350,196,796,88,100,12,176,176,75,75,0,176,176,87,87,0,0.020014295925661188,0.02563055243541305,83,88,5,2,3,3,11,16,33,18,21
351,42,1682,50,100,50,116,182,55,71,16,42,163,50,84,34,0.0007828721195411688,0.017937982912965042,37,77,40,1,2,2,14,2,17,56,19
352,0,1640,1,100,99,0,124,1,64,63,0,124,1,79,78,0.0,0.02546036284420845,1,88,87,1,-1,2,10,0,1,82,15
353,74,175,66,92,26,72,72,80,80,0,72,72,80,80,0,0.007760645358929848,0.007828721195411689,61,61,0,5,2,2,3,5,87,47,55
354,22,123,40,77,37,102,102,53,53,0,22,23,40,42,2,0.0007828721195411688,0.0008169100377820892,37,38,1,5,3,3,17,2,20,63,68
355,16,1656,31,100,69,144,188,63,70,7,16,188,31,85,54,0.003199564314646516,0.023520201504475986,50,88,38,1,3,2,14,3,25,46,5
356,90,296,61,96,35,112,112,70,70,0,90,99,62,64,2,0.006637394056979475,0.007760645358929848,59,61,2,3,2,2,8,6,10,28,64
357,16,632,34,100,66,78,112,37,57,20,16,94,34,60,26,0.0011232513019503727,0.01157289220191293,39,70,31,2,3,3,12,1,14,71,33
358,40,246,59,98,39,22,22,52,52,0,22,22,54,54,0,0.005071649817897137,0.012934408931549747,59,75,16,3,3,3,2,5,86,47,8
359,0,206,1,93,92,0,26,1,35,34,0,26,1,51,50,0.0,0.008407365805507334,1,64,63,3,-1,4,5,0,49,66,33
360,76,1716,58,100,42,126,170,63,72,9,76,170,58,86,28,0.007794683277170768,0.022703291466693896,63,86,23,1,3,2,11,6,33,34,31
361,276,377,92,95,3,286,286,88,88,0,276,286,92,93,1,0.024234997787535316,0.024234997787535316,88,88,0,5,2,2,14,16,25,18,78
362,22,228,41,92,51,40,40,40,40,0,22,32,41,48,7,0.0019741992579733825,0.0031314884781646754,45,48,3,3,3,3,5,2,50,52,43
363,1,617,25,100,75,2,22,25,51,26,1,22,25,53,28,0.0,0.016712617856291908,1,82,81,2,6,3,2,1,86,68,18
364,76,282,63,93,30,124,124,68,68,0,76,78,63,65,2,0.008066986623098132,0.008951972497362062,66,68,2,3,3,3,9,6,31,34,51
365,275,891,94,100,6,246,246,95,95,0,246,246,96,96,0,0.018857006705469893,0.04111780523503183,79,96,17,2,2,2,10,15,22,19,7
366,6,622,29,100,71,14,40,30,39,9,6,36,29,47,18,0.00010211375472276115,0.005582218591510943,29,53,24,2,4,3,5,1,52,60,62
367,0,0,1,1,0,0,0,1,1,0,0,0,1,1,0,0.0,0.0,1,1,0,-1,-1,-1,9,0,29,81,84
368,76,1716,62,100,38,90,124,63,90,27,76,124,62,90,28,0.0088498587426393,0.026277272881990537,66,89,23,1,2,2,6,6,65,34,68
369,162,778,83,100,17,176,176,90,90,0,162,176,90,90,0,0.018074134585928724,0.023179822322066782,79,85,6,2,2,2,8,9,21,39,22
370,100,100,79,79,0,100,100,97,97,0,100,100,97,97,0,0.09094931753973927,0.09959494877293305,100,100,0,3,1,1,3,29,60,0,33
371,6,622,30,100,70,27,46,34,38,4,6,46,30,52,22,0.0004084550188910446,0.009020048333843901,33,68,35,2,4,3,6,1,41,88,27
372,6,107,32,82,50,14,14,32,32,0,6,7,32,34,2,0.0009190237925048504,0.0009190237925048504,37,37,0,6,4,4,3,2,96,42,58
373,0,616,1,100,99,0,108,1,56,55,0,48,1,52,51,0.0,0.007794683277170768,1,57,56,2,-1,3,16,0,9,98,77
374,106,722,77,100,23,120,120,80,80,0,120,120,81,81,0,0.01055175465468532,0.023520201504475986,71,88,17,2,2,2,6,7,34,48,15
375,1,207,26,92,66,6,16,26,30,4,1,8,26,34,8,0.0,0.00088498587426393,1,37,36,3,6,4,6,2,65,58,61
376,240,342,89,96,7,240,240,88,88,0,240,240,90,90,0,0.02552843868069029,0.02552843868069029,88,88,0,4,2,2,12,15,2,16,68
377,100,100,59,59,0,100,100,46,46,0,100,100,59,59,0,0.04789135096497498,0.064127437965894,97,100,3,1,1,1,11,30,5,7,17
378,0,206,1,92,91,0,14,1,34,33,0,14,1,42,41,0.0,0.007147962830593281,1,64,63,3,-1,4,3,1,76,69,20
379,24,24,45,45,0,46,46,43,43,0,24,24,45,45,0,0.0012934408931549745,0.0012934408931549745,40,40,0,-1,3,3,6,3,65,43,40
380,61,677,66,100,34,52,72,78,83,5,52,72,80,83,3,0.010347527145239796,0.037850165083903466,67,95,28,2,2,2,3,6,85,35,10
381,6,6,30,30,0,28,28,34,34,0,6,6,30,30,0,0.0002723033459273631,0.0002723033459273631,33,33,0,-1,4,4,8,1,21,88,84
382,22,638,41,100,59,60,106,35,57,22,22,106,41,70,29,0.0013274788113958951,0.02188638142891181,39,85,46,2,3,3,11,3,5,51,10
383,16,632,41,100,59,30,44,42,47,5,16,44,41,53,12,0.0004765308553728854,0.007658531604207087,36,63,27,2,3,3,4,1,83,4,27
384,0,206,1,89,88,0,24,1,30,29,0,8,1,32,31,0.0,0.002280540522141666,1,39,38,3,-1,4,6,0,71,36,29
385,107,313,79,96,17,48,48,62,62,0,48,48,64,64,0,0.013036522686272508,0.017121072875182955,75,83,8,3,3,3,3,13,64,33,34
386,0,1640,1,100,99,0,116,1,54,53,0,81,1,59,58,0.0,0.012491915994417782,1,72,71,1,-1,2,14,0,17,36,44
387,57,159,60,91,31,52,52,75,75,0,52,52,76,76,0,0.010109261717553355,0.011028285510058205,70,72,2,4,2,2,3,6,87,35,43
388,177,793,88,100,12,120,120,86,86,0,120,120,86,86,0,0.01933353756084278,0.031485074372851356,82,90,8,2,2,2,6,18,65,5,12
389,16,222,41,93,52,36,36,42,42,0,16,22,41,47,6,0.001497668402600497,0.0030634126416828346,42,48,6,3,3,3,5,1,70,53,94
390,76,178,62,85,23,76,76,57,57,0,76,76,61,61,0,0.005956635692161067,0.006024711528642908,58,59,1,4,3,3,6,6,74,13,65
391,139,345,90,100,10,56,56,84,84,0,56,56,84,84,0,0.02467749072466728,0.02661765206439974,87,88,1,3,2,2,2,17,86,6,46
392,18,1658,52,100,48,32,56,63,83,20,18,56,54,84,30,0.002280540522141666,0.06654413016099936,46,98,52,1,3,2,2,2,98,52,23
393,100,100,76,76,0,100,100,91,91,0,100,100,91,91,0,0.07471323053882024,0.07471323053882024,100,100,0,-1,1,1,4,29,77,11,36
394,198,300,89,95,6,232,232,93,93,0,198,232,90,94,4,0.01923142380612002,0.01929949964260186,81,81,0,4,2,2,10,12,18,37,65
395,0,102,1,73,72,0,8,1,25,24,0,2,1,25,24,0.0,0.0002042275094455223,1,32,31,4,-1,5,7,0,43,97,55
396,12,113,40,84,44,18,18,38,38,0,12,13,40,42,2,0.0018040096667687805,0.0019061234214915416,44,46,2,5,4,4,3,2,76,52,55
397,100,100,65,65,0,100,100,45,45,0,100,100,65,65,0,0.0510909152796215,0.062493617890329825,100,100,0,2,1,1,10,29,12,0,15
398,52,252,64,97,33,22,22,52,52,0,22,22,55,55,0,0.008305252050784574,0.010483678818203479,66,70,4,3,3,3,2,9,98,31,22
399,12,114,37,80,43,26,26,36,36,0,12,16,37,39,2,0.0020422750944552232,0.0031314884781646754,45,50,5,4,4,4,5,2,45,75,51
400,0,616,1,100,99,0,28,1,45,44,0,28,1,50,49,0.0,0.009258313761530345,1,65,64,2,-1,3,3,0,85,79,48
401,38,38,51,51,0,40,40,45,45,0,38,38,51,51,0,0.002927260968719153,0.002927260968719153,49,49,0,-1,3,3,5,6,37,70,45
402,0,206,1,92,91,0,30,1,29,28,0,6,1,28,27,0.0,0.0005446066918547262,1,35,34,3,-1,4,12,0,6,67,49
403,166,372,83,97,14,276,276,85,85,0,166,172,83,84,1,0.006977773239388679,0.007726607440688927,59,60,1,3,2,2,15,6,7,28,71
404,54,54,58,58,0,70,70,63,63,0,54,54,58,58,0,0.008101024541339052,0.008101024541339052,64,64,0,-1,3,3,5,7,49,62,98
405,0,1640,1,100,99,0,52,1,80,79,0,52,1,81,80,0.0,0.054154327921304334,1,98,97,1,-1,2,3,0,81,85,10
406,2,618,28,100,72,3,22,28,47,19,2,22,28,50,22,3.4037918240920386e-05,0.01245787807617686,28,75,47,2,5,3,2,1,95,65,39
407,44,660,55,100,45,48,48,54,54,0,48,48,56,56,0,0.006841621566424997,0.015146873617209572,57,79,22,2,3,3,3,7,87,62,21
408,0,206,1,95,94,0,12,1,36,35,0,12,1,40,39,0.0,0.003982436434187685,1,52,51,3,-1,4,2,0,89,87,41
409,8,8,37,37,0,30,30,37,37,0,8,8,37,37,0,0.0016338200755641784,0.0016338200755641784,41,41,0,-1,4,4,5,2,80,83,66
410,63,63,55,55,0,84,84,59,59,0,63,63,55,55,0,0.00622893903808843,0.00622893903808843,56,56,0,-1,2,2,5,4,52,22,93
411,0,206,1,93,92,0,12,1,33,32,0,12,1,40,39,0.0,0.0038462847612240037,1,52,51,3,-1,4,4,0,72,87,38
412,0,0,1,1,0,0,0,1,1,0,0,0,1,1,0,0.0,0.0,1,1,0,-1,-1,-1,4,1,72,50,89
413,100,100,74,74,0,100,100,80,80,0,100,100,80,80,0,0.03311889444841554,0.03335715987610198,91,93,2,4,1,1,5,6,45,73,56
414,0,206,1,87,86,0,23,1,29,28,0,7,1,34,33,0.0,0.0004084550188910446,1,33,32,3,-1,4,10,1,22,69,56
415,28,1668,44,100,56,64,118,41,67,26,28,118,44,81,37,0.0017018959120460194,0.02923857176895061,42,87,45,1,3,2,9,3,31,43,23
416,45,661,61,100,39,32,32,64,64,0,32,32,64,64,0,0.004833384390210695,0.021682153919466287,56,86,30,2,3,3,2,6,89,28,12
417,0,1640,1,100,99,0,142,1,65,64,0,90,1,56,55,0.0,0.011743081793117532,1,68,67,1,-1,2,16,0,9,66,21
418,16,16,37,37,0,34,34,35,35,0,16,16,37,37,0,0.0005786446100956465,0.0005786446100956465,35,35,0,-1,3,3,6,1,65,4,40
419,16,222,39,95,56,42,42,41,41,0,16,42,39,56,17,0.0013274788113958951,0.012696143503863304,42,74,32,3,3,3,6,1,32,71,37
420,0,101,1,73,72,0,12,1,25,24,0,1,1,25,24,0.0,3.4037918240920386e-05,1,27,26,5,-1,6,12,0,6,36,78
421,34,135,50,84,34,60,60,52,52,0,34,35,50,50,0,0.0031314884781646754,0.003199564314646516,50,50,0,6,3,3,5,6,45,70,78
422,16,118,35,77,42,78,78,45,45,0,16,18,35,40,5,0.002484768031587188,0.002586881786309949,47,47,0,4,3,3,8,2,15,94,4
423,53,259,61,97,36,38,38,56,56,0,38,38,57,57,0,0.006943735321147759,0.010790020082371761,60,70,10,3,3,3,3,8,60,57,47
424,0,206,1,90,89,0,36,1,32,31,0,19,1,41,40,0.0,0.0026549576227917903,1,46,45,3,-1,4,8,0,39,89,22
425,128,128,80,80,0,252,252,83,83,0,128,128,80,80,0,0.0068075836481840775,0.0068075836481840775,60,60,0,-1,2,2,14,5,8,47,93
426,0,616,1,100,99,0,22,1,41,40,0,22,1,45,44,0.0,0.020695054290479593,1,88,87,2,-1,3,2,0,68,67,0
427,0,0,1,1,0,0,0,1,1,0,0,0,1,1,0,0.0,0.0,1,1,0,-1,-1,-1,7,0,24,87,98
428,100,100,65,65,0,100,100,47,47,0,100,100,65,65,0,0.023179822322066782,0.024200959869294394,84,84,0,3,1,1,11,9,38,31,51
429,54,260,57,95,38,66,66,51,51,0,54,66,57,61,4,0.006739507811702236,0.007760645358929848,62,63,1,3,3,3,6,4,34,38,64
430,12,218,33,90,57,64,68,35,35,0,12,20,33,40,7,0.0013274788113958951,0.0031314884781646754,40,48,8,3,4,4,12,3,14,51,54
431,22,638,40,100,60,84,120,38,59,21,22,120,40,79,39,0.0005105687736138058,0.0141938119064638,36,72,36,2,3,3,14,2,25,63,30
432,28,234,49,95,46,34,34,39,39,0,28,34,49,50,1,0.0021784267674189047,0.01058579257292624,45,72,27,3,3,3,4,3,53,54,32
433,218,218,92,92,0,128,128,92,92,0,128,128,92,92,0,0.023350011913271386,0.023350011913271386,86,86,0,-1,2,2,5,16,50,18,76
434,1,207,26,93,67,3,14,26,33,7,1,14,26,39,13,3.4037918240920386e-05,0.004220701861874128,26,52,26,3,6,4,3,2,55,58,62
435,24,24,45,45,0,40,40,40,40,0,24,24,45,45,0,0.001157289220191293,0.001157289220191293,39,39,0,-1,3,3,5,4,50,64,40
436,2,2,29,29,0,8,8,30,30,0,2,2,29,29,0,0.00017018959120460194,0.00017018959120460194,30,30,0,-1,5,5,4,1,73,65,50
437,46,148,51,84,33,62,62,44,44,0,46,48,51,51,0,0.0036760951700194017,0.0037441710065012424,48,48,0,4,2,2,6,2,71,74,4
438,114,114,77,77,0,180,180,76,76,0,114,114,77,77,0,0.006705469893461316,0.006705469893461316,58,58,0,-1,2,2,12,6,3,28,86
439,34,240,54,95,41,38,38,57,57,0,38,38,59,59,0,0.005820484019197386,0.017427414139351238,58,80,22,3,3,3,3,7,55,62,18
440,16,632,34,100,66,80,152,39,69,30,16,152,34,85,51,0.0012594029749140542,0.01861874127778345,39,78,39,2,3,3,12,1,3,71,6
441,32,32,52,52,0,48,48,65,65,0,32,32,54,54,0,0.00527587732734266,0.00527587732734266,58,58,0,-1,3,3,3,3,66,29,67
442,52,52,53,53,0,44,44,44,44,0,44,44,50,50,0,0.006739507811702236,0.006739507811702236,58,58,0,-1,3,3,4,6,67,34,82
443,0,616,1,100,99,0,28,1,44,43,0,28,1,51,50,0.0,0.02808128254875932,1,94,93,2,-1,3,3,0,94,84,3
444,2,618,28,100,72,8,23,28,35,7,2,20,28,44,16,0.00013615167296368154,0.006024711528642908,30,57,27,2,5,3,5,1,45,65,83
445,16,632,37,100,63,46,76,39,53,14,16,76,37,59,22,0.0012594029749140542,0.028489737567650362,41,89,48,2,3,3,6,1,41,71,2
446,0,616,1,100,99,0,38,1,54,53,0,38,1,57,56,0.0,0.0176997174852786,1,84,83,2,-1,3,3,0,76,87,18
447,0,206,1,93,92,0,14,1,33,32,0,8,1,34,33,0.0,0.003812246842983083,1,52,51,3,-1,4,3,0,55,91,29
448,0,616,1,100,99,0,62,1,34,33,0,26,1,41,40,0.0,0.003948398515946765,1,53,52,2,-1,3,14,0,25,86,41
449,126,326,80,94,14,82,82,50,50,0,82,82,65,65,0,0.009292351679771264,0.011777119711358454,65,72,7,3,3,3,7,13,43,24,29
450,16,16,35,35,0,40,40,35,35,0,16,16,35,35,0,0.0004084550188910446,0.0004084550188910446,36,36,0,-1,3,3,7,1,24,88,97
451,16,632,37,100,63,38,56,38,44,6,16,56,37,52,15,0.0006467204465774873,0.009973110044589673,38,69,31,2,3,3,6,1,59,4,17
452,171,271,90,98,8,72,72,85,85,0,72,72,85,85,0,0.030293747234419143,0.030293747234419143,90,90,0,5,2,2,3,15,60,16,95
453,6,6,32,32,0,14,14,32,32,0,6,6,32,32,0,0.0009190237925048504,0.0009190237925048504,37,37,0,-1,4,4,3,2,96,42,59
454,80,696,55,100,45,188,198,80,82,2,80,148,55,81,26,0.005990673610401988,0.015248987371932332,55,78,23,2,2,2,10,3,0,29,17
455,6,212,31,94,63,15,28,31,33,2,6,28,31,50,19,6.807583648184077e-05,0.0035059055788147996,29,51,22,3,4,4,6,1,32,65,35
456,104,720,74,100,26,176,196,74,78,4,104,196,74,85,11,0.00622893903808843,0.0195377650702883,57,77,20,2,2,2,12,5,2,47,6
457,154,154,82,82,0,120,120,77,77,0,120,120,84,84,0,0.01153885428367201,0.01153885428367201,72,72,0,-1,2,2,6,13,40,24,91
458,54,54,70,70,0,22,22,55,55,0,22,22,57,57,0,0.010007147962830594,0.010007147962830594,70,70,0,-1,3,3,2,7,97,48,69
459,2,2,26,26,0,12,12,26,26,0,2,2,26,26,0,0.0,0.0,1,1,0,-1,5,5,11,1,5,78,36
460,1,1,26,26,0,7,7,26,26,0,1,1,26,26,0,0.0,0.0,1,1,0,-1,6,6,7,1,46,68,86
461,262,462,98,100,2,56,56,84,84,0,56,56,85,85,0,0.04115184315327275,0.05122706695258518,96,97,1,3,2,2,2,29,98,1,18
462,0,616,1,100,99,0,46,1,44,43,0,46,1,54,53,0.0,0.014432077334150244,1,77,76,2,-1,3,5,0,45,81,39
463,234,234,92,92,0,134,134,90,90,0,134,134,90,90,0,0.02205657102011641,0.02205657102011641,85,85,0,-1,2,2,6,16,48,12,59
464,0,0,1,1,0,0,0,1,1,0,0,0,1,1,0,0.0,0.0,1,1,0,-1,-1,-1,8,0,30,91,84
465,94,300,62,94,32,120,120,77,77,0,94,100,63,63,0,0.006739507811702236,0.008169100377820893,57,63,6,3,2,2,6,5,40,47,94
466,0,616,1,99,98,0,35,1,31,30,0,18,1,39,38,0.0,0.0017359338302869397,1,41,40,2,-1,3,11,1,33,50,74
467,0,616,1,100,99,0,66,1,41,40,0,32,1,46,45,0.0,0.0040845501889104465,1,51,50,2,-1,3,9,0,28,80,29
468,213,213,91,91,0,176,176,87,87,0,176,176,89,89,0,0.025085945743558324,0.025085945743558324,86,86,0,-1,2,2,8,20,57,23,80
469,84,84,59,59,0,104,104,73,73,0,84,84,66,66,0,0.010245413390517035,0.010245413390517035,69,69,0,-1,2,2,5,5,52,25,96
470,6,212,30,94,64,16,20,35,35,0,6,14,30,37,7,0.0009190237925048504,0.002723033459273631,38,50,12,3,4,4,4,2,53,42,83
471,166,268,87,96,9,174,174,80,80,0,174,174,90,90,0,0.016338200755641786,0.016610504101569147,79,80,1,4,2,2,10,13,1,33,55
472,16,632,31,100,69,43,100,30,39,9,16,99,31,59,28,0.0002382654276864427,0.014772456516559448,31,72,41,2,3,3,14,1,25,60,23
473,238,238,92,92,0,320,320,96,96,0,238,238,92,92,0,0.01783586915824228,0.01783586915824228,79,79,0,-1,2,2,14,13,8,33,59
474,6,1646,30,100,70,14,74,31,66,35,6,74,30,68,38,0.0004084550188910446,0.033084856530174615,35,89,54,1,4,2,5,1,80,88,30
475,0,0,1,1,0,0,0,1,1,0,0,0,1,1,0,0.0,0.0,1,1,0,-1,-1,-1,10,0,18,79,40
476,2,208,27,94,67,5,12,27,29,2,2,10,27,36,9,0.0,0.0019061234214915416,1,43,42,3,5,4,4,1,53,68,70
477,0,1640,1,100,99,0,52,1,48,47,0,49,1,52,51,0.0,0.0230436706491031,1,85,84,1,-1,2,5,0,88,93,73
478,83,185,71,92,21,48,48,54,54,0,48,48,56,56,0,0.013002484768031588,0.013955546478777357,76,76,0,4,3,3,3,9,87,39,83
479,2,2,28,28,0,8,8,29,29,0,2,2,28,28,0,0.00010211375472276115,0.00010211375472276115,30,30,0,-1,5,5,5,1,70,95,91
480,288,389,95,96,1,320,320,92,92,0,320,320,95,95,0,0.021614078082984444,0.021614078082984444,81,81,0,5,2,2,14,18,16,5,68
481,193,809,92,100,8,200,200,81,81,0,200,200,92,92,0,0.02236291228428469,0.027945130875795636,85,90,5,2,2,2,11,16,19,18,25
482,78,284,61,95,34,152,152,80,80,0,78,84,61,63,2,0.008169100377820893,0.009870996289866912,63,69,6,3,2,2,8,7,30,62,53
483,425,2025,99,100,1,168,168,96,96,0,168,168,96,96,0,0.037645937574457944,0.06256169372681167,93,99,6,1,2,2,6,30,40,7,33
484,0,206,1,96,95,0,8,1,31,30,0,6,1,31,30,0.0,0.0020763130126961434,1,45,44,3,-1,4,2,1,98,69,90
485,0,616,1,100,99,0,48,1,35,34,0,30,1,46,45,0.0,0.006092787365124749,1,55,54,2,-1,3,9,1,35,45,34
486,142,742,82,100,18,86,86,56,56,0,86,86,62,62,0,0.013070560604513427,0.023111746485584943,75,84,9,2,3,3,6,14,51,14,30
487,18,18,42,42,0,76,76,36,36,0,18,18,42,42,0,0.0007488342013002485,0.0007488342013002485,34,34,0,-1,3,3,13,2,13,63,85
488,56,56,63,63,0,38,38,56,56,0,38,38,57,57,0,0.007590455767725246,0.007590455767725246,64,64,0,-1,3,3,3,7,60,21,79
489,76,282,62,97,35,64,64,59,59,0,64,64,63,63,0,0.00803294870485721,0.009905034208107831,66,68,2,3,3,3,4,7,53,21,46
490,128,334,79,95,16,86,86,55,55,0,86,86,60,60,0,0.012696143503863304,0.012934408931549747,75,75,0,3,3,3,6,8,40,8,4
491,402,602,99,100,1,136,136,98,98,0,136,136,98,98,0,0.038905340549372,0.0390755301405766,92,92,0,3,2,2,4,30,83,7,4
492,152,768,88,100,12,118,118,75,75,0,118,118,81,81,0,0.013376901868681712,0.019980258007420267,74,83,9,2,3,3,8,14,39,14,62
493,92,92,67,67,0,78,78,68,68,0,78,78,71,71,0,0.009496579189216788,0.009496579189216788,69,69,0,-1,2,2,4,7,83,48,81
494,0,616,1,100,99,0,28,1,39,38,0,28,1,48,47,0.0,0.01055175465468532,1,75,74,2,-1,3,3,0,82,97,19
495,0,206,1,92,91,0,36,1,40,39,0,36,1,49,48,0.0,0.01861874127778345,1,80,79,3,-1,4,6,1,69,45,1
496,16,16,37,37,0,38,38,38,38,0,16,16,37,37,0,0.0006467204465774873,0.0006467204465774873,38,38,0,-1,3,3,6,1,59,4,91
497,0,206,1,92,91,0,28,1,35,34,0,28,1,47,46,0.0,0.008543517478471017,1,64,63,3,-1,4,6,0,69,36,33
498,62,1702,57,100,43,104,152,60,78,18,62,132,57,80,23,0.002212464685659825,0.019469689233806462,44,81,37,1,2,2,9,4,54,64,35
499,0,0,1,1,0,0,0,1,1,0,0,0,1,1,0,0.0,0.0,1,1,0,-1,-1,-1,6,0,56,98,50
500,22,124,42,78,36,46,46,39,39,0,22,24,42,45,3,0.0018380475850097008,0.002212464685659825,43,44,1,4,3,3,6,2,41,61,88
501,16,16,37,37,0,92,92,42,42,0,16,16,37,37,0,0.0009190237925048504,0.0009190237925048504,38,38,0,-1,3,3,11,2,19,42,99
502,6,6,27,27,0,32,32,34,34,0,6,6,27,27,0,0.00176997174852786,0.00176997174852786,40,40,0,-1,4,4,6,2,51,94,76
503,0,616,1,100,99,0,52,1,39,38,0,48,1,55,54,0.0,0.007760645358929848,1,61,60,2,-1,3,7,0,24,98,17
504,2,208,28,92,64,6,26,28,36,8,2,26,28,49,21,6.807583648184077e-05,0.006433166547533953,28,59,31,3,5,4,5,1,70,68,25
505,38,1678,49,100,51,84,138,47,77,30,38,138,49,83,34,0.0029612988869600733,0.035705776234725484,49,94,45,1,3,2,9,6,35,70,10
506,2,208,26,90,64,8,22,26,32,6,2,16,26,35,9,3.4037918240920386e-05,0.0012594029749140542,27,39,12,3,5,4,7,1,43,78,54
507,235,835,91,100,9,248,248,90,90,0,248,248,92,92,0,0.01667857993805099,0.021375812655298,77,86,9,2,2,2,11,15,33,19,38
508,0,616,1,100,99,0,22,1,41,40,0,22,1,45,44,0.0,0.008169100377820893,1,62,61,2,-1,3,2,0,68,87,62
509,0,616,1,100,99,0,23,1,32,31,0,16,1,36,35,0.0,0.0014636304843595766,1,41,40,2,-1,3,6,0,41,76,4
510,0,0,1,1,0,0,0,1,1,0,0,0,1,1,0,0.0,0.0,1,1,0,-1,-1,-1,15,0,7,40,45
511,343,343,98,98,0,168,168,84,84,0,168,168,89,89,0,0.03260832567480173,0.03260832567480173,89,89,0,-1,2,2,9,30,23,7,40
512,0,102,1,84,83,0,4,1,26,25,0,3,1,30,29,0.0,0.0005786446100956465,1,35,34,4,-1,5,3,0,92,66,51
513,312,928,98,100,2,332,342,92,94,2,312,342,98,99,1,0.02236291228428469,0.033799652813233945,86,94,8,2,2,2,16,16,9,12,37
514,276,892,93,100,7,248,248,89,89,0,248,248,92,92,0,0.019707954661492902,0.026209197045508698,83,87,4,2,2,2,11,17,5,6,72
515,100,100,76,76,0,100,100,96,96,0,100,100,96,96,0,0.08356308928145954,0.08393750638210967,100,100,0,4,1,1,3,22,87,9,51
516,96,302,71,95,24,94,94,70,70,0,94,94,72,72,0,0.012491915994417782,0.01834643793185609,73,83,10,3,2,2,5,6,37,77,44
517,64,270,62,96,34,62,62,74,74,0,62,62,75,75,0,0.008645631233193778,0.012798257258586064,67,74,7,3,2,2,3,6,64,26,47
518,182,182,89,89,0,158,158,78,78,0,158,158,88,88,0,0.019129310051397258,0.019129310051397258,81,81,0,-1,2,2,9,18,29,30,40
519,38,38,50,50,0,120,120,62,62,0,38,38,50,50,0,0.003267640151128357,0.003267640151128357,49,49,0,-1,3,3,10,6,18,70,69
520,144,350,81,96,15,198,198,82,82,0,144,150,81,83,2,0.012491915994417782,0.014874570271282209,71,75,4,3,2,2,10,6,18,77,46
521,12,218,37,95,58,28,32,34,36,2,12,32,37,50,13,0.0011913271384322134,0.004765308553728854,40,53,13,3,4,4,6,3,32,51,35
522,8,624,38,100,62,20,34,34,43,9,8,34,38,52,14,0.0004084550188910446,0.015385139044896015,35,79,44,2,4,3,4,2,84,56,5
523,100,100,72,72,0,100,100,71,71,0,100,100,75,75,0,0.043704687021341775,0.043704687021341775,93,93,0,-1,1,1,6,17,32,6,66
524,44,146,57,89,32,38,38,59,59,0,38,38,62,62,0,0.006875659484665918,0.0141938119064638,62,76,14,4,3,3,3,4,92,72,32
525,20,20,48,48,0,30,30,44,44,0,20,20,48,48,0,0.0014295925661186562,0.0014295925661186562,41,41,0,-1,3,3,4,3,84,43,92
526,80,80,73,73,0,48,48,67,67,0,48,48,70,70,0,0.007352190340038803,0.007352190340038803,61,61,0,-1,3,3,3,6,96,28,69
527,150,766,86,100,14,144,144,90,90,0,144,144,90,90,0,0.015419176963136935,0.021716191837707205,78,85,7,2,2,2,6,8,59,20,48
528,100,716,80,100,20,32,32,64,64,0,32,32,64,64,0,0.017087034956942034,0.03345927363082474,80,94,14,2,3,3,2,18,89,30,37
529,2,618,26,100,74,13,62,28,35,7,2,36,26,49,23,0.0,0.005480104836788182,1,56,55,2,5,3,10,1,1,68,72
530,111,111,77,77,0,180,180,76,76,0,111,111,77,77,0,0.008645631233193778,0.008645631233193778,63,63,0,-1,2,2,11,8,19,44,91
531,454,660,98,100,2,334,334,99,99,0,334,334,99,99,0,0.03812246842983083,0.03897341638585384,95,95,0,3,2,2,11,29,5,0,43
532,0,616,1,99,98,0,86,1,41,40,0,56,1,52,51,0.0,0.007182000748834201,1,55,54,2,-1,3,11,0,5,91,21
533,49,255,56,94,38,80,80,71,71,0,49,80,55,71,16,0.00980292045338507,0.01320671227747711,67,74,7,3,2,2,5,6,49,73,38
534,58,160,62,88,26,54,54,60,60,0,54,54,62,62,0,0.00980292045338507,0.010449640899962559,69,70,1,4,3,3,4,6,78,77,71
535,0,616,1,100,99,0,170,1,66,65,0,170,1,83,82,0.0,0.024234997787535316,1,87,86,2,-1,3,15,0,7,80,1
536,0,0,1,1,0,0,0,1,1,0,0,0,1,1,0,0.0,0.0,1,1,0,-1,-1,-1,14,0,25,92,91
537,136,752,84,100,16,248,248,90,90,0,136,152,84,85,1,0.011675005956635693,0.014534191088873005,71,76,5,2,2,2,11,7,38,62,94
538,40,246,51,91,40,80,80,58,58,0,40,46,51,52,1,0.0035739814152966403,0.0040845501889104465,50,53,3,3,2,2,6,1,41,53,49
539,6,6,29,29,0,32,32,34,34,0,6,6,29,29,0,0.00013615167296368154,0.00013615167296368154,31,31,0,-1,4,4,8,1,10,4,69
540,0,616,1,99,98,0,104,1,54,53,0,34,1,44,43,0.0,0.005480104836788182,1,54,53,2,-1,3,17,0,20,92,38
541,218,1858,91,100,9,156,190,84,93,9,156,190,88,93,5,0.021818305592429966,0.03652268627250757,85,96,11,1,2,2,8,16,10,18,90
542,38,654,53,100,47,68,78,46,48,2,38,78,53,61,8,0.0029612988869600733,0.010041185881071514,51,67,16,2,3,3,8,3,21,54,31
543,122,122,82,82,0,104,104,82,82,0,104,104,82,82,0,0.01494264610776405,0.01494264610776405,77,77,0,-1,2,2,5,8,80,8,96
544,0,206,1,94,93,0,12,1,29,28,0,10,1,36,35,0.0,0.0012594029749140542,1,38,37,3,-1,4,4,0,53,66,54
545,158,364,85,96,11,190,190,93,93,0,158,170,87,90,3,0.010177337554035196,0.011334626774226489,67,70,3,3,2,2,8,6,15,13,74
546,100,100,67,67,0,100,100,57,57,0,100,100,67,67,0,0.04084550188910446,0.046359644644133564,96,97,1,3,1,1,8,19,21,15,20
547,0,1640,1,100,99,0,156,1,65,64,0,156,1,86,85,0.0,0.028557813404132205,1,90,89,1,-1,2,12,0,6,82,7
548,70,70,67,67,0,48,48,59,59,0,48,48,63,63,0,0.006024711528642908,0.006024711528642908,58,58,0,-1,3,3,3,6,75,28,97
549,62,268,55,93,38,170,170,73,73,0,62,95,55,64,9,0.00445896728956057,0.009428503352734947,52,68,16,3,2,2,11,6,33,70,44
550,293,499,97,100,3,72,72,83,83,0,72,72,83,83,0,0.03451444909629327,0.04098165356206814,92,95,3,3,2,2,3,29,58,0,25
551,8,624,34,100,66,40,50,34,35,1,8,50,34,50,16,0.0005105687736138058,0.012287688484972258,33,70,37,2,4,3,8,2,27,63,37
552,132,1732,82,100,18,154,154,72,72,0,132,154,82,85,3,0.013547091459886314,0.039824364341876854,76,94,18,1,2,2,10,8,36,8,1
553,40,40,54,54,0,62,62,77,77,0,40,40,60,60,0,0.008679669151434699,0.008679669151434699,69,69,0,-1,2,2,3,1,75,90,81
554,62,62,61,61,0,54,54,54,54,0,54,54,58,58,0,0.008713707069675619,0.008713707069675619,65,65,0,-1,3,3,4,6,47,34,80
555,0,206,1,92,91,0,14,1,30,29,0,10,1,35,34,0.0,0.002586881786309949,1,46,45,3,-1,4,5,0,70,98,73
556,100,100,60,60,0,100,100,50,50,0,100,100,60,60,0,0.054903162122604585,0.06191497328023418,99,99,0,2,1,1,9,29,28,1,25
557,74,280,70,96,26,44,44,54,54,0,44,44,58,58,0,0.01143674052894925,0.019265461724360937,72,84,12,3,3,3,4,8,77,8,20
558,0,102,1,73,72,0,14,1,26,25,0,2,1,25,24,0.0,0.00013615167296368154,1,29,28,4,-1,5,12,0,6,97,4
559,100,100,63,63,0,100,100,39,39,0,100,100,63,63,0,0.012559991830899623,0.04305796657476429,71,97,26,1,1,1,14,4,17,64,0
560,6,622,31,100,69,14,28,32,44,12,6,28,31,51,20,0.00030634126416828345,0.032029681064706085,31,93,62,2,4,3,3,1,94,65,3
561,186,287,91,96,5,104,104,80,80,0,104,104,81,81,0,0.024200959869294394,0.024269035705776234,88,88,0,6,2,2,5,15,63,16,78
562,0,1640,1,100,99,0,64,1,56,55,0,64,1,63,62,0.0,0.028728002995336805,1,88,87,1,-1,2,5,1,80,45,33
563,267,267,94,94,0,200,200,94,94,0,200,200,94,94,0,0.0298852922155281,0.0298852922155281,87,87,0,-1,2,2,8,15,57,16,98
564,92,92,72,72,0,54,54,55,55,0,54,54,60,60,0,0.012049423057285817,0.012049423057285817,75,75,0,-1,3,3,4,8,73,17,97
565,163,163,94,94,0,56,56,84,84,0,56,56,84,84,0,0.02828551005820484,0.02828551005820484,89,89,0,-1,2,2,2,19,86,15,92
566,22,638,41,100,59,38,56,38,43,5,22,56,41,57,16,0.0009530617107457708,0.016474352428605468,38,80,42,2,3,3,6,2,34,74,16
567,114,216,87,96,9,56,56,88,88,0,56,56,88,88,0,0.020695054290479593,0.025154021580040164,85,87,2,4,2,2,2,9,93,31,57
568,84,185,56,89,33,184,184,78,78,0,84,85,56,56,0,0.009190237925048503,0.009190237925048503,67,67,0,5,2,2,10,5,0,25,68
569,0,0,1,1,0,0,0,1,1,0,0,0,1,1,0,0.0,0.0,1,1,0,-1,-1,-1,7,0,43,86,40
570,62,678,61,100,39,64,64,64,64,0,64,64,67,67,0,0.008713707069675619,0.014398039415909322,65,77,12,2,3,3,4,6,77,34,26
571,64,270,58,93,35,134,134,72,72,0,64,134,58,81,23,0.007352190340038803,0.0141938119064638,62,75,13,3,3,3,9,4,31,72,32
572,166,372,88,97,9,112,112,93,93,0,112,112,93,93,0,0.018040096667687803,0.018312400013615168,83,84,1,3,2,2,4,14,79,14,4
573,6,1646,29,100,71,22,88,30,46,16,6,88,29,66,37,0.0002723033459273631,0.022226760611321013,32,84,52,1,4,2,8,1,39,55,32
574,2,208,27,95,68,5,14,27,31,4,2,14,27,38,11,6.807583648184077e-05,0.005514142755029102,28,55,27,3,5,4,3,1,94,95,31
575,16,222,44,92,48,54,54,55,55,0,16,54,44,59,15,0.0032336022328874367,0.010790020082371761,50,68,18,3,3,3,4,3,84,46,17
576,111,711,78,100,22,164,164,77,77,0,111,164,78,86,8,0.007862759113652609,0.015283025290173252,63,79,16,2,2,2,10,8,36,44,20
577,0,0,1,1,0,0,0,1,1,0,0,0,1,1,0,0.0,0.0,1,1,0,-1,-1,-1,8,0,30,97,59
578,38,244,49,95,46,98,98,52,52,0,38,98,49,67,18,0.003608019333537561,0.012219612648490419,49,71,22,3,3,3,8,6,39,70,33
579,86,292,64,94,30,96,96,60,60,0,86,96,64,68,4,0.00803294870485721,0.014466115252391163,64,79,15,3,3,3,6,6,44,34,27
580,129,129,87,87,0,48,48,72,72,0,48,48,74,74,0,0.014329963579427483,0.014329963579427483,78,78,0,-1,3,3,3,15,60,19,40
581,46,662,62,100,38,22,22,47,47,0,22,22,52,52,0,0.005071649817897137,0.015555328636100617,58,77,19,2,3,3,2,6,89,26,48
582,20,122,48,82,34,30,30,44,44,0,20,30,48,51,3,0.0014295925661186562,0.0020082371762143027,41,45,4,4,3,3,4,3,84,43,51
583,0,206,1,88,87,0,23,1,28,27,0,6,1,27,26,0.0,0.00034037918240920387,1,32,31,3,-1,4,14,0,17,76,88
584,0,102,1,80,79,0,5,1,28,27,0,2,1,27,26,0.0,0.0006126825283365669,1,34,33,4,-1,5,3,0,55,79,71
585,0,616,1,100,99,0,46,1,37,36,0,46,1,50,49,0.0,0.01405766023350012,1,75,74,2,-1,3,6,0,71,80,18
586,362,568,95,100,5,224,224,99,99,0,224,224,99,99,0,0.03104258143571939,0.03366350114027026,90,93,3,3,2,2,8,22,27,9,73
587,100,100,61,61,0,100,100,43,43,0,100,100,61,61,0,0.023520201504475986,0.023520201504475986,84,84,0,-1,1,1,12,5,2,25,96
588,108,108,75,75,0,220,220,85,85,0,108,108,75,75,0,0.007011811157629599,0.007011811157629599,60,60,0,-1,2,2,12,6,3,26,36
589,0,102,1,76,75,0,8,1,28,27,0,4,1,30,29,0.0,0.0004084550188910446,1,34,33,4,-1,5,5,0,70,40,63
590,0,0,1,1,0,0,0,1,1,0,0,0,1,1,0,0.0,0.0,1,1,0,-1,-1,-1,3,0,55,76,80
591,56,262,61,97,36,48,48,59,59,0,48,48,63,63,0,0.006399128629293032,0.009224275843289425,59,69,10,3,3,3,3,6,75,13,41
592,22,638,47,100,53,34,54,44,53,9,22,54,47,57,10,0.0013274788113958951,0.019197385887879097,42,83,41,2,3,3,4,2,47,63,16
593,104,104,78,78,0,70,70,63,63,0,70,70,66,66,0,0.013819394805813677,0.013819394805813677,75,75,0,-1,3,3,5,13,49,33,80
594,40,40,54,54,0,48,48,73,73,0,40,40,74,74,0,0.0061949011198475104,0.0061949011198475104,58,58,0,-1,2,2,3,1,92,88,36
595,0,616,1,100,99,0,54,1,58,57,0,54,1,62,61,0.0,0.018822968787228972,1,83,82,2,-1,3,4,0,77,82,16
596,98,714,69,100,31,96,96,61,61,0,96,96,69,69,0,0.011640968038394772,0.014398039415909322,74,78,4,2,3,3,6,9,48,27,74
597,8,8,36,36,0,10,10,32,32,0,8,8,36,36,0,0.0009190237925048504,0.0009190237925048504,38,38,0,-1,4,4,3,2,60,74,91
598,0,0,1,1,0,0,0,1,1,0,0,0,1,1,0,0.0,0.0,1,1,0,-1,-1,-1,2,0,91,36,79
599,41,657,57,100,43,38,48,47,58,11,38,48,53,62,9,0.004322815616596889,0.020933319718166036,53,88,35,2,3,3,3,6,75,35,16
600,0,616,1,100,99,0,66,1,36,35,0,34,1,47,46,0.0,0.005786446100956465,1,57,56,2,-1,3,10,0,22,87,38
601,0,206,1,96,95,0,8,1,33,32,0,8,1,39,38,0.0,0.0035059055788147996,1,50,49,3,-1,4,2,0,93,67,47
602,22,228,48,93,45,40,40,44,44,0,22,40,48,52,4,0.002552843868069029,0.006126825283365669,46,58,12,3,3,3,5,2,70,83,13
603,0,616,1,100,99,0,44,1,48,47,0,44,1,53,52,0.0,0.016916845365737433,1,79,78,2,-1,3,4,0,53,91,23
604,100,100,80,80,0,100,100,98,98,0,100,100,98,98,0,0.08655842608666053,0.08655842608666053,99,99,0,-1,1,1,2,14,90,32,59
605,0,206,1,89,88,0,52,1,34,33,0,32,1,45,44,0.0,0.005922597773920147,1,55,54,3,-1,4,12,0,3,89,34
606,16,222,35,89,54,62,62,43,43,0,16,25,35,46,11,0.002586881786309949,0.0032336022328874367,47,49,2,3,3,3,7,2,24,94,64
607,104,310,85,98,13,32,32,58,58,0,32,32,59,59,0,0.010347527145239796,0.018176248340651485,71,85,14,3,3,3,2,14,68,32,20
608,86,292,58,97,39,170,170,69,69,0,86,94,58,58,0,0.004016474352428605,0.004765308553728854,54,55,1,3,2,2,12,6,6,70,74
609,322,522,96,99,3,216,216,96,96,0,216,216,96,96,0,0.0313829606181286,0.03682902753667586,91,94,3,3,2,2,9,22,29,9,48
610,218,424,91,98,7,128,128,90,90,0,128,128,90,90,0,0.02042275094455223,0.025154021580040164,84,87,3,3,2,2,5,17,61,6,38
611,6,108,29,75,46,22,22,35,35,0,6,11,29,35,6,0.00034037918240920387,0.0031314884781646754,34,49,15,4,4,4,5,1,61,88,73
612,2,102,26,76,50,8,8,27,27,0,2,2,26,26,0,0.0,6.807583648184077e-05,1,26,25,4,5,5,6,1,56,68,65
613,64,680,58,100,42,140,140,70,70,0,64,140,58,80,22,0.00622893903808843,0.015725518227305217,59,75,16,2,3,3,10,7,12,62,8
614,0,206,1,92,91,0,22,1,33,32,0,22,1,47,46,0.0,0.0035739814152966403,1,50,49,3,-1,4,5,0,70,98,13
615,0,616,1,100,99,0,136,1,66,65,0,136,1,83,82,0.0,0.025358249089485686,1,87,86,2,-1,3,11,0,38,67,1
616,0,616,1,100,99,0,32,1,63,62,0,32,1,63,62,0.0,0.01861874127778345,1,84,83,2,-1,3,2,1,89,45,5
617,12,12,45,45,0,8,8,34,34,0,12,12,45,45,0,0.0007828721195411688,0.0007828721195411688,38,38,0,-1,4,4,2,2,93,74,98
618,115,321,83,99,16,38,38,56,56,0,38,38,59,59,0,0.01756356581231492,0.0283876238129276,83,90,7,3,3,3,3,17,58,6,5
619,112,318,84,98,14,78,78,75,75,0,78,78,76,76,0,0.016270124919159943,0.01872085503250621,80,81,1,3,2,2,4,8,73,8,41
620,98,714,71,100,29,54,54,56,56,0,54,54,57,57,0,0.012730181422104225,0.01929949964260186,71,83,12,2,3,3,4,13,67,33,48
621,100,100,61,61,0,100,100,43,43,0,100,100,61,61,0,0.03281255318424725,0.03434425950508867,91,93,2,3,1,1,12,18,2,30,54
622,6,108,33,86,53,8,8,33,33,0,6,8,33,37,4,0.0004765308553728854,0.0012934408931549745,37,42,5,4,4,4,2,1,90,88,71
623,0,0,1,1,0,0,0,1,1,0,0,0,1,1,0,0.0,0.0,1,1,0,-1,-1,-1,3,0,85,84,99
624,0,206,1,90,89,0,26,1,34,33,0,26,1,47,46,0.0,0.0061949011198475104,1,59,58,3,-1,4,5,0,80,85,77
625,66,682,56,100,44,122,132,60,62,2,64,86,56,59,3,0.0040845501889104465,0.00622893903808843,53,56,3,2,2,2,12,6,3,41,70
626,22,228,50,97,47,28,28,46,46,0,22,28,50,52,2,0.0034037918240920387,0.010994247591817285,51,73,22,3,3,3,3,2,81,75,14
627,0,616,1,100,99,0,116,1,55,54,0,108,1,74,73,0.0,0.011368664692467409,1,70,69,2,-1,3,14,0,16,81,14
628,100,100,72,72,0,100,100,71,71,0,100,100,75,75,0,0.06807583648184078,0.07835528779059872,100,100,0,3,1,1,6,29,32,0,30
629,63,269,66,97,31,38,38,59,59,0,38,38,62,62,0,0.007250076585316042,0.01153885428367201,65,72,7,3,3,3,3,8,92,57,34
630,76,282,70,97,27,38,38,47,47,0,38,38,53,53,0,0.007182000748834201,0.01933353756084278,62,84,22,3,3,3,3,13,75,24,15
631,0,206,1,87,86,0,47,1,33,32,0,6,1,27,26,0.0,0.0015317063208414173,1,42,41,3,-1,4,16,1,9,45,94
632,0,616,1,100,99,0,46,1,47,46,0,46,1,53,52,0.0,0.018006058749446885,1,81,80,2,-1,3,5,0,49,80,16
633,0,616,1,100,99,0,20,1,44,43,0,17,1,46,45,0.0,0.005820484019197386,1,59,58,2,-1,3,3,0,85,89,74
634,64,165,58,87,29,64,64,59,59,0,64,64,63,63,0,0.007113924912352361,0.007182000748834201,60,60,0,5,3,3,4,4,53,72,78
635,0,102,1,82,81,0,6,1,28,27,0,3,1,30,29,0.0,0.0008169100377820892,1,38,37,4,-1,5,3,0,85,79,61
636,38,244,52,95,43,60,60,48,48,0,36,40,52,52,0,0.004016474352428605,0.004901460226692535,52,55,3,3,3,3,5,6,63,41,71
637,111,317,78,96,18,132,132,79,79,0,111,132,79,83,4,0.009326389598012186,0.010313489226998877,69,69,0,3,2,2,8,8,39,44,43
638,150,251,90,97,7,72,72,84,84,0,72,72,84,84,0,0.021750229755948126,0.021784267674189048,86,86,0,5,2,2,3,18,85,5,78
639,46,662,48,100,52,178,198,69,72,3,46,198,48,86,38,0.002314578440382586,0.018210286258892407,44,78,34,2,2,2,14,2,25,61,12
640,190,190,90,90,0,126,126,80,80,0,126,126,83,83,0,0.021137547227611558,0.021137547227611558,82,82,0,-1,2,2,7,16,62,18,79
641,100,201,69,88,19,84,84,46,46,0,84,84,64,64,0,0.01065386840940808,0.010790020082371761,68,68,0,5,3,3,9,14,26,32,55
642,8,110,36,85,49,12,12,36,36,0,8,12,36,36,0,0.0004084550188910446,0.0013274788113958951,35,39,4,4,4,4,2,2,68,56,64
643,138,344,84,96,12,100,100,66,66,0,100,100,72,72,0,0.010041185881071514,0.01245787807617686,68,74,6,3,2,2,6,9,44,31,73
644,100,100,57,57,0,100,100,38,38,0,100,100,57,57,0,0.04663194799006093,0.04663194799006093,98,98,0,-1,1,1,16,29,4,11,87
645,2,2,28,28,0,4,4,28,28,0,2,2,28,28,0,3.4037918240920386e-05,3.4037918240920386e-05,26,26,0,-1,5,5,3,1,55,95,96
646,1,1641,25,100,75,6,54,25,48,23,1,55,25,57,32,3.4037918240920386e-05,0.01960584090677014,28,82,54,1,6,2,6,1,69,78,41
647,135,341,84,98,14,64,64,65,65,0,64,64,67,67,0,0.014908608189523128,0.022396950202525613,78,87,9,3,3,3,4,15,47,19,32
648,0,101,1,74,73,0,7,1,25,24,0,1,1,25,24,0.0,0.0,1,1,0,6,-1,7,7,0,62,85,58
649,42,1682,58,100,42,52,86,78,93,15,42,86,65,93,28,0.00803294870485721,0.055243541305013785,63,98,35,1,2,2,3,2,85,74,23
650,22,22,51,51,0,44,44,53,53,0,22,22,51,51,0,0.004016474352428605,0.004016474352428605,55,55,0,-1,3,3,4,3,78,29,98
651,54,54,59,59,0,54,54,55,55,0,54,54,60,60,0,0.006909697402906838,0.006909697402906838,61,61,0,-1,3,3,4,7,73,62,87
652,30,646,47,100,53,58,88,38,47,9,30,88,47,61,14,0.004356853534837809,0.02042275094455223,54,84,30,2,3,3,8,6,15,73,23
653,2,2,26,26,0,11,11,26,26,0,2,2,26,26,0,0.00013615167296368154,0.00013615167296368154,28,28,0,-1,5,5,10,1,22,78,85
654,74,280,67,96,29,62,62,77,77,0,62,62,78,78,0,0.010041185881071514,0.020967357636406957,66,84,18,3,2,2,3,6,58,26,6
655,44,250,66,100,34,32,32,67,67,0,32,32,68,68,0,0.009224275843289425,0.027808979202831954,68,90,22,3,3,3,2,6,97,34,11
656,16,222,36,93,57,40,40,40,40,0,16,40,36,49,13,0.0011913271384322134,0.006943735321147759,39,57,18,3,3,3,5,1,52,71,44
657,0,616,1,100,99,0,80,1,43,42,0,80,1,61,60,0.0,0.010619830491167161,1,70,69,2,-1,3,9,0,54,92,32
658,0,206,1,93,92,0,18,1,40,39,0,18,1,44,43,0.0,0.005412029000306341,1,53,52,3,-1,4,3,0,60,76,72
659,168,1808,85,100,15,276,310,89,92,3,168,310,85,95,10,0.010415602981721638,0.028523775485891283,67,92,25,1,2,2,14,7,17,21,37
660,0,206,1,88,87,0,50,1,35,34,0,20,1,42,41,0.0,0.004731270635487933,1,53,52,3,-1,4,9,0,54,93,72
661,16,222,34,89,55,106,106,55,55,0,16,22,34,40,6,0.0029612988869600733,0.0037441710065012424,45,50,5,3,3,3,11,2,33,94,71
662,28,1668,49,100,51,72,106,49,73,24,28,106,49,78,29,0.0012253650566731338,0.02467749072466728,40,86,46,1,3,2,7,4,62,64,32
663,22,1662,39,100,61,154,218,65,76,11,22,218,39,89,50,0.0018040096667687805,0.03335715987610198,40,93,53,1,3,2,14,2,17,52,11
664,100,100,61,61,0,100,100,43,43,0,100,100,61,61,0,0.020797168045202357,0.02226079852956193,79,80,1,3,1,1,12,7,2,62,54
665,252,1852,93,100,7,158,158,95,95,0,158,158,95,95,0,0.025154021580040164,0.06416147588413493,87,99,12,1,2,2,6,16,40,18,2
666,56,157,68,90,22,38,38,61,61,0,38,38,63,63,0,0.007147962830593281,0.007182000748834201,65,65,0,6,3,3,3,7,81,21,58
667,0,206,1,91,90,0,20,1,28,27,0,7,1,32,31,0.0,0.0002723033459273631,1,30,29,3,-1,4,9,0,31,85,56
668,100,100,61,61,0,100,100,44,44,0,100,100,61,61,0,0.034140031995643146,0.04145818441744103,91,93,2,2,1,1,12,16,6,12,32
669,66,66,63,63,0,48,48,62,62,0,48,48,64,64,0,0.006705469893461316,0.006705469893461316,61,61,0,-1,3,3,3,6,64,13,87
670,16,222,34,89,55,76,76,39,39,0,16,28,34,42,8,0.0012934408931549745,0.004561081044283332,40,51,11,3,3,3,11,1,33,71,29
671,235,851,93,100,7,158,158,98,98,0,158,158,98,98,0,0.02038871302631131,0.048878450593961675,81,97,16,2,2,2,6,15,74,19,3
672,2,618,28,100,72,7,30,29,45,16,2,30,28,54,26,0.0,0.008271214132543654,1,66,65,2,5,3,4,1,78,95,8
673,0,0,1,1,0,0,0,1,1,0,0,0,1,1,0,0.0,0.0,1,1,0,-1,-1,-1,6,0,71,67,79
674,82,698,72,100,28,32,32,70,70,0,32,32,70,70,0,0.012764219340345145,0.021716191837707205,75,85,10,2,3,3,2,6,95,77,17
675,0,206,1,89,88,0,16,1,29,28,0,8,1,32,31,0.0,0.0025188059498281084,1,39,38,3,-1,4,6,0,71,97,83
676,6,622,29,99,70,36,82,32,38,6,6,63,29,55,26,0.0002723033459273631,0.012117498893767658,32,72,40,2,4,3,12,1,6,65,37
677,49,665,65,100,35,22,32,49,68,19,22,32,53,68,15,0.005786446100956465,0.024064808196330712,60,87,27,2,3,3,2,4,90,22,6
678,56,672,52,100,48,94,104,62,72,10,56,90,53,68,15,0.006671431975220395,0.011334626774226489,57,73,16,2,2,2,5,3,52,29,70
679,84,185,64,90,26,110,110,80,80,0,84,85,63,64,1,0.006875659484665918,0.006875659484665918,63,63,0,5,2,2,6,6,48,28,58
680,106,722,74,100,26,126,126,69,69,0,106,126,75,77,2,0.00970080669866231,0.016099935327955343,69,79,10,2,2,2,7,7,24,48,62
681,226,226,89,89,0,224,224,85,85,0,224,224,89,89,0,0.019946220089179345,0.019946220089179345,84,84,0,-1,2,2,11,18,5,30,86
682,144,1784,82,100,18,176,200,87,93,6,144,200,82,93,11,0.01058579257292624,0.040709350216140784,70,95,25,1,2,2,8,7,15,21,0
683,40,40,51,51,0,80,80,54,54,0,40,40,51,51,0,0.0048674223084516155,0.0048674223084516155,55,55,0,-1,2,2,6,3,48,46,92
684,0,0,1,1,0,0,0,1,1,0,0,0,1,1,0,0.0,0.0,1,1,0,-1,-1,-1,8,0,42,67,91
685,80,696,70,100,30,50,60,47,48,1,50,60,54,58,4,0.007828721195411689,0.01330882603219987,62,75,13,2,3,3,5,13,88,24,83
686,38,38,49,49,0,56,56,44,44,0,38,38,49,49,0,0.0010892133837094523,0.0010892133837094523,40,40,0,-1,3,3,6,4,41,64,91
687,462,462,98,98,0,312,312,98,98,0,312,312,98,98,0,0.037475747983253344,0.037475747983253344,97,97,0,-1,2,2,12,29,2,11,45
688,0,0,1,1,0,0,0,1,1,0,0,0,1,1,0,0.0,0.0,1,1,0,-1,-1,-1,4,0,78,91,93
689,12,628,37,100,63,12,22,32,41,9,12,22,37,44,7,0.0018380475850097008,0.025936893699581333,44,90,46,2,4,3,2,2,91,83,11
690,0,0,1,1,0,0,0,1,1,0,0,0,1,1,0,0.0,0.0,1,1,0,-1,-1,-1,8,0,21,96,97
691,2,208,26,93,67,4,18,26,35,9,2,18,26,44,18,0.0,0.005616256509751864,1,59,58,3,5,4,3,1,82,68,24
692,74,690,57,100,43,206,216,75,82,7,74,122,57,76,19,0.00527587732734266,0.012934408931549747,57,73,16,2,2,2,12,4,14,22,34
693,66,66,64,64,0,32,32,58,58,0,32,32,60,60,0,0.006501242384015794,0.006501242384015794,58,58,0,-1,3,3,2,6,91,28,85
694,0,616,1,100,99,0,44,1,47,46,0,44,1,53,52,0.0,0.007726607440688927,1,64,63,2,-1,3,4,1,83,45,13
695,0,0,1,1,0,0,0,1,1,0,0,0,1,1,0,0.0,0.0,1,1,0,-1,-1,-1,10,0,36,92,76
696,388,588,100,100,0,224,224,99,99,0,224,224,99,99,0,0.03887130263113108,0.046563872153579086,95,96,1,3,2,2,8,27,39,10,33
697,54,54,51,51,0,86,86,63,63,0,54,54,51,51,0,0.007147962830593281,0.007147962830593281,59,59,0,-1,3,3,6,4,56,38,84
698,6,108,33,84,51,12,12,35,35,0,6,12,33,42,9,0.001599782157323258,0.004969536063174376,44,56,12,4,4,4,2,1,86,53,73
699,320,1960,97,100,3,340,364,97,98,1,320,364,97,98,1,0.025392287007726607,0.038224582184553595,87,95,8,1,2,2,15,16,7,18,26
700,54,260,58,95,37,70,70,58,58,0,54,70,59,63,4,0.0068075836481840775,0.007624493685966166,60,64,4,3,3,3,5,4,63,72,64
701,135,751,84,100,16,128,128,90,90,0,128,128,90,90,0,0.01242384015793594,0.025902855781340415,73,89,16,2,2,2,5,8,63,44,18
702,0,616,1,100,99,0,66,1,47,46,0,66,1,58,57,0.0,0.02484768031587188,1,89,88,2,-1,3,6,0,59,81,11
703,68,684,56,100,44,80,90,62,66,4,68,90,59,69,10,0.006399128629293032,0.026073045372545015,54,89,35,2,2,2,6,4,71,72,9
704,296,1896,94,100,6,320,320,95,95,0,296,320,93,95,2,0.024098846114571634,0.052554545763981074,86,99,13,1,2,2,14,20,17,23,3
705,49,49,59,59,0,54,54,62,62,0,49,49,67,67,0,0.004969536063174376,0.004969536063174376,54,54,0,-1,3,3,4,4,72,22,99
706,6,108,33,84,51,12,12,35,35,0,6,12,33,42,9,0.001599782157323258,0.002382654276864427,44,49,5,4,4,4,2,1,86,53,64
707,126,227,86,94,8,96,96,89,89,0,96,96,89,89,0,0.018040096667687803,0.018040096667687803,84,84,0,6,2,2,3,8,64,17,58
708,111,1711,77,100,23,218,218,76,76,0,111,218,77,87,10,0.007454304094761564,0.03087239184451479,61,91,30,1,2,2,14,8,25,57,9
709,208,824,89,100,11,252,252,92,92,0,208,252,89,92,3,0.017495489975833077,0.02757071377514551,79,89,10,2,2,2,11,8,33,20,19
710,0,102,1,70,69,0,16,1,28,27,0,4,1,28,27,0.0,0.000442492937131965,1,36,35,4,-1,5,9,0,28,96,63
711,0,616,1,100,99,0,54,1,52,51,0,54,1,56,55,0.0,0.02365635317743967,1,86,85,2,-1,3,4,0,79,82,7
712,6,212,29,90,61,27,27,30,30,0,6,14,29,33,4,0.0002382654276864427,0.0016338200755641784,31,42,11,3,4,4,12,1,14,65,83
713,120,326,77,95,18,110,110,74,74,0,120,110,78,76,-2,0.013376901868681712,0.013819394805813677,74,74,0,3,2,2,6,6,41,77,63
714,0,616,1,99,98,0,92,1,42,41,0,54,1,52,51,0.0,0.006841621566424997,1,55,54,2,-1,3,11,0,5,86,72
715,70,276,67,97,30,62,62,80,80,0,62,62,80,80,0,0.00789679703189353,0.009054086252084823,61,66,5,3,2,2,3,6,55,26,61
716,0,616,1,100,99,0,110,1,57,56,0,110,1,71,70,0.0,0.023724429013921508,1,87,86,2,-1,3,10,0,0,59,11
717,60,266,58,94,36,74,74,64,64,0,59,74,58,69,11,0.006773545729943157,0.00966676878042139,59,68,9,3,2,2,5,6,88,41,29
718,493,493,99,99,0,208,208,99,99,0,208,208,99,99,0,0.049763436468225605,0.049763436468225605,96,96,0,-1,2,2,7,36,46,2,93
719,100,100,58,58,0,100,100,38,38,0,100,100,58,58,0,0.029544913033118896,0.036658837945471257,91,94,3,2,1,1,16,17,9,6,31
720,391,991,99,100,1,208,208,100,100,0,208,208,100,100,0,0.039449947241226725,0.04836788182034787,95,98,3,2,2,2,7,29,62,11,30
721,74,690,56,100,44,168,168,67,67,0,68,106,54,76,22,0.0053099152455835805,0.011028285510058205,56,67,11,2,2,2,14,6,25,41,34
722,105,721,85,100,15,46,46,81,81,0,46,46,82,82,0,0.019741992579733823,0.03277851526600633,85,92,7,2,2,2,2,12,90,37,39
723,2,618,26,100,74,9,54,26,37,11,2,54,26,52,26,3.4037918240920386e-05,0.006433166547533953,26,60,34,2,5,3,8,1,30,78,31
724,100,100,75,75,0,100,100,89,89,0,100,100,89,89,0,0.03846284761224004,0.04506620375097859,95,96,1,2,1,1,4,2,73,83,72
725,16,222,37,93,56,76,76,52,52,0,16,40,37,50,13,0.0025188059498281084,0.007624493685966166,47,62,15,3,3,3,6,1,65,53,38
726,22,622,47,100,53,28,28,42,42,0,22,28,47,50,3,0.0026889955410327104,0.010313489226998877,50,71,21,2,3,3,3,2,64,75,32
727,343,549,100,100,0,134,134,90,90,0,134,134,90,90,0,0.03567173831648456,0.03795227883862623,96,97,1,3,2,2,6,30,56,7,73
728,0,0,1,1,0,0,0,1,1,0,0,0,1,1,0,0.0,0.0,1,1,0,-1,-1,-1,5,0,88,87,91
729,24,126,52,91,39,18,18,53,53,0,18,18,54,54,0,0.002280540522141666,0.005105687736138058,46,55,9,4,3,3,2,3,97,54,47
730,24,640,50,100,50,28,38,45,50,5,24,38,51,53,2,0.002144388849177984,0.01065386840940808,44,69,25,2,3,3,3,3,94,43,26
731,0,206,1,93,92,0,18,1,34,33,0,18,1,45,44,0.0,0.007556417849484326,1,64,63,3,-1,4,3,0,58,76,8
732,108,314,84,100,16,32,32,70,70,0,32,32,70,70,0,0.015453214881377854,0.027877055039313797,78,90,12,3,3,3,2,14,95,14,18
733,230,430,95,100,5,64,64,68,68,0,64,64,71,71,0,0.03226794649239253,0.03553558664352088,91,93,2,3,3,3,4,29,72,0,31
734,0,102,1,80,79,0,6,1,28,27,0,4,1,31,30,0.0,0.0017359338302869397,1,44,43,4,-1,5,3,0,87,96,75
735,100,100,62,62,0,100,100,45,45,0,100,100,62,62,0,0.029034344259505088,0.03686306545491678,88,93,5,2,1,1,12,18,3,5,20
736,0,0,1,1,0,0,0,1,1,0,0,0,1,1,0,0.0,0.0,1,1,0,-1,-1,-1,3,0,75,82,79
737,0,0,1,1,0,0,0,1,1,0,0,0,1,1,0,0.0,0.0,1,1,0,-1,-1,-1,3,1,76,45,96
738,26,127,49,80,31,78,78,47,47,0,26,27,49,49,0,0.004765308553728854,0.004799346471969774,53,53,0,5,3,3,8,6,30,73,58
739,78,678,71,100,29,48,48,64,64,0,48,48,66,66,0,0.01245787807617686,0.03226794649239253,74,90,16,2,3,3,3,8,85,20,0
740,140,346,81,96,15,150,150,90,90,0,140,150,89,90,1,0.011879233466081215,0.013819394805813677,71,75,4,3,2,2,7,7,62,48,46
741,6,622,30,100,70,23,66,32,50,18,6,66,30,61,31,0.0002042275094455223,0.023315973995030465,31,86,55,2,4,3,6,1,34,65,0
742,101,201,83,94,11,32,32,69,69,0,32,32,69,69,0,0.013989584397018279,0.013989584397018279,79,79,0,6,3,3,2,15,90,19,68
743,77,77,62,62,0,60,60,51,51,0,60,60,57,57,0,0.006943735321147759,0.006943735321147759,61,61,0,-1,3,3,5,8,37,57,87
744,60,676,57,100,43,100,100,55,55,0,60,100,57,68,11,0.0088498587426393,0.011504816365431091,65,69,4,2,3,3,9,9,26,31,46
745,0,0,1,1,0,0,0,1,1,0,0,0,1,1,0,0.0,0.0,1,1,0,-1,-1,-1,8,0,27,40,66
746,22,638,41,100,59,80,80,43,43,0,22,44,41,52,11,0.0027911092957554717,0.006058749446883829,46,59,13,2,3,3,9,2,23,83,29
747,32,32,44,44,0,78,78,45,45,0,32,32,44,44,0,0.0012934408931549745,0.0012934408931549745,41,41,0,-1,3,3,8,2,42,74,96
748,145,351,81,96,15,188,188,83,83,0,145,151,81,82,1,0.009939072126348753,0.01055175465468532,69,70,1,3,2,2,10,8,12,44,42
749,0,1640,1,100,99,0,134,1,65,64,0,134,1,83,82,0.0,0.038564961366962795,1,95,94,1,-1,2,10,0,22,87,2
750,40,40,50,50,0,112,112,73,73,0,40,40,50,50,0,0.00442492937131965,0.00442492937131965,55,55,0,-1,2,2,8,3,39,46,79
751,0,0,1,1,0,0,0,1,1,0,0,0,1,1,0,0.0,0.0,1,1,0,-1,-1,-1,6,0,41,89,66
752,40,656,55,100,45,52,62,76,79,3,40,62,69,79,10,0.004288777698355968,0.02294155689438034,54,88,34,2,2,2,3,1,55,53,6
753,335,335,99,99,0,96,96,92,92,0,96,96,92,92,0,0.05051227066952585,0.05051227066952585,96,96,0,-1,2,2,3,36,96,2,97
754,0,0,1,1,0,0,0,1,1,0,0,0,1,1,0,0.0,0.0,1,1,0,-1,-1,-1,3,0,64,84,66
755,97,97,79,79,0,46,46,84,84,0,46,46,84,84,0,0.017121072875182955,0.017121072875182955,81,81,0,-1,2,2,2,13,93,33,36
756,73,279,70,98,28,22,22,48,48,0,22,22,51,51,0,0.011675005956635693,0.01242384015793594,72,74,2,3,3,3,2,13,95,33,64
757,6,108,30,82,52,12,12,32,32,0,6,12,30,36,6,0.0005105687736138058,0.00088498587426393,35,36,1,4,4,4,2,2,91,42,63
758,156,756,85,100,15,172,172,88,88,0,156,172,86,89,3,0.011606930120153852,0.01929949964260186,71,81,10,2,2,2,9,9,35,27,8
759,2,618,27,99,72,13,146,28,66,38,2,146,27,82,55,0.0,0.032948704857210936,1,92,91,2,5,3,11,2,19,58,2
760,16,222,36,93,57,64,64,39,39,0,16,36,36,47,11,0.0016678579938050988,0.0063650907110521125,43,60,17,3,3,3,9,1,23,53,38
761,1,1,26,26,0,4,4,26,26,0,1,1,26,26,0,0.0,0.0,1,1,0,-1,6,6,4,2,72,58,67
762,0,616,1,100,99,0,34,1,35,34,0,32,1,43,42,0.0,0.004833384390210695,1,51,50,2,-1,3,6,0,71,81,26
763,6,212,33,95,62,12,12,37,37,0,6,12,33,40,7,0.0002042275094455223,0.0024507301133462676,31,46,15,3,4,4,2,1,89,4,94
764,100,100,62,62,0,100,100,45,45,0,100,100,62,62,0,0.029034344259505088,0.029034344259505088,88,88,0,-1,1,1,12,18,3,5,36
765,180,780,90,100,10,120,120,90,90,0,120,120,90,90,0,0.022567139793730217,0.02818339630348208,82,87,5,2,2,2,6,17,69,6,77
766,16,632,32,99,67,102,124,53,58,5,16,84,32,54,22,0.0007828721195411688,0.008441403723748256,37,62,25,2,3,3,17,2,20,42,27
767,156,156,85,85,0,120,120,86,86,0,120,120,86,86,0,0.014364001497668403,0.014364001497668403,76,76,0,-1,2,2,6,13,65,33,82
768,22,638,47,100,53,34,44,43,48,5,22,44,47,54,7,0.0017018959120460194,0.008441403723748256,44,64,20,2,3,3,4,3,79,51,38
769,288,288,97,97,0,288,288,97,97,0,288,288,97,97,0,0.021648116001225366,0.021648116001225366,84,84,0,-1,2,2,12,18,14,5,59
770,0,616,1,100,99,0,24,1,32,31,0,18,1,38,37,0.0,0.004663194799006093,1,52,51,2,-1,3,5,0,50,89,75
771,0,0,1,1,0,0,0,1,1,0,0,0,1,1,0,0.0,0.0,1,1,0,-1,-1,-1,7,0,62,36,93
772,242,242,94,94,0,184,184,94,94,0,184,184,95,95,0,0.025119983661799246,0.025119983661799246,86,86,0,-1,2,2,7,16,24,18,85
773,0,206,1,92,91,0,10,1,31,30,0,10,1,37,36,0.0,0.0032336022328874367,1,51,50,3,-1,4,3,0,64,85,73
774,0,0,1,1,0,0,0,1,1,0,0,0,1,1,0,0.0,0.0,1,1,0,-1,-1,-1,9,0,54,59,81
775,0,206,1,92,91,0,18,1,35,34,0,18,1,46,45,0.0,0.010483678818203479,1,70,69,3,-1,4,3,0,64,89,5
776,0,206,1,85,84,0,27,1,29,28,0,9,1,32,31,0.0,0.0007488342013002485,1,36,35,3,-1,4,12,0,2,87,64
777,266,266,93,93,0,272,272,96,96,0,272,272,96,96,0,0.02651553830967698,0.02651553830967698,88,88,0,-1,2,2,11,16,38,18,80
778,168,768,89,100,11,110,110,80,80,0,110,110,83,83,0,0.013989584397018279,0.027979168794036557,77,89,12,2,2,2,6,14,48,32,12
779,80,286,66,94,28,88,88,73,73,0,88,88,74,74,0,0.007590455767725246,0.010211375472276116,61,69,8,3,2,2,4,6,83,28,29
780,32,648,44,100,56,136,146,63,66,3,32,68,44,55,11,0.0032336022328874367,0.007624493685966166,50,57,7,2,3,3,16,2,9,75,26
781,0,0,1,1,0,0,0,1,1,0,0,0,1,1,0,0.0,0.0,1,1,0,-1,-1,-1,4,1,84,45,82
782,16,222,36,92,56,56,68,38,40,2,16,42,36,51,15,0.0008169100377820892,0.004152626025392287,38,51,13,3,3,3,8,2,30,42,35
783,170,786,87,100,13,86,96,57,66,9,86,96,66,69,3,0.018788930868988054,0.03362946322202934,81,94,13,2,3,3,6,17,65,6,19
784,122,722,86,100,14,56,56,76,76,0,56,56,77,77,0,0.018006058749446885,0.029681064706082574,84,91,7,2,2,2,2,14,68,14,5
785,0,206,1,96,95,0,8,1,32,31,0,8,1,37,36,0.0,0.017291262466387555,1,82,81,3,-1,4,2,1,99,69,0
786,0,0,1,1,0,0,0,1,1,0,0,0,1,1,0,0.0,0.0,1,1,0,-1,-1,-1,3,0,60,79,85
787,44,250,57,99,42,12,12,37,37,0,12,12,42,42,0,0.009360427516253106,0.011300588855985567,68,71,3,3,4,4,2,8,99,8,55
788,94,300,77,98,21,72,72,77,77,0,72,72,79,79,0,0.00966676878042139,0.011266550937744648,70,75,5,3,2,2,3,5,96,47,52
789,40,1680,49,100,51,150,174,70,78,8,40,107,49,77,28,0.004731270635487933,0.018312400013615168,56,79,23,1,2,2,11,3,38,46,31
790,22,22,42,42,0,34,34,39,39,0,22,22,42,42,0,0.0018380475850097008,0.0018380475850097008,44,44,0,-1,3,3,4,2,53,61,67
791,111,727,78,100,22,164,164,77,77,0,111,164,78,86,8,0.007862759113652609,0.02117158514585248,63,86,23,2,2,2,10,8,36,44,37
792,68,684,68,100,32,52,62,78,81,3,52,62,80,81,1,0.011606930120153852,0.02375846693216243,70,87,17,2,2,2,3,4,85,38,32
793,286,492,99,100,1,136,136,97,97,0,136,136,97,97,0,0.046223492971169886,0.05020592940535757,96,96,0,3,2,2,4,27,72,10,57
794,42,144,54,83,29,94,94,48,48,0,40,42,51,54,3,0.003437829742332959,0.0035739814152966403,51,51,0,4,3,3,9,6,28,41,55
795,6,622,29,99,70,36,122,32,61,29,6,122,29,77,48,0.00017018959120460194,0.016712617856291908,30,79,49,2,4,3,12,1,6,60,15
796,100,100,79,79,0,100,100,95,95,0,100,100,95,95,0,0.08386943054562783,0.13067156812689337,98,100,2,1,1,1,3,29,75,0,7
797,2,618,27,100,73,10,44,27,35,8,2,18,27,42,15,0.0,0.003437829742332959,1,50,49,2,5,3,9,1,54,68,90
798,0,102,1,83,82,0,4,1,30,29,0,4,1,32,31,0.0,0.0005446066918547262,1,37,36,4,-1,5,2,0,90,36,43
799,6,212,29,90,61,29,56,31,34,3,6,38,29,47,18,0.0002042275094455223,0.006535280302256714,31,59,28,3,4,4,12,1,3,65,34
800,325,531,99,100,1,96,96,92,92,0,96,96,92,92,0,0.04952517104053916,0.05834099186493754,96,98,2,3,2,2,3,36,81,2,14
801,16,632,42,100,58,38,48,47,58,11,16,48,42,62,20,0.0026889955410327104,0.04190067735457299,48,95,47,2,3,3,3,2,75,94,2
802,16,632,37,100,63,60,70,48,57,9,16,70,37,63,26,0.0030634126416828346,0.011198475101262807,51,70,19,2,3,3,5,2,63,94,44
803,1,1,26,26,0,4,4,26,26,0,1,1,26,26,0,0.0,0.0,1,1,0,-1,6,6,4,2,73,58,36
804,32,238,51,92,41,64,68,41,42,1,32,50,51,57,6,0.002586881786309949,0.005956635692161067,47,59,12,3,3,3,8,2,57,83,35
805,100,100,76,76,0,100,100,96,96,0,100,100,96,96,0,0.08356308928145954,0.1052112052826849,100,100,0,2,1,1,3,22,87,9,0
806,0,616,1,100,99,0,56,1,45,44,0,56,1,57,56,0.0,0.017257224548146634,1,79,78,2,-1,3,6,1,74,45,23
807,0,206,1,91,90,0,46,1,33,32,0,15,1,35,34,0.0,0.002586881786309949,1,46,45,3,-1,4,11,0,38,85,41
808,8,214,40,96,56,8,8,34,34,0,8,8,40,40,0,0.0018040096667687805,0.011743081793117532,43,71,28,3,4,4,2,2,93,61,6
809,67,67,64,64,0,44,44,54,54,0,44,44,58,58,0,0.007522379931243405,0.007522379931243405,63,63,0,-1,3,3,4,8,77,44,89
810,6,212,33,93,60,12,24,34,37,3,6,24,33,50,17,0.0002723033459273631,0.008271214132543654,35,67,32,3,4,4,4,1,72,55,20
811,111,111,78,78,0,132,132,79,79,0,111,111,79,79,0,0.009326389598012186,0.009326389598012186,69,69,0,-1,2,2,8,8,39,44,96
812,100,100,66,66,0,100,100,60,60,0,100,100,68,68,0,0.033221008203138294,0.033221008203138294,90,90,0,-1,1,1,7,8,43,17,87
813,8,8,37,37,0,24,24,38,38,0,8,8,37,37,0,0.000442492937131965,0.000442492937131965,35,35,0,-1,4,4,4,2,73,56,84
814,6,212,30,90,60,15,24,31,33,2,6,12,30,35,5,0.00010211375472276115,0.0016338200755641784,30,42,12,3,4,4,6,1,74,60,94
815,414,2014,99,100,1,320,320,99,99,0,320,320,99,99,0,0.032914666938970015,0.05207801490860819,91,98,7,1,2,2,11,22,38,9,15
816,50,666,60,100,40,54,54,55,55,0,54,54,60,60,0,0.005480104836788182,0.029476837196637053,56,89,33,2,3,3,4,5,84,47,0
817,44,44,54,54,0,48,48,72,72,0,48,48,74,74,0,0.006637394056979475,0.006637394056979475,57,57,0,-1,3,3,3,4,60,38,81
818,62,62,63,63,0,74,74,73,73,0,60,60,60,60,0,0.006433166547533953,0.006433166547533953,59,59,0,-1,2,2,5,6,70,41,91
819,22,22,45,45,0,40,40,41,41,0,22,22,45,45,0,0.0015657442390823377,0.0015657442390823377,40,40,0,-1,3,3,5,2,80,74,86
820,2,208,27,94,67,6,18,30,37,7,2,18,27,46,19,0.00010211375472276115,0.011913271384322134,29,75,46,3,5,4,3,1,81,4,18
821,0,206,1,86,85,0,40,1,33,32,0,19,1,41,40,0.0,0.0030974505599237552,1,47,46,3,-1,4,8,1,27,50,22
822,138,1738,85,100,15,200,200,96,96,0,138,200,85,96,11,0.013819394805813677,0.051669559889717144,76,96,20,1,2,2,8,6,39,77,2
823,38,654,49,100,51,110,120,60,64,4,38,120,49,78,29,0.002314578440382586,0.016202049082678104,47,78,31,2,3,3,10,6,11,70,18
824,98,304,78,99,21,48,48,64,64,0,48,48,66,66,0,0.011334626774226489,0.028217434221723,69,89,20,3,3,3,3,14,85,14,9
825,16,1656,32,100,68,58,198,34,73,39,16,198,32,86,54,0.0004084550188910446,0.03301678069369277,33,94,61,1,3,2,14,1,17,88,3
826,100,100,69,69,0,100,100,71,71,0,100,100,72,72,0,0.034310221586847746,0.07440688927465196,95,100,5,1,1,1,6,9,56,31,3
827,100,100,61,61,0,100,100,43,43,0,100,100,61,61,0,0.020797168045202357,0.020797168045202357,79,79,0,-1,1,1,12,7,2,62,36
828,0,102,1,74,73,0,26,1,27,26,0,4,1,27,26,0.0,0.0002042275094455223,1,31,30,4,-1,5,16,0,4,91,63
829,0,616,1,100,99,0,62,1,42,41,0,62,1,57,56,0.0,0.01678069369277375,1,80,79,2,-1,3,7,0,24,99,23
830,126,1766,80,100,20,196,220,79,85,6,126,194,80,85,5,0.012559991830899623,0.025936893699581333,70,88,18,1,2,2,12,8,2,17,62
831,0,206,1,92,91,0,10,1,28,27,0,6,1,28,27,0.0,0.0009530617107457708,1,37,36,3,-1,4,3,0,82,85,42
832,208,824,88,100,12,326,326,95,95,0,208,266,88,94,6,0.014364001497668403,0.020763130126961436,74,83,9,2,2,2,15,8,7,17,34
833,146,146,83,83,0,96,96,67,67,0,96,96,68,68,0,0.014023622315259198,0.014023622315259198,75,75,0,-1,3,3,6,13,74,33,99
834,100,100,59,59,0,100,100,45,45,0,100,100,59,59,0,0.035875965825930084,0.035875965825930084,92,92,0,-1,1,1,10,16,0,18,67
835,151,351,91,100,9,56,56,80,80,0,56,56,81,81,0,0.027638789611627353,0.02900030634126417,90,91,1,3,2,2,2,15,91,16,41
836,0,0,1,1,0,0,0,1,1,0,0,0,1,1,0,0.0,0.0,1,1,0,-1,-1,-1,6,0,71,92,96
837,0,616,1,100,99,0,146,1,62,61,0,146,1,78,77,0.0,0.019946220089179345,1,83,82,2,-1,3,15,0,7,84,15
838,46,46,60,60,0,38,38,59,59,0,38,38,62,62,0,0.010041185881071514,0.010041185881071514,70,70,0,-1,3,3,3,5,92,25,99
839,32,648,44,100,56,78,88,45,46,1,32,48,44,50,6,0.0012934408931549745,0.005071649817897137,41,55,14,2,3,3,8,2,42,74,90
840,278,478,92,98,6,310,310,93,93,0,278,280,92,92,0,0.016508390346846386,0.017325300384628477,76,77,1,3,2,2,14,14,17,14,52
841,312,414,96,98,2,168,168,96,96,0,168,168,96,96,0,0.03601211749889377,0.03628442084482113,92,92,0,4,2,2,6,22,32,9,63
842,40,246,50,95,45,102,102,66,66,0,40,102,50,76,26,0.004016474352428605,0.012049423057285817,52,71,19,3,2,2,8,2,39,94,14
843,97,1737,63,100,37,102,126,65,76,11,97,126,65,83,18,0.008611593314952858,0.0392457197317812,62,92,30,1,3,2,7,8,46,44,9
844,18,18,44,44,0,62,62,46,46,0,18,18,44,44,0,0.0015657442390823377,0.0015657442390823377,43,43,0,-1,3,3,7,2,62,61,87
845,1,207,26,93,67,2,12,26,35,9,1,12,26,36,10,3.4037918240920386e-05,0.010381565063480718,26,72,46,3,6,4,2,2,68,58,39
846,36,242,53,95,42,28,28,43,43,0,28,28,50,50,0,0.0038462847612240037,0.007284114503556962,52,65,13,3,3,3,3,6,66,41,29
847,0,1640,1,100,99,0,56,1,52,51,0,46,1,53,52,0.0,0.021750229755948126,1,85,84,1,-1,2,5,0,49,85,61
848,0,0,1,1,0,0,0,1,1,0,0,0,1,1,0,0.0,0.0,1,1,0,-1,-1,-1,10,0,18,86,84
849,120,326,80,97,17,188,188,85,85,0,120,188,80,90,10,0.01055175465468532,0.012968446849790666,71,74,3,3,2,2,10,7,36,48,41
850,88,704,71,100,29,48,48,60,60,0,48,48,63,63,0,0.013002484768031588,0.02740052418394091,74,90,16,2,3,3,3,9,58,27,30
851,0,206,1,86,85,0,24,1,29,28,0,6,1,28,27,0.0,0.0002382654276864427,1,32,31,3,-1,4,11,0,5,66,49
852,0,206,1,91,90,0,21,1,32,31,0,6,1,30,29,0.0,0.0020082371762143027,1,44,43,3,-1,4,7,0,62,87,46
853,22,22,38,38,0,38,38,35,35,0,22,22,38,38,0,0.0013274788113958951,0.0013274788113958951,38,38,0,-1,3,3,6,2,51,74,67
854,0,206,1,96,95,0,12,1,36,35,0,12,1,41,40,0.0,0.010381565063480718,1,69,68,3,-1,4,2,0,99,86,33
855,138,138,82,82,0,172,172,73,73,0,138,138,82,82,0,0.010279451308757957,0.010279451308757957,68,68,0,-1,2,2,12,9,2,31,76
856,32,32,51,51,0,70,70,58,58,0,32,32,51,51,0,0.004799346471969774,0.004799346471969774,54,54,0,-1,3,3,5,3,63,29,40
857,0,206,1,87,86,0,56,1,33,32,0,6,1,27,26,0.0,0.00176997174852786,1,43,42,3,-1,4,16,0,9,80,46
858,29,29,51,51,0,50,50,50,50,0,29,29,51,51,0,0.004935498144933456,0.004935498144933456,54,54,0,-1,3,3,5,4,70,22,59
859,16,16,34,34,0,92,92,41,41,0,16,16,34,34,0,0.0026889955410327104,0.0026889955410327104,48,48,0,-1,3,3,12,2,2,94,69
860,160,160,87,87,0,176,176,91,91,0,160,160,90,90,0,0.01596378365499166,0.01596378365499166,78,78,0,-1,2,2,8,8,10,17,82
861,194,294,93,95,2,86,86,62,62,0,86,86,68,68,0,0.018788930868988054,0.020626978453997753,85,86,1,4,3,3,6,19,32,15,73
862,86,1726,58,100,42,170,234,69,88,19,86,234,58,93,35,0.004016474352428605,0.03577385207120733,54,92,38,1,2,2,12,6,6,70,0
863,100,100,72,72,0,100,100,71,71,0,100,100,75,75,0,0.06807583648184078,0.0691310119473093,100,100,0,3,1,1,6,29,32,0,83
864,0,1640,1,100,99,0,52,1,75,74,0,52,1,76,75,0.0,0.04731270635487934,1,97,96,1,-1,2,3,0,55,76,7
865,190,806,85,100,15,214,224,84,86,2,190,215,85,86,1,0.014568229007113924,0.018788930868988054,71,77,6,2,2,2,12,8,2,8,73
866,18,224,40,93,53,62,62,36,36,0,18,24,40,43,3,0.0007488342013002485,0.0013274788113958951,36,41,5,3,3,3,10,2,36,63,42
867,18,634,41,100,59,38,48,38,44,6,18,48,41,54,13,0.000442492937131965,0.007216038667075122,34,63,29,2,3,3,6,2,48,56,24
868,0,102,1,78,77,0,10,1,29,28,0,2,1,27,26,0.0,0.0004084550188910446,1,33,32,4,-1,5,6,1,69,45,42
869,37,243,56,94,38,28,28,44,44,0,28,28,54,54,0,0.005582218591510943,0.011811157629599374,61,73,12,3,3,3,3,6,76,35,57
870,0,616,1,100,99,0,40,1,40,39,0,40,1,52,51,0.0,0.011266550937744648,1,72,71,2,-1,3,5,0,80,36,19
871,16,1656,32,100,68,48,168,33,67,34,16,168,32,86,54,0.0002723033459273631,0.027128220838013545,31,90,59,1,3,2,14,1,8,95,10
872,2,2,28,28,0,7,7,28,28,0,2,2,28,28,0,0.0,0.0,1,1,0,-1,5,5,6,1,32,68,92
873,0,1640,1,100,99,0,92,1,49,48,0,92,1,66,65,0.0,0.025936893699581333,1,88,87,1,-1,2,8,0,30,96,18
874,100,201,66,91,25,130,130,85,85,0,98,99,68,68,0,0.008645631233193778,0.008645631233193778,66,66,0,6,2,2,7,6,62,41,58
875,6,622,27,100,73,11,38,27,34,7,6,38,27,44,17,0.00013615167296368154,0.008986010415602982,28,67,39,2,4,3,6,1,51,68,77
876,36,242,50,91,41,78,78,44,44,0,36,78,50,57,7,0.004561081044283332,0.013785356887572755,54,75,21,3,3,3,8,6,10,73,14
877,24,640,45,100,55,40,50,40,45,5,24,50,45,52,7,0.001157289220191293,0.020899281799925118,39,83,44,2,3,3,5,4,50,64,16
878,224,430,95,100,5,56,56,85,85,0,56,56,85,85,0,0.04098165356206814,0.05902175022975595,95,98,3,3,2,2,2,27,90,10,1
879,0,206,1,90,89,0,58,1,32,31,0,8,1,33,32,0.0,0.003267640151128357,1,47,46,3,-1,4,13,0,13,59,29
880,0,0,1,1,0,0,0,1,1,0,0,0,1,1,0,0.0,0.0,1,1,0,-1,-1,-1,5,0,61,97,96
881,16,222,42,93,51,22,22,42,42,0,16,22,42,45,3,0.002484768031587188,0.013751318969331836,49,77,28,3,3,3,2,3,68,46,18
882,100,100,59,59,0,100,100,40,40,0,100,100,59,59,0,0.0631063004186664,0.0631063004186664,100,100,0,-1,1,1,15,36,7,2,81
883,2,208,26,89,63,10,25,26,29,3,2,8,26,31,5,0.0,0.0016338200755641784,1,39,38,3,5,4,9,2,29,58,94
884,100,100,69,69,0,100,100,71,71,0,100,100,72,72,0,0.024473263215221756,0.02910242009598693,88,89,1,3,1,1,6,1,56,95,26
885,0,0,1,1,0,0,0,1,1,0,0,0,1,1,0,0.0,0.0,1,1,0,-1,-1,-1,5,0,63,89,98
886,284,900,97,100,3,134,134,90,90,0,134,134,90,90,0,0.030497974743864665,0.03904149222233568,90,97,7,2,2,2,6,22,56,9,32
887,36,1676,48,100,52,62,100,48,62,14,36,100,48,67,19,0.003948398515946765,0.039279757650022125,53,94,41,1,3,2,6,6,41,73,7
888,38,654,51,100,49,56,76,46,56,10,38,76,51,60,9,0.0030293747234419145,0.017121072875182955,49,79,30,2,3,3,6,6,74,70,15
889,0,616,1,100,99,0,36,1,39,38,0,36,1,50,49,0.0,0.004595118962524252,1,52,51,2,-1,3,5,1,37,45,26
890,0,206,1,92,91,0,24,1,32,31,0,32,1,48,47,0.0,0.0040845501889104465,1,50,49,3,-1,4,6,1,65,50,13
891,126,126,80,80,0,136,136,81,81,0,126,126,84,84,0,0.013138636440995268,0.013138636440995268,77,77,0,-1,2,2,7,8,46,17,67
892,46,662,48,100,52,178,178,69,69,0,46,64,48,53,5,0.002314578440382586,0.003267640151128357,44,49,5,2,2,2,14,2,25,61,56
893,40,142,54,89,35,28,28,44,44,0,28,28,51,51,0,0.005446066918547262,0.006909697402906838,54,63,9,4,3,3,3,6,92,26,75
894,244,860,94,100,6,144,144,92,92,0,144,144,92,92,0,0.026753803737363423,0.0315531502093332,89,89,0,2,2,2,6,15,48,16,57
895,0,206,1,92,91,0,42,1,36,35,0,42,1,49,48,0.0,0.011879233466081215,1,74,73,3,-1,4,7,0,46,59,18
896,0,102,1,83,82,0,4,1,28,27,0,3,1,30,29,0.0,0.0008169100377820892,1,36,35,4,-1,5,2,0,99,36,74
897,300,506,95,99,4,192,192,87,87,0,192,192,88,88,0,0.02811532046700024,0.029340685523673374,87,88,1,3,2,2,9,22,54,9,83
898,8,214,41,97,56,12,12,39,39,0,8,12,41,43,2,0.001599782157323258,0.008509479560230097,43,67,24,3,4,4,2,2,97,61,77
899,202,202,89,89,0,144,144,88,88,0,144,144,88,88,0,0.021409850573538922,0.021409850573538922,84,84,0,-1,2,2,6,18,44,5,76
900,0,0,1,1,0,0,0,1,1,0,0,0,1,1,0,0.0,0.0,1,1,0,-1,-1,-1,6,0,69,93,91
901,16,16,32,32,0,46,46,31,31,0,16,16,32,32,0,0.0002723033459273631,0.0002723033459273631,31,31,0,-1,3,3,14,1,8,65,93
902,16,16,43,43,0,28,28,46,46,0,16,16,43,43,0,0.003165526396405596,0.003165526396405596,49,49,0,-1,3,3,3,3,81,46,99
903,0,616,1,100,99,0,74,1,44,43,0,74,1,56,55,0.0,0.022396950202525613,1,86,85,2,-1,3,9,0,35,89,7
904,90,90,71,71,0,64,64,63,63,0,64,64,64,64,0,0.009939072126348753,0.009939072126348753,70,70,0,-1,3,3,4,9,79,31,81
905,100,100,66,66,0,100,100,43,43,0,100,100,66,66,0,0.024507301133462677,0.024507301133462677,87,87,0,-1,1,1,11,9,33,31,76
906,12,628,36,100,64,18,28,38,42,4,12,28,36,49,13,0.0009870996289866913,0.0141938119064638,39,78,39,2,4,3,3,2,96,74,12
907,60,60,58,58,0,74,74,64,64,0,59,59,58,58,0,0.006773545729943157,0.006773545729943157,59,59,0,-1,2,2,5,6,88,41,96
908,289,389,97,99,2,112,112,96,96,0,112,112,96,96,0,0.03553558664352088,0.039109568058817525,93,93,0,4,2,2,4,29,77,0,31
909,209,415,91,100,9,112,112,93,93,0,112,112,93,93,0,0.028523775485891283,0.029578950951359814,88,88,0,3,2,2,4,15,79,16,51
910,100,100,64,64,0,100,100,49,49,0,100,100,64,64,0,0.03819054426631267,0.06062153238707921,92,99,7,1,1,1,8,15,42,19,16
911,16,632,36,100,64,40,50,42,48,6,16,50,36,54,18,0.001055175465468532,0.015317063208414174,39,79,40,2,3,3,5,2,61,42,6
912,276,482,98,100,2,72,72,87,87,0,72,72,87,87,0,0.04084550188910446,0.043364307838932574,94,95,1,3,2,2,3,29,55,1,41
913,28,1668,52,100,48,28,62,42,73,31,28,62,51,74,23,0.002314578440382586,0.04915075393988903,48,97,49,1,3,2,3,6,64,70,12
914,0,616,1,100,99,0,80,1,40,39,0,80,1,56,55,0.0,0.01055175465468532,1,68,67,2,-1,3,10,0,18,81,19
915,40,656,50,100,50,57,72,43,48,5,40,60,50,53,3,0.004186663943633207,0.006977773239388679,53,57,4,2,2,2,6,1,40,55,43
916,0,206,1,93,92,0,10,1,30,29,0,10,1,40,39,0.0,0.006433166547533953,1,61,60,3,-1,4,3,0,92,96,27
917,190,806,92,100,8,104,104,80,80,0,104,104,81,81,0,0.021920419347152727,0.03114469519044215,85,90,5,2,2,2,5,16,63,12,17
918,22,1662,43,100,57,98,132,41,60,19,22,63,43,54,11,0.0025188059498281084,0.010075223799312433,45,67,22,1,3,2,13,2,13,83,56
919,100,100,59,59,0,100,100,40,40,0,100,100,59,59,0,0.04431736954967834,0.06426358963885768,98,100,2,1,1,1,15,27,7,10,16
920,157,363,91,100,9,56,56,85,85,0,56,56,85,85,0,0.026855917492086184,0.032540249838319886,88,92,4,3,2,2,2,15,90,16,24
921,28,129,50,88,38,28,28,43,43,0,28,28,50,50,0,0.0020422750944552232,0.0020763130126961434,46,47,1,5,3,3,3,3,66,54,78
922,112,318,78,95,17,222,222,77,77,0,112,118,78,79,1,0.008135062459579971,0.008271214132543654,63,63,0,3,2,2,14,7,25,62,65
923,16,117,35,77,42,88,88,48,48,0,16,17,35,40,5,0.003165526396405596,0.003199564314646516,49,50,1,5,3,3,8,1,15,90,58
924,0,206,1,93,92,0,30,1,39,38,0,30,1,51,50,0.0,0.007828721195411689,1,63,62,3,-1,4,5,0,49,89,27
925,186,802,87,100,13,152,152,76,76,0,152,152,85,85,0,0.013819394805813677,0.015623404472582456,76,79,3,2,2,2,8,14,15,14,43
926,237,443,91,99,8,232,232,91,91,0,232,232,93,93,0,0.026004969536063176,0.026753803737363423,90,90,0,3,2,2,10,20,22,23,74
927,12,218,39,93,54,20,24,35,37,2,12,24,39,49,10,0.0009530617107457708,0.004765308553728854,39,54,15,3,4,4,4,2,73,74,47
928,6,107,29,76,47,19,19,29,29,0,6,7,29,34,5,0.0002382654276864427,0.0002382654276864427,33,33,0,5,4,4,8,1,15,55,68
929,0,206,1,91,90,0,18,1,31,30,0,14,1,35,34,0.0,0.002757071377514551,1,48,47,3,-1,4,5,0,52,81,73
930,118,318,81,99,18,78,78,77,77,0,78,78,77,77,0,0.015623404472582456,0.022328874366043774,79,83,4,3,2,2,4,13,84,33,17
931,0,0,1,1,0,0,0,1,1,0,0,0,1,1,0,0.0,0.0,1,1,0,-1,-1,-1,5,0,88,85,96
932,38,38,53,53,0,88,88,52,52,0,38,38,53,53,0,0.0028932230504782326,0.0028932230504782326,50,50,0,-1,3,3,8,6,21,70,69
933,16,632,41,100,59,30,44,42,47,5,16,44,41,53,12,0.0004765308553728854,0.007352190340038803,36,60,24,2,3,3,4,1,83,4,44
934,405,505,98,99,1,190,190,91,91,0,190,190,91,91,0,0.036590762108989414,0.03672691378195309,96,96,0,4,2,2,8,29,27,1,49
935,0,616,1,100,99,0,110,1,60,59,0,110,1,78,77,0.0,0.022533101875489295,1,84,83,2,-1,3,10,0,1,59,10
936,80,286,73,98,25,48,48,67,67,0,48,48,70,70,0,0.007352190340038803,0.010926171755335444,61,74,13,3,3,3,3,6,96,28,73
937,126,126,77,77,0,104,104,73,73,0,104,104,79,79,0,0.013819394805813677,0.013819394805813677,78,78,0,-1,2,2,5,8,52,17,97
938,2,618,27,100,73,6,38,29,55,26,2,38,27,58,31,0.0002042275094455223,0.02403077027808979,32,87,55,2,5,3,3,1,58,60,10
939,88,88,57,57,0,214,214,74,74,0,88,88,57,57,0,0.007624493685966166,0.007624493685966166,60,60,0,-1,2,2,15,7,7,62,92
940,0,0,1,1,0,0,0,1,1,0,0,0,1,1,0,0.0,0.0,1,1,0,-1,-1,-1,9,0,26,67,45
941,80,286,73,100,27,22,22,54,54,0,22,22,54,54,0,0.010892133837094524,0.025051907825317403,70,90,20,3,3,3,2,14,99,14,18
942,0,0,1,1,0,0,0,1,1,0,0,0,1,1,0,0.0,0.0,1,1,0,-1,-1,-1,17,0,20,86,91
943,227,433,87,96,9,240,240,88,88,0,240,240,90,90,0,0.024064808196330712,0.024575376969944517,85,86,1,3,2,2,12,20,2,23,49
944,1,207,26,93,67,3,18,26,39,13,1,18,26,45,19,3.4037918240920386e-05,0.005480104836788182,26,57,31,3,6,4,3,2,55,58,25
945,2,2,27,27,0,13,13,27,27,0,2,2,27,27,0,0.00013615167296368154,0.00013615167296368154,29,29,0,-1,5,5,11,1,38,78,79
946,102,308,73,94,21,166,166,83,83,0,102,108,73,75,2,0.009462541270975866,0.010143299635794275,68,70,2,3,2,2,8,7,42,62,49
947,0,102,1,84,83,0,4,1,28,27,0,4,1,31,30,0.0,0.001055175465468532,1,38,37,4,-1,5,2,0,98,81,54
948,0,0,1,1,0,0,0,1,1,0,0,0,1,1,0,0.0,0.0,1,1,0,-1,-1,-1,6,0,71,66,59
949,0,206,1,95,94,0,14,1,31,30,0,14,1,38,37,0.0,0.006092787365124749,1,58,57,3,-1,4,3,0,94,93,24
950,0,616,1,100,99,0,56,1,40,39,0,56,1,51,50,0.0,0.017087034956942034,1,80,79,2,-1,3,6,1,71,50,16
951,0,616,1,99,98,0,92,1,41,40,0,67,1,55,54,0.0,0.005684332346233704,1,58,57,2,-1,3,11,0,19,79,57
952,183,799,87,100,13,222,232,92,94,2,183,232,86,94,8,0.02038871302631131,0.03669287586371218,82,94,12,2,2,2,10,12,12,37,6
953,2,618,28,100,72,12,58,30,43,13,2,58,28,56,28,0.00017018959120460194,0.019571802988529223,31,83,52,2,5,3,7,1,62,55,37
954,16,1656,35,100,65,100,154,45,66,21,16,154,35,83,48,0.0033357159876101976,0.041253956907995507,50,95,45,1,3,2,10,3,18,46,2
955,230,436,95,100,5,168,168,97,97,0,168,168,97,97,0,0.026004969536063176,0.028693965077095884,89,91,2,3,2,2,6,18,59,30,22
956,0,206,1,86,85,0,34,1,31,30,0,12,1,33,32,0.0,0.0002723033459273631,1,32,31,3,-1,4,11,0,5,66,56
957,118,118,82,82,0,110,110,81,81,0,110,110,85,85,0,0.01330882603219987,0.01330882603219987,76,76,0,-1,2,2,6,9,32,27,67
958,22,638,50,100,50,22,32,55,66,11,22,32,57,67,10,0.004356853534837809,0.018925082541951733,52,83,31,2,3,3,2,3,97,29,32
959,16,16,33,33,0,94,94,37,37,0,16,16,33,33,0,0.0007147962830593281,0.0007147962830593281,36,36,0,-1,3,3,16,2,4,42,79
960,22,228,45,91,46,38,42,39,39,0,22,28,45,48,3,0.0013615167296368155,0.0017359338302869397,40,43,3,3,3,3,6,3,74,51,4
961,6,212,30,90,60,15,28,31,35,4,6,26,30,47,17,0.00010211375472276115,0.005037611899656217,30,55,25,3,4,4,6,1,74,60,38
962,122,122,85,85,0,72,72,84,84,0,72,72,84,84,0,0.018925082541951733,0.018925082541951733,81,81,0,-1,2,2,3,15,81,19,40
963,0,616,1,100,99,0,46,1,41,40,0,46,1,53,52,0.0,0.009258313761530345,1,67,66,2,-1,3,6,0,48,79,33
964,70,276,67,96,29,54,54,55,55,0,54,54,60,60,0,0.006399128629293032,0.008305252050784574,59,65,6,3,3,3,4,6,84,26,54
965,118,718,78,100,22,194,194,78,78,0,118,133,78,80,2,0.007216038667075122,0.012934408931549747,61,74,13,2,2,2,11,5,19,47,25
966,100,100,77,77,0,100,100,97,97,0,100,100,97,97,0,0.04969536063174376,0.054903162122604585,97,98,1,3,1,1,3,1,55,78,25
967,66,682,55,100,45,76,76,55,55,0,66,82,55,65,10,0.006126825283365669,0.008271214132543654,53,61,8,2,3,3,6,6,71,28,53
968,2,2,27,27,0,7,7,27,27,0,2,2,27,27,0,3.4037918240920386e-05,3.4037918240920386e-05,26,26,0,-1,5,5,6,1,74,68,84
969,245,347,97,100,3,56,56,85,85,0,56,56,85,85,0,0.04322815616596889,0.04853807141155247,96,98,2,4,2,2,2,29,90,0,8
970,16,632,42,100,58,26,54,42,52,10,16,54,42,56,14,0.0004765308553728854,0.022669253548452978,35,85,50,2,3,3,4,1,79,4,7
971,0,102,1,81,80,0,5,1,27,26,0,2,1,27,26,0.0,0.000442492937131965,1,35,34,4,-1,5,3,1,96,50,42
972,24,640,43,100,57,30,44,38,43,5,24,44,43,49,6,0.0016338200755641784,0.031178733108683073,38,91,53,2,3,3,4,3,67,43,2
973,6,1646,28,100,72,27,106,28,57,29,6,106,28,77,49,0.00030634126416828345,0.023315973995030465,31,87,56,1,4,2,10,1,36,60,12
974,80,80,69,69,0,38,38,53,53,0,38,38,55,55,0,0.009122162088566664,0.009122162088566664,69,69,0,-1,3,3,3,9,64,31,67
975,100,100,59,59,0,100,100,40,40,0,100,100,59,59,0,0.037509785901494265,0.03917764389529936,94,95,1,3,1,1,15,22,7,9,75
976,548,1148,99,100,1,304,304,98,98,0,304,304,98,98,0,0.04996766397767113,0.06171074577078866,97,100,3,2,2,2,10,36,12,2,6
977,40,142,49,84,35,45,48,37,39,2,40,43,49,50,1,0.003437829742332959,0.003642057251778481,44,47,3,4,2,2,6,1,71,68,56
978,62,1702,52,100,48,154,188,66,79,13,62,188,52,90,38,0.003778208924742163,0.033935804486197624,51,91,40,1,2,2,10,6,0,70,7
979,128,128,81,81,0,134,134,91,91,0,128,128,91,91,0,0.015521290717859695,0.015521290717859695,78,78,0,-1,2,2,6,6,71,41,59
980,42,42,52,52,0,112,112,63,63,0,42,42,52,52,0,0.003165526396405596,0.003165526396405596,49,49,0,-1,2,2,8,2,15,61,93
981,6,212,31,92,61,10,18,32,37,5,6,18,31,46,15,0.00034037918240920387,0.012900371013308825,33,76,43,3,4,4,3,1,85,4,15
982,32,32,44,44,0,138,138,61,61,0,32,32,44,44,0,0.002927260968719153,0.002927260968719153,50,50,0,-1,3,3,17,2,20,75,98
983,8,110,36,80,44,26,26,36,36,0,8,12,36,36,0,0.0005105687736138058,0.001497668402600497,35,41,6,4,4,4,5,2,45,56,51
984,8,110,40,86,46,12,12,39,39,0,8,12,40,44,4,0.0018380475850097008,0.002144388849177984,44,44,0,4,4,4,2,2,93,83,4
985,16,222,34,86,52,40,40,32,32,0,16,16,34,34,0,0.00034037918240920387,0.0006126825283365669,32,36,4,3,3,3,12,1,2,60,65
986,1,1,25,25,0,5,5,25,25,0,1,1,25,25,0,3.4037918240920386e-05,3.4037918240920386e-05,26,26,0,-1,6,6,5,1,45,68,91
987,100,100,66,66,0,100,100,49,49,0,100,100,66,66,0,0.03618230709009837,0.041049729398549985,94,96,2,2,1,1,9,16,54,18,21
988,108,108,72,72,0,70,70,51,51,0,70,70,57,57,0,0.013547091459886314,0.013547091459886314,77,77,0,-1,3,3,5,9,52,39,99
989,60,60,65,65,0,48,48,70,70,0,48,48,72,72,0,0.005548180673270023,0.005548180673270023,55,55,0,-1,3,3,3,5,94,47,85
990,396,602,100,100,0,144,144,91,91,0,144,144,91,91,0,0.04394295244902822,0.046359644644133564,97,97,0,3,2,2,6,40,74,3,75
991,112,312,81,96,15,38,38,53,53,0,38,38,55,55,0,0.012083460975526737,0.016610504101569147,74,82,8,3,3,3,3,14,64,14,44
992,122,122,85,85,0,72,72,80,80,0,72,72,80,80,0,0.017495489975833077,0.017495489975833077,82,82,0,-1,2,2,3,8,76,8,92
993,60,60,65,65,0,38,38,57,57,0,38,38,60,60,0,0.005718370264474625,0.005718370264474625,59,59,0,-1,3,3,3,6,85,26,93
994,12,218,41,94,53,20,24,37,37,0,12,20,41,45,4,0.002382654276864427,0.003982436434187685,48,52,4,3,4,4,4,2,72,75,52
995,16,16,42,42,0,28,28,43,43,0,16,16,42,42,0,0.0026889955410327104,0.0026889955410327104,47,47,0,-1,3,3,3,2,96,94,36
996,156,156,88,88,0,94,94,78,78,0,94,94,78,78,0,0.018108172504169646,0.018108172504169646,83,83,0,-1,2,2,5,14,45,14,69
997,272,272,98,98,0,72,72,86,86,0,72,72,86,86,0,0.041049729398549985,0.041049729398549985,93,93,0,-1,2,2,3,30,92,7,67
998,22,638,43,100,57,54,98,39,54,15,22,98,43,66,23,0.0013955546478777359,0.0265495762279179,42,88,46,2,3,3,8,3,21,51,7
999,100,100,59,59,0,100,100,40,40,0,100,100,59,59,0,0.04431736954967834,0.04431736954967834,98,98,0,-1,1,1,15,27,7,10,45
