,FreeNet_pre_score,FreeNet_post_score,FreeNet_pre_rank,FreeNet_post_rank,FreeNet_delta_ranks,Reversed_pre_score,Reversed_post_score,Reversed_pre_rank,Reversed_post_rank,Reversed_delta_ranks,Independent_pre_score,Independent_post_score,Independent_pre_rank,Independent_post_rank,Independent_delta_ranks,Random_pre_score,Random_post_score,Random_pre_rank,Random_post_rank,Random_delta_ranks,dist_victim_relayer,dist_victim_vilain_pre,dist_victim_vilain_post,out_deg_victim,in_deg_villain,victim,villain,relayer
0,76,282,67,96,29,64,64,65,65,0,64,64,67,67,0,0.006977773239388679,0.01058579257292624,62,71,9,3,3,3,4,6,47,13,28
1,100,100,76,76,0,100,100,96,96,0,100,100,96,96,0,0.05589026175159127,0.056979475135300724,98,98,0,4,1,1,3,6,58,35,64
2,100,100,63,63,0,100,100,45,45,0,100,100,63,63,0,0.020456788862793153,0.022465026039007456,81,84,3,2,1,1,11,7,19,62,53
3,16,16,34,34,0,28,28,34,34,0,16,16,34,34,0,0.0006467204465774873,0.0006467204465774873,35,35,0,-1,3,3,5,1,50,88,45
4,100,100,59,59,0,100,100,39,39,0,100,100,59,59,0,0.014738418598318526,0.014738418598318526,76,76,0,-1,1,1,14,4,16,22,97
5,39,1679,54,100,46,76,100,54,70,16,39,100,54,74,20,0.0042547397801150485,0.03863303720344464,53,93,40,1,3,2,6,4,32,22,11
6,100,100,79,79,0,100,100,95,95,0,100,100,95,95,0,0.08958780081010245,0.09054086252084823,100,100,0,3,1,1,3,30,75,7,54
7,190,806,91,100,9,150,150,85,85,0,150,150,89,89,0,0.01501072194424589,0.030804316008032948,78,90,12,2,2,2,7,14,46,14,16
8,193,193,92,92,0,200,200,81,81,0,200,200,92,92,0,0.02236291228428469,0.02236291228428469,85,85,0,-1,2,2,11,16,19,18,97
9,186,786,92,100,8,104,104,86,86,0,104,104,87,87,0,0.024881718234112803,0.03359542530378842,88,92,4,2,2,2,5,17,49,6,20
10,16,222,34,90,56,112,112,59,59,0,16,64,34,55,21,0.0037441710065012424,0.009258313761530345,52,69,17,3,3,3,12,1,3,90,24
11,0,206,1,90,89,0,20,1,32,31,0,19,1,42,41,0.0,0.003369753905851118,1,48,47,3,-1,4,6,1,48,50,35
12,76,276,69,97,28,38,38,57,57,0,38,38,59,59,0,0.008101024541339052,0.011640968038394772,62,73,11,3,3,3,3,13,55,24,22
13,54,670,53,100,47,160,160,76,76,0,54,160,53,83,30,0.007284114503556962,0.024234997787535316,62,84,22,2,3,3,10,4,12,72,23
14,6,212,33,96,63,14,14,33,33,0,6,14,33,40,7,0.0006467204465774873,0.008305252050784574,36,66,30,3,4,4,3,2,75,42,14
15,76,76,62,62,0,64,64,59,59,0,64,64,63,63,0,0.00803294870485721,0.00803294870485721,66,66,0,-1,3,3,4,7,53,21,96
16,40,246,55,93,38,62,62,75,75,0,40,62,63,76,13,0.006943735321147759,0.013070560604513427,63,77,14,3,2,2,3,3,82,46,32
17,0,206,1,96,95,0,12,1,36,35,0,12,1,41,40,0.0,0.005922597773920147,1,61,60,3,-1,4,2,0,99,40,25
18,46,252,50,94,44,50,54,55,55,0,46,54,55,56,1,0.007216038667075122,0.02464345280642636,60,88,28,3,2,2,4,2,67,42,1
19,8,214,35,90,55,24,32,34,36,2,8,14,35,36,1,0.0002382654276864427,0.002314578440382586,34,47,13,3,4,4,6,2,74,63,90
20,120,736,81,100,19,118,118,91,91,0,118,118,91,91,0,0.01320671227747711,0.015725518227305217,75,78,3,2,2,2,5,7,80,48,43
21,6,6,32,32,0,8,8,32,32,0,6,6,32,32,0,0.0004084550188910446,0.0004084550188910446,35,35,0,-1,4,4,2,1,98,88,36
22,22,638,47,100,53,28,38,42,52,10,22,38,47,54,7,0.000442492937131965,0.010041185881071514,35,71,36,2,3,3,3,2,64,63,32
23,132,132,80,80,0,86,86,56,56,0,86,86,66,66,0,0.013887470642295518,0.013887470642295518,76,76,0,-1,3,3,6,13,59,33,86
24,16,222,37,90,53,30,34,35,35,0,16,24,37,44,7,0.0006467204465774873,0.0020763130126961434,36,43,7,3,3,3,6,1,48,88,51
25,40,40,47,47,0,64,64,40,40,0,40,40,47,47,0,0.004050512270669526,0.004050512270669526,49,49,0,-1,3,3,8,6,27,73,69
26,0,206,1,92,91,0,14,1,28,27,0,6,1,28,27,0.0,0.000442492937131965,1,33,32,3,-1,4,6,1,59,45,4
27,197,397,91,99,8,88,88,80,80,0,88,88,81,81,0,0.02631131080023146,0.03192756730998332,88,91,3,3,2,2,4,19,77,15,8
28,52,258,65,99,34,12,12,37,37,0,12,12,42,42,0,0.007794683277170768,0.010755982164130842,66,69,3,3,4,4,2,13,99,24,47
29,100,100,58,58,0,100,100,38,38,0,100,100,58,58,0,0.04435140746791926,0.04435140746791926,96,96,0,-1,1,1,16,27,9,10,97
30,0,206,1,93,92,0,20,1,34,33,0,20,1,47,46,0.0,0.00445896728956057,1,54,53,3,-1,4,4,0,73,80,28
31,218,320,97,100,3,48,48,70,70,0,48,48,72,72,0,0.02923857176895061,0.03134892269988768,93,94,1,4,3,3,3,29,94,1,75
32,40,656,49,100,51,156,156,68,68,0,40,156,49,86,37,0.002825147213996392,0.024269035705776234,48,88,40,2,2,2,12,1,14,53,10
33,6,622,32,100,68,22,36,33,41,8,6,35,32,49,17,0.0010892133837094523,0.006501242384015794,39,56,17,2,4,3,5,1,45,71,22
34,222,838,89,100,11,294,314,86,88,2,222,288,89,96,7,0.009973110044589673,0.01841451376833793,66,82,16,2,2,2,17,13,20,24,77
35,140,140,84,84,0,198,198,86,86,0,140,140,84,84,0,0.01330882603219987,0.01330882603219987,75,75,0,-1,2,2,10,8,1,17,69
36,0,0,1,1,0,0,0,1,1,0,0,0,1,1,0,0.0,0.0,1,1,0,-1,-1,-1,2,1,89,45,99
37,207,207,93,93,0,152,152,95,95,0,152,152,95,95,0,0.028455699649409444,0.028455699649409444,90,90,0,-1,2,2,5,20,63,23,69
38,0,0,1,1,0,0,0,1,1,0,0,0,1,1,0,0.0,0.0,1,1,0,-1,-1,-1,8,0,10,76,89
39,100,100,64,64,0,100,100,57,57,0,100,100,66,66,0,0.05323530412879948,0.05323530412879948,97,97,0,-1,1,1,7,22,46,9,81
40,100,100,62,62,0,100,100,48,48,0,100,100,62,62,0,0.03230198441063344,0.06150651826134314,89,100,11,1,1,1,10,15,11,19,0
41,100,100,69,69,0,100,100,69,69,0,100,100,71,71,0,0.07331767589094251,0.08380135470914599,99,100,1,2,1,1,6,40,34,3,77
42,0,616,1,100,99,0,66,1,46,45,0,66,1,54,53,0.0,0.0300554818067327,1,93,92,2,-1,3,6,0,71,82,2
43,0,616,1,100,99,0,90,1,40,39,0,90,1,60,59,0.0,0.01405766023350012,1,72,71,2,-1,3,12,0,2,93,12
44,1,617,25,100,75,3,28,25,43,18,1,28,25,53,28,0.0,0.011334626774226489,1,73,72,2,6,3,3,2,76,58,8
45,0,0,1,1,0,0,0,1,1,0,0,0,1,1,0,0.0,0.0,1,1,0,-1,-1,-1,6,0,74,80,85
46,73,173,64,91,27,54,54,54,54,0,54,54,58,58,0,0.006773545729943157,0.007420266176520644,60,62,2,4,3,3,4,8,47,57,74
47,7,7,38,38,0,8,8,33,33,0,7,7,38,38,0,0.0002723033459273631,0.0002723033459273631,34,34,0,-1,4,4,2,2,86,56,92
48,0,0,1,1,0,0,0,1,1,0,0,0,1,1,0,0.0,0.0,1,1,0,-1,-1,-1,9,0,26,92,69
49,33,649,57,100,43,22,22,52,52,0,22,22,54,54,0,0.005105687736138058,0.02226079852956193,60,86,26,2,3,3,2,6,86,35,18
50,70,70,65,65,0,38,38,46,46,0,38,38,51,51,0,0.010347527145239796,0.010347527145239796,74,74,0,-1,3,3,3,9,96,27,86
51,137,137,88,88,0,48,48,54,54,0,48,48,56,56,0,0.020967357636406957,0.020967357636406957,86,86,0,-1,3,3,3,16,87,18,93
52,0,206,1,92,91,0,42,1,36,35,0,36,1,46,45,0.0,0.006739507811702236,1,57,56,3,-1,4,7,0,46,96,77
53,6,622,28,100,72,15,38,28,35,7,6,38,28,46,18,0.0002042275094455223,0.006943735321147759,29,58,29,2,4,3,6,1,56,4,44
54,4,210,31,94,63,6,18,30,37,7,4,18,31,46,15,0.0004084550188910446,0.008169100377820893,36,67,31,3,5,4,3,2,81,63,77
55,6,6,32,32,0,10,10,32,32,0,6,6,32,32,0,0.00030634126416828345,0.00030634126416828345,33,33,0,-1,4,4,3,1,64,65,69
56,12,628,37,100,63,14,38,33,46,13,12,38,37,52,15,0.0005786446100956465,0.01678069369277375,35,82,47,2,4,3,3,2,75,63,5
57,44,44,56,56,0,96,96,60,60,0,44,44,56,56,0,0.006773545729943157,0.006773545729943157,61,61,0,-1,3,3,6,7,44,62,82
58,0,102,1,82,81,0,4,1,29,28,0,4,1,31,30,0.0,0.00034037918240920387,1,33,32,4,-1,5,2,1,68,45,63
59,0,616,1,100,99,0,22,1,51,50,0,22,1,53,52,0.0,0.010721944245889922,1,69,68,2,-1,3,2,1,86,45,25
60,12,113,35,82,47,18,18,35,35,0,12,13,35,38,3,0.0014295925661186562,0.0014295925661186562,39,39,0,5,4,4,3,2,94,61,95
61,128,128,79,79,0,290,290,83,83,0,128,128,79,79,0,0.008713707069675619,0.008713707069675619,60,60,0,-1,2,2,17,6,20,26,69
62,0,102,1,73,72,0,15,1,27,26,0,2,1,25,24,0.0,0.00010211375472276115,1,29,28,4,-1,5,12,0,6,79,60
63,0,206,1,89,88,0,38,1,31,30,0,38,1,45,44,0.0,0.005377991082065421,1,54,53,3,-1,4,9,1,29,69,44
64,16,222,43,94,51,54,54,62,62,0,16,54,43,67,24,0.005446066918547262,0.014398039415909322,59,78,19,3,3,3,4,1,72,90,19
65,68,1708,64,100,36,72,96,79,89,10,72,96,80,89,9,0.009564655025698629,0.06225535246264338,70,97,27,1,2,2,3,4,75,72,10
66,202,1842,92,100,8,158,192,82,92,10,158,192,87,93,6,0.020150447598624867,0.0402328193607679,83,96,13,1,2,2,9,18,35,5,77
67,160,366,86,96,10,302,302,88,88,0,160,172,86,87,1,0.010687906327649,0.012525953912658701,68,72,4,3,2,2,16,4,4,38,52
68,40,142,48,84,36,102,102,57,57,0,40,42,48,52,4,0.003914360597705844,0.004050512270669526,53,54,1,4,3,3,12,6,6,73,4
69,297,297,99,99,0,72,72,84,84,0,72,72,84,84,0,0.044623710813846626,0.044623710813846626,96,96,0,-1,2,2,3,40,85,3,81
70,218,319,90,94,4,144,144,92,92,0,144,144,92,92,0,0.02382654276864427,0.02382654276864427,85,85,0,5,2,2,6,17,41,6,58
71,0,616,1,100,99,0,78,1,46,45,0,78,1,62,61,0.0,0.01855066544130161,1,81,80,2,-1,3,8,0,57,93,16
72,334,436,100,100,0,80,80,96,96,0,80,80,96,96,0,0.05745600599067361,0.05926001565744239,98,98,0,4,2,2,2,36,86,2,90
73,32,238,44,88,44,108,108,58,58,0,32,38,44,45,1,0.003267640151128357,0.0035739814152966403,51,51,0,3,3,3,12,2,2,75,55
74,188,394,86,99,13,230,230,73,73,0,188,194,86,87,1,0.012594029749140543,0.012662105585622384,70,70,0,3,2,2,16,14,9,32,95
75,2,2,27,27,0,12,12,29,29,0,2,2,27,27,0,0.00010211375472276115,0.00010211375472276115,30,30,0,-1,5,5,6,1,48,65,93
76,12,218,42,97,55,12,12,37,37,0,12,12,41,41,0,0.0020422750944552232,0.005071649817897137,44,58,14,3,4,4,2,2,89,83,26
77,202,818,92,100,8,136,136,98,98,0,136,136,98,98,0,0.0283876238129276,0.03563770039824364,89,93,4,2,2,2,4,18,47,30,24
78,100,100,64,64,0,100,100,57,57,0,100,100,65,65,0,0.032880629020729094,0.032880629020729094,90,90,0,-1,1,1,8,8,10,20,66
79,56,262,65,99,34,22,22,49,49,0,22,22,50,50,0,0.006501242384015794,0.010347527145239796,61,69,8,3,3,3,2,6,93,13,28
80,132,338,84,96,12,88,88,77,77,0,88,88,77,77,0,0.017087034956942034,0.01858470335954253,82,84,2,3,2,2,4,8,79,8,52
81,342,342,98,98,0,224,224,96,96,0,224,224,96,96,0,0.03533135913407536,0.03533135913407536,92,92,0,-1,2,2,8,29,30,0,93
82,16,16,47,47,0,22,22,49,49,0,16,16,48,48,0,0.002382654276864427,0.002382654276864427,47,47,0,-1,3,3,2,1,93,53,69
83,84,84,62,62,0,80,80,59,59,0,80,80,63,63,0,0.012934408931549747,0.012934408931549747,75,75,0,-1,3,3,5,9,61,39,99
84,56,56,53,53,0,154,154,67,67,0,56,56,53,53,0,0.004731270635487933,0.004731270635487933,55,55,0,-1,2,2,10,3,18,29,92
85,96,1736,67,100,33,56,90,44,65,21,56,90,52,68,16,0.009258313761530345,0.02743456210218183,66,90,24,1,3,2,6,13,56,24,95
86,62,678,57,100,43,104,118,60,63,3,62,118,57,78,21,0.002212464685659825,0.011198475101262807,44,70,26,2,2,2,9,4,54,64,14
87,112,213,76,90,14,210,210,83,83,0,112,113,76,76,0,0.007998910786616291,0.00803294870485721,63,63,0,5,2,2,12,4,3,72,58
88,16,222,34,92,58,50,50,46,46,0,16,24,34,44,10,0.0018040096667687805,0.0025188059498281084,43,47,4,3,3,3,5,1,50,53,51
89,100,100,69,69,0,100,100,66,66,0,100,100,75,75,0,0.025902855781340415,0.027060145001531706,87,88,1,3,1,1,6,3,51,54,61
90,296,397,94,97,3,320,320,95,95,0,296,320,93,95,2,0.024098846114571634,0.024303073624017155,86,86,0,5,2,2,14,20,17,23,55
91,387,593,100,100,0,176,176,100,100,0,176,176,100,100,0,0.045134279587460434,0.048878450593961675,97,97,0,3,2,2,5,29,88,11,47
92,16,16,34,34,0,68,68,41,41,0,16,16,34,34,0,0.0031314884781646754,0.0031314884781646754,50,50,0,-1,3,3,8,3,42,46,82
93,60,660,58,100,42,112,112,75,75,0,60,112,58,77,19,0.009462541270975866,0.039109568058817525,67,94,27,2,3,3,7,5,43,25,2
94,0,0,1,1,0,0,0,1,1,0,0,0,1,1,0,0.0,0.0,1,1,0,-1,-1,-1,5,0,61,59,86
95,100,100,76,76,0,100,100,97,97,0,100,100,97,97,0,0.10153511011266551,0.11167840974845979,100,100,0,2,1,1,3,36,94,2,19
96,98,98,72,72,0,54,54,53,53,0,54,54,57,57,0,0.012389802239695021,0.012389802239695021,75,75,0,-1,3,3,4,9,79,27,91
97,2,618,26,100,74,7,76,26,53,27,2,76,26,65,39,0.00010211375472276115,0.023315973995030465,27,87,60,2,5,3,6,1,56,78,23
98,0,101,1,84,83,0,2,1,24,23,0,1,1,24,23,0.0,0.0002723033459273631,1,32,31,5,-1,6,2,0,93,79,88
99,2,208,27,95,68,5,14,27,31,4,2,14,27,38,11,0.0,0.012628067667381462,1,75,74,3,5,4,3,1,94,68,23
100,0,206,1,89,88,0,32,1,32,31,0,32,1,45,44,0.0,0.007794683277170768,1,61,60,3,-1,4,6,0,40,67,8
101,128,334,81,96,15,150,150,85,85,0,128,134,86,86,0,0.00796487286837537,0.009734844616903231,61,68,7,3,2,2,7,5,46,47,94
102,136,342,80,98,18,246,246,74,74,0,136,142,80,80,0,0.009292351679771264,0.010824058000612683,64,67,3,3,2,2,17,7,20,48,53
103,222,428,92,97,5,172,172,86,86,0,172,172,90,90,0,0.02209060893835733,0.0228734810578985,84,84,0,3,2,2,9,17,29,6,74
104,2,104,27,78,51,5,7,27,27,0,2,4,27,31,4,6.807583648184077e-05,0.0008169100377820892,28,38,10,4,5,5,4,1,79,78,71
105,0,616,1,100,99,0,48,1,40,39,0,48,1,53,52,0.0,0.008475441641989176,1,65,64,2,-1,3,7,0,62,89,27
106,22,1662,41,100,59,78,116,39,59,20,22,81,41,57,16,0.0011913271384322134,0.014534191088873005,38,74,36,1,3,2,11,2,5,74,28
107,49,665,51,100,49,66,86,48,55,7,49,86,51,65,14,0.0042547397801150485,0.020729092208720514,51,85,34,2,3,3,6,4,59,22,15
108,76,282,63,93,30,134,134,72,72,0,76,82,63,65,2,0.009836958371625992,0.010109261717553355,70,70,0,3,3,3,9,6,31,77,60
109,6,108,32,85,53,8,8,32,32,0,6,8,32,35,3,0.00034037918240920387,0.0009870996289866913,34,38,4,4,4,4,2,1,68,88,71
110,110,212,75,89,14,148,148,76,76,0,110,112,75,76,1,0.00796487286837537,0.00796487286837537,61,61,0,4,2,2,9,6,29,13,95
111,0,616,1,99,98,0,72,1,38,37,0,57,1,51,50,0.0,0.011130399264780965,1,69,68,2,-1,3,11,0,33,87,37
112,256,358,94,99,5,88,88,80,80,0,88,88,80,80,0,0.03260832567480173,0.03277851526600633,90,91,1,4,2,2,4,27,84,10,4
113,66,272,59,94,35,80,80,61,61,0,66,80,61,66,5,0.00881582082439838,0.00970080669866231,65,68,3,3,2,2,6,6,56,34,61
114,12,12,35,35,0,50,50,36,36,0,12,12,35,35,0,0.0009530617107457708,0.0009530617107457708,37,37,0,-1,4,4,9,2,54,74,40
115,218,1858,91,100,9,312,336,91,95,4,218,336,91,97,6,0.019810068416215663,0.0372374825555669,83,95,12,1,2,2,15,12,7,37,5
116,24,640,48,100,52,74,74,46,46,0,24,74,48,62,14,0.0020422750944552232,0.008066986623098132,45,64,19,2,3,3,8,3,57,54,44
117,2,208,28,93,65,6,20,28,35,7,2,20,28,50,22,0.00013615167296368154,0.006705469893461316,31,60,29,3,5,4,4,1,78,55,77
118,1,1641,26,100,74,5,52,26,53,27,1,52,26,54,28,3.4037918240920386e-05,0.024166921951053473,27,84,57,1,6,2,5,2,70,58,34
119,192,808,88,100,12,134,134,89,89,0,134,134,90,90,0,0.020831205963443275,0.0317233398005378,82,89,7,2,2,2,6,18,41,30,8
120,0,101,1,75,74,0,7,1,25,24,0,1,1,25,24,0.0,0.00017018959120460194,1,30,29,5,-1,6,7,0,62,93,55
121,148,1788,85,100,15,110,134,83,90,7,110,134,83,91,8,0.01409169815174104,0.031178733108683073,73,92,19,1,2,2,6,14,71,32,65
122,0,206,1,93,92,0,24,1,37,36,0,24,1,50,49,0.0,0.01324075019571803,1,77,76,3,-1,4,4,0,72,66,18
123,23,229,53,92,39,38,38,49,49,0,23,38,53,53,0,0.002314578440382586,0.006841621566424997,49,58,9,3,3,3,3,4,87,64,72
124,125,741,81,100,19,80,80,66,66,0,80,80,68,68,0,0.014432077334150244,0.026004969536063176,78,89,11,2,3,3,5,15,63,19,37
125,40,40,54,54,0,68,68,71,71,0,40,40,54,54,0,0.005854521937438306,0.005854521937438306,58,58,0,-1,2,2,4,2,79,94,82
126,100,100,81,81,0,100,100,98,98,0,100,100,98,98,0,0.07835528779059872,0.07862759113652609,99,99,0,4,1,1,2,2,99,94,63
127,100,100,72,72,0,100,100,71,71,0,100,100,75,75,0,0.028932230504782327,0.029442799278396135,89,89,0,4,1,1,6,2,32,75,49
128,100,100,69,69,0,100,100,66,66,0,100,100,72,72,0,0.04680213758126553,0.06286803499097995,96,100,4,2,1,1,6,17,44,6,18
129,66,682,53,100,47,190,200,69,71,2,64,108,53,76,23,0.004016474352428605,0.009462541270975866,51,66,15,2,2,2,16,6,4,41,62
130,108,209,75,89,14,220,220,85,85,0,108,109,75,75,0,0.007011811157629599,0.00704584907587052,60,60,0,5,2,2,12,6,3,26,58
131,0,616,1,100,99,0,48,1,44,43,0,39,1,49,48,0.0,0.008169100377820893,1,65,64,2,-1,3,6,0,59,76,34
132,1,1,26,26,0,9,9,26,26,0,1,1,26,26,0,0.0,0.0,1,1,0,-1,6,6,9,1,26,78,67
133,136,342,84,98,14,144,144,90,90,0,144,144,90,90,0,0.01579359406378706,0.01865277919602437,80,82,2,3,2,2,6,8,59,17,26
134,114,114,76,76,0,100,100,70,70,0,100,100,72,72,0,0.01143674052894925,0.01143674052894925,69,69,0,-1,2,2,6,9,65,31,98
135,2,1642,27,100,73,20,120,29,60,31,2,120,27,78,51,0.00013615167296368154,0.02379250485040335,30,88,58,1,5,2,11,1,33,55,16
136,0,616,1,100,99,0,34,1,44,43,0,34,1,52,51,0.0,0.020797168045202357,1,84,83,2,-1,3,4,0,84,40,10
137,0,206,1,92,91,0,42,1,34,33,0,34,1,48,47,0.0,0.0053439531638245,1,54,53,3,-1,4,9,0,35,93,48
138,82,1722,59,100,41,174,208,73,85,12,82,136,59,80,21,0.0045270431260424114,0.018176248340651485,56,79,23,1,2,2,11,6,19,70,62
139,44,660,55,100,45,38,38,51,51,0,38,38,54,54,0,0.006603356138738555,0.02032063718982947,59,82,23,2,3,3,3,4,94,72,15
140,84,84,66,66,0,88,88,71,71,0,88,88,71,71,0,0.011300588855985567,0.011300588855985567,73,73,0,-1,2,2,4,5,53,25,79
141,126,326,85,100,15,38,38,56,56,0,38,38,57,57,0,0.01657646618332823,0.020524864699274992,82,85,3,3,3,3,3,16,60,12,57
142,100,100,76,76,0,100,100,91,91,0,100,100,91,91,0,0.07471323053882024,0.07471323053882024,100,100,0,-1,1,1,4,29,77,11,66
143,52,668,65,100,35,22,22,54,54,0,22,22,54,54,0,0.005820484019197386,0.020252561353347628,60,84,24,2,3,3,2,6,99,13,37
144,88,294,57,96,39,174,174,72,72,0,88,94,57,58,1,0.008305252050784574,0.008747744987916539,62,65,3,3,2,2,10,4,0,38,42
145,24,126,49,85,36,28,28,45,45,0,24,28,49,49,0,0.003165526396405596,0.004220701861874128,48,51,3,4,3,3,3,6,58,70,64
146,0,616,1,100,99,0,30,1,34,33,0,16,1,36,35,0.0,0.0032336022328874367,1,48,47,2,-1,3,6,0,48,87,46
147,22,638,41,100,59,34,56,37,43,6,22,56,41,57,16,0.0008169100377820892,0.010007147962830594,36,69,33,2,3,3,6,2,34,63,20
148,0,102,1,78,77,0,8,1,27,26,0,4,1,31,30,0.0,0.0006126825283365669,1,35,34,4,-1,5,6,0,69,80,51
149,16,16,44,44,0,22,22,47,47,0,16,16,47,47,0,0.0030974505599237552,0.0030974505599237552,50,50,0,-1,3,3,2,2,89,94,45
150,132,132,86,86,0,70,70,63,63,0,70,70,66,66,0,0.012185574730249497,0.012185574730249497,72,72,0,-1,3,3,5,14,49,14,97
151,158,158,85,85,0,192,192,93,93,0,192,192,94,94,0,0.01929949964260186,0.01929949964260186,81,81,0,-1,2,2,9,12,23,37,85
152,92,1732,67,100,33,134,158,86,92,6,92,158,67,92,25,0.009496579189216788,0.036624800027230335,67,93,26,1,2,2,6,4,44,72,30
153,126,332,77,96,19,158,158,74,74,0,126,132,78,79,1,0.011096361346540046,0.011675005956635693,70,75,5,3,2,2,9,8,28,17,71
154,158,364,90,100,10,72,72,80,80,0,72,72,80,80,0,0.02365635317743967,0.024881718234112803,88,88,0,3,2,2,3,20,76,23,53
155,100,100,72,72,0,100,100,71,71,0,100,100,75,75,0,0.043704687021341775,0.056673133871132444,93,98,5,3,1,1,6,17,32,6,15
156,70,686,62,100,38,80,80,66,66,0,70,80,64,67,3,0.005241839409101739,0.0141938119064638,58,76,18,2,3,3,5,6,63,28,27
157,8,8,36,36,0,12,12,32,32,0,8,8,36,36,0,0.0004084550188910446,0.0004084550188910446,34,34,0,-1,4,4,2,2,91,56,69
158,38,244,46,93,47,100,100,45,45,0,38,50,46,50,4,0.0012594029749140542,0.002552843868069029,39,47,8,3,3,3,10,4,0,64,51
159,0,0,1,1,0,0,0,1,1,0,0,0,1,1,0,0.0,0.0,1,1,0,-1,-1,-1,9,0,35,92,80
160,8,624,37,100,63,20,44,34,48,14,8,44,37,54,17,0.0005786446100956465,0.031451036454610434,36,90,54,2,4,3,4,2,79,63,3
161,40,40,48,48,0,80,80,45,45,0,40,40,48,48,0,0.0034037918240920387,0.0034037918240920387,48,48,0,-1,2,2,9,1,31,71,79
162,66,272,61,95,34,86,86,63,63,0,66,86,62,67,5,0.008611593314952858,0.00970080669866231,67,69,2,3,3,3,6,7,34,21,64
163,339,545,98,100,2,144,144,88,88,0,144,144,89,89,0,0.03516116954287076,0.03642057251778481,93,93,0,3,2,2,6,29,34,11,43
164,38,244,52,95,43,56,56,47,47,0,36,56,52,59,7,0.0035739814152966403,0.0088498587426393,52,67,15,3,3,3,6,6,32,41,34
165,420,1036,98,100,2,320,320,95,95,0,320,320,96,96,0,0.03465060076925695,0.05200993907212635,93,99,6,2,2,2,14,27,17,10,16
166,6,6,33,33,0,8,8,33,33,0,6,6,33,33,0,0.00037441710065012424,0.00037441710065012424,35,35,0,-1,4,4,2,1,90,49,50
167,54,156,57,84,27,66,66,51,51,0,54,56,57,57,0,0.006739507811702236,0.006909697402906838,62,62,0,4,3,3,6,4,34,38,88
168,0,616,1,100,99,0,22,1,51,50,0,22,1,53,52,0.0,0.0141938119064638,1,76,75,2,-1,3,2,0,86,85,24
169,6,6,31,31,0,24,24,33,33,0,6,6,31,31,0,0.0002042275094455223,0.0002042275094455223,31,31,0,-1,4,4,6,1,48,4,67
170,8,8,38,38,0,24,24,40,40,0,8,8,38,38,0,0.00037441710065012424,0.00037441710065012424,35,35,0,-1,4,4,4,2,47,56,50
171,22,1662,43,100,57,94,162,39,67,28,22,162,43,86,43,0.0013615167296368155,0.029034344259505088,41,90,49,1,3,2,13,2,13,74,1
172,2,618,29,100,71,6,34,29,46,17,2,34,29,54,25,3.4037918240920386e-05,0.010824058000612683,27,72,45,2,5,3,4,1,77,95,19
173,16,16,37,37,0,58,58,43,43,0,16,16,37,37,0,0.0020422750944552232,0.0020422750944552232,45,45,0,-1,3,3,8,2,21,94,40
174,0,101,1,74,73,0,6,1,24,23,0,1,1,24,23,0.0,6.807583648184077e-05,1,26,25,5,-1,6,6,0,59,84,78
175,100,100,62,62,0,100,100,48,48,0,100,100,62,62,0,0.06273188331801627,0.08124851084107695,99,100,1,2,1,1,10,40,11,3,1
176,92,708,69,100,31,64,74,61,70,9,64,74,64,71,7,0.012662105585622384,0.019639878825011062,74,82,8,2,2,2,5,8,49,8,77
177,6,6,34,34,0,16,16,34,34,0,6,6,34,34,0,0.0004084550188910446,0.0004084550188910446,36,36,0,-1,4,4,4,1,77,88,36
178,138,240,87,97,10,48,48,70,70,0,48,48,72,72,0,0.013138636440995268,0.015317063208414174,76,77,1,4,3,3,3,14,94,32,75
179,91,193,65,89,24,122,122,74,74,0,91,93,65,66,1,0.008237176214302734,0.008407365805507334,65,65,0,4,2,2,8,8,57,44,60
180,22,123,47,81,34,44,44,48,48,0,22,23,47,51,4,0.0014295925661186562,0.0014295925661186562,43,43,0,6,3,3,4,2,47,61,78
181,230,846,95,100,5,64,64,68,68,0,64,64,71,71,0,0.03226794649239253,0.038394771775758195,91,94,3,2,3,3,4,29,72,0,44
182,270,1870,91,100,9,286,286,88,88,0,270,286,91,93,2,0.0212056230640934,0.04894652643044351,81,97,16,1,2,2,14,18,25,30,1
183,100,100,71,71,0,100,100,79,79,0,100,100,79,79,0,0.049048640185166276,0.06092787365124749,98,100,2,3,1,1,5,18,70,30,6
184,490,490,100,100,0,208,208,99,99,0,208,208,99,99,0,0.05340549372000408,0.05340549372000408,99,99,0,-1,2,2,7,36,43,2,93
185,26,1666,50,100,50,40,84,44,74,30,26,84,50,75,25,0.00353994349705572,0.03628442084482113,50,93,43,1,3,2,5,6,70,73,30
186,64,64,60,60,0,76,76,59,59,0,64,64,61,61,0,0.006092787365124749,0.006092787365124749,58,58,0,-1,3,3,6,4,34,72,82
187,214,315,90,95,5,174,174,76,76,0,174,174,86,86,0,0.019980258007420267,0.020082371762143027,82,82,0,5,2,2,10,17,18,6,58
188,6,6,30,30,0,15,15,30,30,0,6,6,30,30,0,0.0,0.0,1,1,0,-1,4,4,6,1,41,95,82
189,0,616,1,100,99,0,22,1,46,45,0,22,1,51,50,0.0,0.02198849518363457,1,85,84,2,-1,3,2,1,89,50,7
190,6,212,30,94,64,12,24,30,35,5,6,24,30,46,16,0.00034037918240920387,0.005207801490860819,33,54,21,3,4,4,4,1,53,4,13
191,207,413,93,99,6,152,152,95,95,0,152,152,95,95,0,0.028455699649409444,0.029919330133769018,90,90,0,3,2,2,5,20,63,23,54
192,12,12,36,36,0,22,22,34,34,0,12,12,36,36,0,0.0006807583648184077,0.0006807583648184077,36,36,0,-1,4,4,5,2,70,63,92
193,405,405,98,98,0,184,184,94,94,0,184,184,94,94,0,0.035739814152966405,0.035739814152966405,93,93,0,-1,2,2,7,29,43,1,80
194,0,616,1,100,99,0,30,1,31,30,0,16,1,32,31,0.0,0.002484768031587188,1,45,44,2,-1,3,9,0,31,99,71
195,0,102,1,82,81,0,6,1,28,27,0,2,1,28,27,0.0,0.0008169100377820892,1,38,37,4,-1,5,3,0,75,86,71
196,36,652,45,100,55,132,162,58,60,2,36,100,45,56,11,0.004050512270669526,0.010994247591817285,52,70,18,2,3,3,16,6,4,73,38
197,43,249,64,100,36,22,22,55,55,0,22,22,57,57,0,0.006943735321147759,0.019367575479083698,63,83,20,3,3,3,2,8,97,44,30
198,232,832,95,100,5,64,64,68,68,0,64,64,70,70,0,0.02995336805200994,0.047993464719697745,90,96,6,2,3,3,4,27,78,10,7
199,80,181,72,90,18,88,88,80,80,0,88,88,81,81,0,0.014295925661186561,0.014295925661186561,78,78,0,5,2,2,4,5,77,25,95
200,94,300,60,96,36,92,92,50,50,0,92,92,61,61,0,0.008986010415602982,0.01405766023350012,64,77,13,3,3,3,7,9,46,27,34
201,72,1712,57,100,43,144,212,63,76,13,72,212,57,89,32,0.0020082371762143027,0.03134892269988768,43,92,49,1,2,2,14,3,17,43,0
202,226,826,92,100,8,228,228,77,77,0,226,228,92,92,0,0.013138636440995268,0.01667857993805099,71,77,6,2,2,2,15,14,7,32,13
203,1,207,25,92,67,3,18,25,37,12,1,18,25,46,21,3.4037918240920386e-05,0.003608019333537561,29,53,24,3,6,4,3,1,76,68,28
204,0,0,1,1,0,0,0,1,1,0,0,0,1,1,0,0.0,0.0,1,1,0,-1,-1,-1,8,0,10,81,85
205,299,899,100,100,0,72,72,85,85,0,72,72,85,85,0,0.04663194799006093,0.05997481194050172,97,99,2,2,2,2,3,36,60,2,18
206,0,616,1,100,99,0,22,1,48,47,0,22,1,49,48,0.0,0.026889955410327106,1,90,89,2,-1,3,2,0,93,80,3
207,100,100,73,73,0,100,100,87,87,0,100,100,87,87,0,0.057149664726505324,0.07501957180298853,99,100,1,2,1,1,4,16,79,18,9
208,0,616,1,100,99,0,46,1,36,35,0,46,1,51,50,0.0,0.007011811157629599,1,60,59,2,-1,3,6,0,40,98,24
209,62,678,52,100,48,174,184,67,70,3,62,124,52,75,23,0.0031314884781646754,0.00888389666088022,50,62,12,2,2,2,15,6,7,70,24
210,0,206,1,89,88,0,26,1,29,28,0,8,1,33,32,0.0,0.0011232513019503727,1,38,37,3,-1,4,12,0,3,80,74
211,297,503,97,100,3,96,96,72,72,0,96,96,72,72,0,0.03100854351747847,0.033765614894993023,92,95,3,3,3,3,6,29,71,1,54
212,100,100,58,58,0,100,100,38,38,0,100,100,58,58,0,0.016133973246196264,0.028830116750059566,78,91,13,2,1,1,16,8,9,57,37
213,0,616,1,100,99,0,24,1,41,40,0,16,1,41,40,0.0,0.005922597773920147,1,57,56,2,-1,3,3,0,75,86,90
214,206,206,89,89,0,128,128,67,67,0,128,128,79,79,0,0.01783586915824228,0.01783586915824228,81,81,0,-1,3,3,8,16,15,12,79
215,0,0,1,1,0,0,0,1,1,0,0,0,1,1,0,0.0,0.0,1,1,0,-1,-1,-1,8,0,10,92,67
216,56,672,52,100,48,76,90,54,66,12,56,90,52,68,16,0.004595118962524252,0.02491575615235372,50,88,38,2,2,2,6,2,56,74,0
217,176,176,93,93,0,56,56,85,85,0,56,56,85,85,0,0.03094046768099663,0.03094046768099663,92,92,0,-1,2,2,2,17,90,6,96
218,42,1642,52,100,48,112,112,63,63,0,42,112,52,77,25,0.003165526396405596,0.032370060247115286,49,92,43,1,2,2,8,2,15,61,9
219,2,208,27,92,65,9,19,27,29,2,2,8,27,35,8,3.4037918240920386e-05,0.00088498587426393,26,38,12,3,5,4,8,1,21,78,71
220,410,410,98,98,0,144,144,89,89,0,144,144,90,90,0,0.031076619353960312,0.031076619353960312,90,90,0,-1,2,2,6,29,40,1,67
221,58,58,59,59,0,28,28,48,48,0,28,28,54,54,0,0.007760645358929848,0.007760645358929848,60,60,0,-1,3,3,3,7,55,48,96
222,22,22,38,38,0,70,70,40,40,0,22,22,38,38,0,0.001497668402600497,0.001497668402600497,41,41,0,-1,3,3,10,2,0,83,82
223,160,261,93,98,5,32,32,63,63,0,32,32,64,64,0,0.0283876238129276,0.028591851322373123,90,92,2,5,3,3,2,27,86,10,55
224,100,100,67,67,0,100,100,70,70,0,100,100,71,71,0,0.058443105619660304,0.06099594948772933,99,99,0,3,1,1,6,29,74,11,75
225,100,100,59,59,0,100,100,46,46,0,100,100,59,59,0,0.050444194833044013,0.050444194833044013,100,100,0,-1,1,1,11,29,5,11,89
226,184,800,86,100,14,190,190,92,92,0,184,190,93,93,0,0.016542428265087308,0.018959120460192654,80,81,1,2,2,2,8,8,42,20,54
227,0,0,1,1,0,0,0,1,1,0,0,0,1,1,0,0.0,0.0,1,1,0,-1,-1,-1,6,1,34,45,82
228,0,0,1,1,0,0,0,1,1,0,0,0,1,1,0,0.0,0.0,1,1,0,-1,-1,-1,3,0,58,81,82
229,32,238,51,95,44,54,54,55,55,0,32,54,51,59,8,0.004901460226692535,0.010109261717553355,56,72,16,3,3,3,4,3,73,29,44
230,2,208,28,93,65,5,12,28,33,5,2,12,28,40,12,6.807583648184077e-05,0.002110350930937064,29,45,16,3,5,4,4,1,72,78,41
231,40,1680,50,100,50,82,178,45,79,34,40,178,50,87,37,0.0023486163586235067,0.041968753191054836,48,96,48,1,2,2,10,2,11,42,2
232,2,618,27,100,73,12,76,29,51,22,2,76,27,61,34,0.00034037918240920387,0.020797168045202357,31,85,54,2,5,3,6,1,65,88,16
233,92,708,59,100,41,124,124,69,69,0,92,124,59,78,19,0.009428503352734947,0.014295925661186561,68,74,6,2,3,3,9,7,29,48,13
234,38,244,49,93,44,62,62,43,43,0,38,44,49,51,2,0.002144388849177984,0.004629156880765172,46,52,6,3,3,3,7,3,43,54,90
235,66,1706,65,100,35,60,84,55,74,19,60,84,60,75,15,0.008577555396711936,0.04026685727900882,68,96,28,1,3,2,5,7,70,21,30
236,101,202,78,90,12,100,100,68,68,0,100,100,73,73,0,0.008101024541339052,0.008237176214302734,65,65,0,5,2,2,6,8,48,57,65
237,105,705,71,100,29,144,144,61,61,0,105,144,71,78,7,0.006024711528642908,0.010960209673576363,56,74,18,2,2,2,10,6,0,35,24
238,110,316,75,95,20,164,164,74,74,0,110,164,75,85,10,0.010313489226998877,0.01494264610776405,67,75,8,3,2,2,10,7,22,21,26
239,80,182,70,91,21,38,38,57,57,0,38,38,59,59,0,0.009122162088566664,0.010755982164130842,66,69,3,4,3,3,3,9,55,31,75
240,78,1678,56,100,44,206,206,76,76,0,78,206,56,91,35,0.008441403723748256,0.04309200449300521,66,95,29,1,2,2,12,7,6,62,2
241,142,1782,83,100,17,228,262,79,87,8,142,226,83,89,6,0.013819394805813677,0.02552843868069029,71,89,18,1,2,2,14,9,25,39,47
242,220,426,94,100,6,48,48,60,60,0,48,48,63,63,0,0.03094046768099663,0.03362946322202934,91,91,0,3,3,3,3,30,58,7,13
243,174,380,87,98,11,110,110,78,78,0,110,110,82,82,0,0.018040096667687803,0.020048333843902106,79,82,3,3,2,2,6,16,51,12,70
244,111,213,83,93,10,64,64,68,68,0,64,64,71,71,0,0.01405766023350012,0.0141938119064638,79,79,0,4,3,3,4,15,72,19,55
245,6,6,29,29,0,34,34,30,30,0,6,6,29,29,0,0.00013615167296368154,0.00013615167296368154,28,28,0,-1,4,4,13,1,13,65,99
246,114,320,80,94,14,176,176,87,87,0,114,176,80,88,8,0.011845195547840293,0.017325300384628477,74,81,7,3,2,2,8,6,57,77,72
247,158,364,90,100,10,72,72,80,80,0,72,72,80,80,0,0.02365635317743967,0.025188059498281085,88,88,0,3,2,2,3,20,76,23,64
248,86,292,64,96,32,86,86,56,56,0,86,86,66,66,0,0.006297014874570271,0.007420266176520644,59,63,4,3,3,3,6,6,59,13,53
249,2,2,26,26,0,10,10,27,27,0,2,2,26,26,0,3.4037918240920386e-05,3.4037918240920386e-05,26,26,0,-1,5,5,8,2,30,58,85
250,32,1672,43,100,57,124,190,57,68,11,32,162,43,86,43,0.0013615167296368155,0.021682153919466287,39,82,43,1,3,2,16,2,4,74,6
251,16,632,37,100,63,64,116,36,61,25,16,116,37,77,40,0.00037441710065012424,0.015419176963136935,35,77,42,2,3,3,11,1,19,49,15
252,58,158,55,82,27,66,66,44,44,0,58,66,55,56,1,0.009020048333843901,0.009224275843289425,67,68,1,4,3,3,6,6,51,34,63
253,112,112,76,76,0,220,220,84,84,0,112,112,76,76,0,0.008169100377820893,0.008169100377820893,62,62,0,-1,2,2,12,4,14,72,97
254,625,625,100,100,0,368,368,100,100,0,368,368,100,100,0,0.053269342047040404,0.053269342047040404,99,99,0,-1,2,2,11,36,19,2,76
255,54,156,58,88,30,76,76,52,52,0,54,56,58,58,0,0.006705469893461316,0.007726607440688927,62,63,1,4,3,3,6,4,48,38,71
256,0,206,1,92,91,0,22,1,32,31,0,22,1,42,41,0.0,0.005241839409101739,1,57,56,3,-1,4,5,0,63,93,31
257,0,0,1,1,0,0,0,1,1,0,0,0,1,1,0,0.0,0.0,1,1,0,-1,-1,-1,5,0,50,81,82
258,44,44,62,62,0,32,32,69,69,0,32,32,69,69,0,0.007590455767725246,0.007590455767725246,67,67,0,-1,3,3,2,4,90,72,87
259,0,616,1,100,99,0,60,1,38,37,0,50,1,51,50,0.0,0.011164437183021887,1,69,68,2,-1,3,9,0,29,89,39
260,0,206,1,90,89,0,24,1,29,28,0,15,1,32,31,0.0,0.0032336022328874367,1,45,44,3,-1,4,6,0,51,87,22
261,87,293,60,95,35,104,104,64,64,0,87,99,60,66,6,0.008373327887266415,0.009632730862180468,65,70,5,3,3,3,9,8,35,44,61
262,2,618,26,100,74,15,82,26,34,8,2,38,26,47,21,6.807583648184077e-05,0.0037441710065012424,28,51,23,2,5,3,14,2,16,58,28
263,265,365,96,99,3,88,88,80,80,0,88,88,81,81,0,0.03420810783212499,0.03434425950508867,92,92,0,5,2,2,4,30,77,7,55
264,92,193,76,95,19,48,48,59,59,0,48,48,63,63,0,0.012866333095067906,0.012866333095067906,78,78,0,5,3,3,3,8,75,17,95
265,6,622,27,100,73,24,56,30,41,11,6,56,27,53,26,0.0009190237925048504,0.03209775690118792,35,93,58,2,4,3,6,2,51,42,2
266,0,0,1,1,0,0,0,1,1,0,0,0,1,1,0,0.0,0.0,1,1,0,-1,-1,-1,16,0,4,81,92
267,116,716,77,100,23,88,88,73,73,0,88,88,74,74,0,0.015112835698968652,0.03209775690118792,78,90,12,2,2,2,4,8,83,20,0
268,0,0,1,1,0,0,0,1,1,0,0,0,1,1,0,0.0,0.0,1,1,0,-1,-1,-1,4,0,77,81,96
269,198,814,89,100,11,232,232,93,93,0,198,232,90,94,4,0.01923142380612002,0.02219272269308009,81,84,3,2,2,2,10,12,18,37,22
270,162,368,84,96,12,112,112,75,75,0,112,112,78,78,0,0.012491915994417782,0.013751318969331836,73,76,3,3,3,3,7,14,43,14,53
271,184,1824,88,100,12,182,206,91,94,3,182,206,92,95,3,0.019776030497974745,0.0440791041219919,82,97,15,1,2,2,9,12,35,37,15
272,0,0,1,1,0,0,0,1,1,0,0,0,1,1,0,0.0,0.0,1,1,0,-1,-1,-1,7,0,24,87,82
273,6,622,29,100,71,62,80,34,37,3,6,22,29,41,12,0.000442492937131965,0.0028932230504782326,33,46,13,2,4,3,13,1,13,49,61
274,122,122,80,80,0,66,66,51,51,0,66,66,62,62,0,0.0123557643214541,0.0123557643214541,74,74,0,-1,3,3,6,14,34,14,69
275,2,208,27,90,63,12,20,29,32,3,2,10,27,35,8,0.00010211375472276115,0.0012934408931549745,30,38,8,3,5,4,6,1,48,65,52
276,0,206,1,88,87,0,15,1,29,28,0,8,1,34,33,0.0,0.00030634126416828345,1,32,31,3,-1,4,6,0,41,97,56
277,0,616,1,100,99,0,52,1,37,36,0,22,1,42,41,0.0,0.002927260968719153,1,48,47,2,-1,3,9,0,54,85,52
278,493,595,99,100,1,208,208,99,99,0,208,208,99,99,0,0.049763436468225605,0.0509207256884169,96,96,0,4,2,2,7,36,46,2,75
279,158,158,84,84,0,164,164,69,69,0,158,158,85,85,0,0.009598692943939549,0.009598692943939549,69,69,0,-1,2,2,10,9,0,31,59
280,100,100,58,58,0,100,100,38,38,0,100,100,58,58,0,0.03158718812757412,0.03168930188229688,92,92,0,4,1,1,16,19,9,15,65
281,18,634,42,100,58,76,94,36,38,2,18,44,42,52,10,0.0007488342013002485,0.006058749446883829,34,57,23,2,3,3,13,2,13,63,72
282,88,704,67,100,33,132,132,79,79,0,88,132,67,83,16,0.00878178290615746,0.01606589740971442,67,79,12,2,2,2,8,7,39,62,21
283,0,616,1,100,99,0,30,1,32,31,0,20,1,40,39,0.0,0.002757071377514551,1,45,44,2,-1,3,6,1,40,50,43
284,44,250,59,93,34,38,38,51,51,0,38,38,54,54,0,0.006399128629293032,0.007011811157629599,61,63,2,3,3,3,3,4,82,38,88
285,0,0,1,1,0,0,0,1,1,0,0,0,1,1,0,0.0,0.0,1,1,0,-1,-1,-1,4,0,53,89,99
286,0,0,1,1,0,0,0,1,1,0,0,0,1,1,0,0.0,0.0,1,1,0,-1,-1,-1,11,0,19,84,76
287,2,2,27,27,0,17,17,28,28,0,2,2,27,27,0,0.00010211375472276115,0.00010211375472276115,30,30,0,-1,5,5,10,1,12,55,98
288,304,404,98,100,2,158,158,95,95,0,158,158,95,95,0,0.03213179481942884,0.03274447734776541,92,92,0,4,2,2,6,22,59,9,43
289,6,108,32,80,48,18,18,32,32,0,6,10,32,36,4,0.00037441710065012424,0.0012934408931549745,34,40,6,4,4,4,5,1,45,4,51
290,100,100,63,63,0,100,100,39,39,0,100,100,63,63,0,0.012559991830899623,0.012559991830899623,71,71,0,-1,1,1,14,4,17,64,67
291,0,206,1,95,94,0,14,1,31,30,0,14,1,38,37,0.0,0.008237176214302734,1,64,63,3,-1,4,3,0,94,91,8
292,19,120,49,83,34,18,18,38,38,0,18,18,47,47,0,0.00439089145307873,0.00439089145307873,56,56,0,5,4,4,3,4,81,22,68
293,0,206,1,94,93,0,18,1,37,36,0,18,1,46,45,0.0,0.013887470642295518,1,76,75,3,-1,4,3,0,81,66,16
294,78,78,57,57,0,104,104,73,73,0,78,78,58,58,0,0.009292351679771264,0.009292351679771264,65,65,0,-1,2,2,5,4,52,38,93
295,138,738,84,100,16,100,100,66,66,0,100,100,72,72,0,0.010041185881071514,0.015180911535450491,68,80,12,2,2,2,6,9,44,31,38
296,208,808,94,100,6,144,144,88,88,0,144,144,89,89,0,0.023179822322066782,0.0313829606181286,87,91,4,2,2,2,6,16,34,18,20
297,16,632,34,100,66,68,88,41,46,5,16,88,34,59,25,0.0031314884781646754,0.012798257258586064,50,76,26,2,3,3,8,3,42,46,20
298,100,100,63,63,0,100,100,47,47,0,100,100,63,63,0,0.034854828278702475,0.035059055788148,91,91,0,4,1,1,10,17,36,6,60
299,548,748,100,100,0,288,288,100,100,0,288,288,100,100,0,0.046393682562374486,0.046529834235338165,97,97,0,3,2,2,9,40,31,3,49
300,66,272,61,95,34,86,86,63,63,0,66,86,62,67,5,0.008611593314952858,0.00980292045338507,67,69,2,3,3,3,6,7,34,21,43
301,64,680,59,100,41,124,124,66,66,0,64,88,59,63,4,0.007352190340038803,0.0088498587426393,62,66,4,2,3,3,9,4,54,38,64
302,207,1847,90,100,10,206,230,95,96,1,206,230,95,96,1,0.0228734810578985,0.03720344463732598,83,95,12,1,2,2,9,12,26,37,28
303,2,208,28,94,66,8,22,28,32,4,2,22,28,45,17,0.00013615167296368154,0.007386228258279724,30,62,32,3,5,4,5,1,45,65,8
304,16,1656,39,100,61,46,100,40,65,25,16,100,39,71,32,0.0026209197045508697,0.03703325504612138,48,93,45,1,3,2,6,2,44,94,7
305,0,616,1,99,98,0,80,1,38,37,0,64,1,55,54,0.0,0.0088498587426393,1,67,66,2,-1,3,12,0,6,86,8
306,100,100,58,58,0,100,100,38,38,0,100,100,58,58,0,0.04782327512849314,0.053473569556485925,97,98,1,2,1,1,16,29,9,1,62
307,111,317,80,95,15,182,182,70,70,0,111,117,80,82,2,0.007760645358929848,0.00888389666088022,62,65,3,3,2,2,13,8,13,44,53
308,156,257,85,94,9,176,176,85,85,0,156,156,88,88,0,0.012900371013308825,0.012934408931549747,76,76,0,5,2,2,8,9,30,27,68
309,169,785,90,100,10,72,72,83,83,0,72,72,83,83,0,0.02484768031587188,0.048299805983866025,88,96,8,2,2,2,3,16,58,18,1
310,32,648,48,100,52,68,98,40,51,11,32,98,48,64,16,0.0015317063208414173,0.018959120460192654,42,82,40,2,3,3,8,2,15,74,16
311,0,0,1,1,0,0,0,1,1,0,0,0,1,1,0,0.0,0.0,1,1,0,-1,-1,-1,11,0,19,36,40
312,8,214,36,93,57,14,14,35,35,0,8,14,36,42,6,0.0004084550188910446,0.003437829742332959,34,48,14,3,4,4,3,2,92,56,29
313,0,206,1,89,88,0,28,1,33,32,0,12,1,33,32,0.0,0.0009190237925048504,1,38,37,3,-1,4,8,0,42,86,74
314,76,282,63,96,33,70,70,58,58,0,70,70,64,64,0,0.008305252050784574,0.00966676878042139,67,68,1,3,3,3,5,7,63,21,52
315,0,616,1,100,99,0,42,1,35,34,0,36,1,44,43,0.0,0.004220701861874128,1,50,49,2,-1,3,6,0,51,92,47
316,6,622,29,100,71,13,40,29,41,12,6,40,29,52,23,0.00010211375472276115,0.004016474352428605,30,53,23,2,4,3,5,1,61,60,28
317,32,1672,41,100,59,76,100,55,65,10,32,100,41,74,33,0.0028591851322373124,0.028047244630518397,42,89,47,1,3,2,6,2,51,52,33
318,162,263,93,100,7,56,56,82,82,0,56,56,82,82,0,0.027026107083290785,0.027026107083290785,89,89,0,6,2,2,2,16,89,12,68
319,102,308,85,100,15,46,46,84,84,0,46,46,84,84,0,0.018312400013615168,0.023384049831512304,83,87,4,3,2,2,2,8,93,8,25
320,22,1662,41,100,59,36,94,36,67,31,22,94,41,70,29,0.0009870996289866913,0.03781612716566255,38,95,57,1,3,2,5,3,50,51,9
321,115,321,83,100,17,38,38,51,51,0,38,38,54,54,0,0.019946220089179345,0.022703291466693896,81,86,5,3,3,3,3,20,94,23,83
322,0,616,1,100,99,0,24,1,34,33,0,18,1,44,43,0.0,0.0057524081827155455,1,54,53,2,-1,3,5,0,88,76,83
323,36,1676,54,100,46,44,68,50,75,25,35,68,55,75,20,0.004356853534837809,0.03260832567480173,54,92,38,1,3,2,4,6,84,41,70
324,0,206,1,89,88,0,14,1,31,30,0,6,1,28,27,0.0,0.0014636304843595766,1,40,39,3,-1,4,5,0,61,79,94
325,106,208,79,90,11,78,78,73,73,0,78,78,73,73,0,0.014534191088873005,0.015180911535450491,77,79,2,4,2,2,4,8,79,20,71
326,40,246,47,91,44,66,66,44,44,0,40,55,47,53,6,0.003437829742332959,0.006705469893461316,46,55,9,3,2,2,6,1,51,71,22
327,100,100,79,79,0,100,100,96,96,0,100,100,96,96,0,0.07539398890363866,0.0911535450491848,100,100,0,2,1,1,3,20,85,23,16
328,0,0,1,1,0,0,0,1,1,0,0,0,1,1,0,0.0,0.0,1,1,0,-1,-1,-1,2,0,99,40,87
329,264,1864,92,100,8,248,248,90,90,0,248,248,92,92,0,0.019980258007420267,0.05190782531740359,81,98,17,1,2,2,11,18,38,5,3
330,66,66,61,61,0,60,60,49,49,0,60,60,59,59,0,0.008169100377820893,0.008169100377820893,64,64,0,-1,3,3,5,7,88,21,96
331,6,212,33,96,63,12,12,35,35,0,6,12,33,42,9,0.0004765308553728854,0.0011913271384322134,37,39,2,3,4,4,2,1,86,49,42
332,40,40,48,48,0,45,45,38,38,0,40,40,48,48,0,0.01055175465468532,0.01055175465468532,69,69,0,-1,2,2,6,2,56,58,36
333,6,212,28,92,64,43,48,30,31,1,6,12,28,31,3,0.00017018959120460194,0.0006467204465774873,29,35,6,3,4,4,16,1,4,65,49
334,66,66,65,65,0,60,60,55,55,0,60,60,60,60,0,0.008577555396711936,0.008577555396711936,68,68,0,-1,3,3,5,7,70,21,86
335,6,622,32,100,68,14,28,32,45,13,6,28,32,53,21,0.0004765308553728854,0.004969536063174376,34,55,21,2,4,3,3,1,87,88,22
336,122,722,79,100,21,110,110,76,76,0,110,110,81,81,0,0.016099935327955343,0.02913645801422785,81,91,10,2,2,2,6,9,59,39,16
337,0,0,1,1,0,0,0,1,1,0,0,0,1,1,0,0.0,0.0,1,1,0,-1,-1,-1,12,0,3,92,87
338,0,206,1,89,88,0,28,1,33,32,0,9,1,37,36,0.0,0.0013955546478777359,1,40,39,3,-1,4,8,0,57,86,64
339,262,878,95,100,5,208,208,89,89,0,208,208,94,94,0,0.021682153919466287,0.026889955410327106,86,88,2,2,2,2,10,19,36,15,22
340,0,616,1,100,99,0,124,1,59,58,0,124,1,79,78,0.0,0.01415977398822288,1,73,72,2,-1,3,14,0,16,91,5
341,58,160,55,82,27,100,100,45,45,0,58,62,55,56,1,0.002110350930937064,0.002757071377514551,43,48,5,4,2,2,10,4,12,64,51
342,66,167,66,90,24,54,54,55,55,0,54,54,60,60,0,0.009905034208107831,0.009905034208107831,67,67,0,6,3,3,4,6,84,77,78
343,50,666,52,100,48,134,184,62,69,7,44,184,49,88,39,0.0035059055788147996,0.025902855781340415,51,90,39,2,3,3,14,6,8,41,0
344,224,840,91,100,9,246,246,95,95,0,246,246,95,95,0,0.017801831240001363,0.02307770856734402,78,82,4,2,2,2,10,13,12,33,47
345,62,62,54,54,0,90,90,56,56,0,62,62,54,54,0,0.005990673610401988,0.005990673610401988,55,55,0,-1,2,2,6,3,40,54,45
346,2,1642,29,100,71,4,46,31,80,49,2,46,29,81,52,3.4037918240920386e-05,0.055209503386772864,27,98,71,1,5,2,2,1,90,65,32
347,0,206,1,91,90,0,26,1,34,33,0,10,1,35,34,0.0,0.0009190237925048504,1,37,36,3,-1,4,7,0,62,40,64
348,168,768,87,100,13,128,128,69,69,0,128,128,82,82,0,0.012491915994417782,0.014500153170632085,75,77,2,2,3,3,8,14,30,32,90
349,100,100,59,59,0,100,100,40,40,0,100,100,59,59,0,0.018142210422410564,0.018142210422410564,80,80,0,-1,1,1,15,7,7,21,40
350,166,166,89,89,0,84,84,66,66,0,84,84,70,70,0,0.014636304843595765,0.014636304843595765,80,80,0,-1,2,2,5,14,61,14,96
351,16,222,36,93,57,40,40,40,40,0,16,40,36,49,13,0.0004084550188910446,0.00707988699411144,34,58,24,3,3,3,5,1,52,49,24
352,2,208,28,93,65,8,28,28,35,7,2,21,28,43,15,0.0002723033459273631,0.003914360597705844,32,51,19,3,5,4,6,1,69,55,22
353,0,0,1,1,0,0,0,1,1,0,0,0,1,1,0,0.0,0.0,1,1,0,-1,-1,-1,16,0,9,85,80
354,54,54,56,56,0,50,50,50,50,0,54,54,55,55,0,0.007216038667075122,0.007216038667075122,61,61,0,-1,3,3,5,4,70,38,82
355,22,22,48,48,0,38,38,57,57,0,22,22,48,48,0,0.0045270431260424114,0.0045270431260424114,54,54,0,-1,3,3,3,3,85,29,98
356,0,0,1,1,0,0,0,1,1,0,0,0,1,1,0,0.0,0.0,1,1,0,-1,-1,-1,4,1,78,50,69
357,0,616,1,100,99,0,66,1,48,47,0,62,1,58,57,0.0,0.00803294870485721,1,64,63,2,-1,3,6,0,44,82,21
358,0,101,1,79,78,0,9,1,25,24,0,1,1,25,24,0.0,0.00010211375472276115,1,29,28,5,-1,6,9,0,26,97,55
359,0,206,1,96,95,0,12,1,34,33,0,12,1,41,40,0.0,0.007011811157629599,1,61,60,3,-1,4,2,0,98,91,77
360,236,852,92,100,8,174,174,93,93,0,174,174,94,94,0,0.017155110793423873,0.02831954797644576,80,89,9,2,2,2,7,14,24,32,37
361,100,100,57,57,0,100,100,38,38,0,100,100,57,57,0,0.010824058000612683,0.01245787807617686,69,72,3,3,1,1,16,4,4,64,52
362,153,153,92,92,0,80,80,97,97,0,80,80,97,97,0,0.02900030634126417,0.02900030634126417,90,90,0,-1,2,2,2,18,89,5,98
363,657,657,100,100,0,536,536,100,100,0,536,536,100,100,0,0.03979032642363593,0.03979032642363593,95,95,0,-1,2,2,17,30,20,7,97
364,0,0,1,1,0,0,0,1,1,0,0,0,1,1,0,0.0,0.0,1,1,0,-1,-1,-1,2,0,90,84,40
365,252,452,98,100,2,56,56,85,85,0,56,56,85,85,0,0.03921168181354028,0.04554273460635148,94,98,4,3,2,2,2,30,90,7,33
366,0,616,1,100,99,0,22,1,51,50,0,22,1,53,52,0.0,0.018891044623710815,1,84,83,2,-1,3,2,0,86,80,23
367,42,42,56,56,0,22,22,48,48,0,22,22,51,51,0,0.007216038667075122,0.007216038667075122,61,61,0,-1,3,3,2,6,95,34,81
368,58,264,67,98,31,46,46,82,82,0,46,46,82,82,0,0.012151536812008578,0.029919330133769018,72,94,22,3,2,2,2,4,86,72,10
369,0,616,1,100,99,0,34,1,42,41,0,34,1,51,50,0.0,0.008441403723748256,1,66,65,2,-1,3,4,1,83,45,21
370,0,206,1,90,89,0,11,1,26,25,0,6,1,26,25,0.0,0.000442492937131965,1,30,29,3,-1,4,6,0,51,84,60
371,40,656,54,100,46,48,62,73,81,8,40,62,74,81,7,0.0061949011198475104,0.020865243881684196,58,84,26,2,2,2,3,1,92,88,18
372,62,62,59,59,0,80,80,61,61,0,62,62,59,59,0,0.005888559855679227,0.005888559855679227,57,57,0,-1,2,2,6,3,74,54,36
373,176,792,87,100,13,174,174,78,78,0,174,174,87,87,0,0.015283025290173252,0.023486163586235065,78,87,9,2,2,2,10,13,11,33,27
374,0,0,1,1,0,0,0,1,1,0,0,0,1,1,0,0.0,0.0,1,1,0,-1,-1,-1,3,0,85,76,40
375,2,104,27,82,55,5,6,28,28,0,2,6,27,30,3,3.4037918240920386e-05,0.0008509479560230097,26,37,11,4,5,5,3,1,66,95,64
376,6,108,30,77,47,12,12,30,30,0,6,10,30,36,6,0.0002042275094455223,0.0017359338302869397,32,43,11,4,4,4,4,1,53,55,75
377,16,118,35,76,41,80,80,40,40,0,16,20,35,42,7,0.0023486163586235067,0.002927260968719153,47,48,1,4,3,3,10,2,12,94,74
378,22,22,49,49,0,34,34,45,45,0,22,22,49,49,0,0.0028932230504782326,0.0028932230504782326,49,49,0,-1,3,3,4,2,84,75,92
379,276,378,95,100,5,192,192,100,100,0,192,192,100,100,0,0.034140031995643146,0.03437829742332959,94,95,1,4,2,2,6,20,56,23,55
380,102,204,78,91,13,102,102,93,93,0,102,102,93,93,0,0.015283025290173252,0.015997821573232582,78,79,1,4,2,2,4,4,84,38,74
381,0,206,1,93,92,0,12,1,33,32,0,12,1,40,39,0.0,0.005071649817897137,1,57,56,3,-1,4,4,0,72,82,24
382,12,12,35,35,0,18,18,35,35,0,12,12,35,35,0,0.0017018959120460194,0.0017018959120460194,41,41,0,-1,4,4,3,2,94,52,80
383,0,206,1,88,87,0,36,1,35,34,0,12,1,35,34,0.0,0.0013274788113958951,1,40,39,3,-1,4,8,0,10,89,52
384,16,222,35,92,57,68,68,40,40,0,16,24,35,45,10,0.001157289220191293,0.002757071377514551,40,47,7,3,3,3,8,1,15,71,52
385,0,206,1,92,91,0,18,1,34,33,0,18,1,47,46,0.0,0.00616086320160659,1,56,55,3,-1,4,3,0,87,79,48
386,0,0,1,1,0,0,0,1,1,0,0,0,1,1,0,0.0,0.0,1,1,0,-1,-1,-1,16,1,4,45,84
387,22,228,46,94,48,34,34,44,44,0,22,30,46,54,8,0.0036760951700194017,0.007011811157629599,52,64,12,3,3,3,4,2,72,83,29
388,0,1640,1,100,99,0,112,1,61,60,0,112,1,77,76,0.0,0.023315973995030465,1,85,84,1,-1,2,8,0,42,66,19
389,49,255,56,94,38,70,70,63,63,0,49,70,55,65,10,0.005037611899656217,0.008747744987916539,56,65,9,3,3,3,5,4,49,22,29
390,40,656,44,100,56,168,178,68,69,1,40,107,44,75,31,0.002484768031587188,0.014772456516559448,47,73,26,2,2,2,14,1,8,53,37
391,0,1640,1,100,99,0,40,1,43,42,0,40,1,48,47,0.0,0.025494400762449368,1,87,86,1,-1,2,4,0,67,66,50
392,598,598,100,100,0,344,344,96,96,0,344,344,96,96,0,0.04319411824772797,0.04319411824772797,96,96,0,-1,2,2,14,40,25,3,85
393,1,1,25,25,0,6,6,25,25,0,1,1,25,25,0,3.4037918240920386e-05,3.4037918240920386e-05,28,28,0,-1,6,6,6,1,69,78,80
394,0,616,1,100,99,0,36,1,37,36,0,36,1,51,50,0.0,0.005412029000306341,1,58,57,2,-1,3,5,0,63,76,13
395,0,1640,1,100,99,0,114,1,64,63,0,114,1,75,74,0.0,0.022499063957248374,1,85,84,1,-1,2,10,0,11,89,6
396,119,735,84,100,16,78,78,75,75,0,78,78,77,77,0,0.011709043874876613,0.030395860989141904,73,90,17,2,2,2,4,13,77,24,9
397,60,266,60,95,35,76,76,54,54,0,60,76,60,65,5,0.0053099152455835805,0.006467204465774873,56,58,2,3,3,3,6,6,32,28,52
398,100,100,62,62,0,100,100,48,48,0,100,100,62,62,0,0.026719765819122502,0.028625889240614044,88,88,0,2,1,1,10,5,11,25,52
399,0,616,1,100,99,0,40,1,39,38,0,40,1,48,47,0.0,0.015419176963136935,1,79,78,2,-1,3,5,0,50,92,16
400,51,257,57,97,40,38,38,46,46,0,38,38,51,51,0,0.005480104836788182,0.01147077844719017,55,75,20,3,3,3,3,6,96,35,48
401,80,80,60,60,0,142,142,71,71,0,80,80,60,60,0,0.010347527145239796,0.010347527145239796,68,68,0,-1,2,2,8,6,15,77,96
402,0,1640,1,100,99,0,102,1,55,54,0,72,1,54,53,0.0,0.01334286395044079,1,70,69,1,-1,2,14,0,25,99,48
403,178,178,88,88,0,190,190,94,94,0,190,190,94,94,0,0.018788930868988054,0.018788930868988054,81,81,0,-1,2,2,8,12,21,37,45
404,32,648,46,100,54,94,122,44,59,15,32,82,46,58,12,0.003199564314646516,0.007862759113652609,50,62,12,2,3,3,12,2,3,83,47
405,90,706,64,100,36,104,104,82,82,0,104,104,83,83,0,0.010858095918853602,0.026107083290785937,73,89,16,2,2,2,5,6,50,77,5
406,80,696,69,100,31,38,38,53,53,0,38,38,55,55,0,0.009122162088566664,0.028932230504782327,69,91,22,2,3,3,3,9,64,31,10
407,51,51,57,57,0,56,56,45,45,0,51,51,57,57,0,0.005480104836788182,0.005480104836788182,56,56,0,-1,3,3,6,6,48,35,89
408,22,123,50,85,35,28,28,46,46,0,22,23,50,51,1,0.002586881786309949,0.002586881786309949,47,47,0,5,3,3,3,2,81,83,68
409,0,1640,1,100,99,0,156,1,59,58,0,156,1,85,84,0.0,0.021375812655298,1,82,81,1,-1,2,16,0,4,80,15
410,202,303,93,96,3,104,104,86,86,0,104,104,86,86,0,0.02566459035365397,0.02566459035365397,88,88,0,6,2,2,5,19,45,15,58
411,134,134,80,80,0,132,132,74,74,0,132,132,81,81,0,0.011130399264780965,0.011130399264780965,70,70,0,-1,2,2,8,9,21,31,96
412,0,0,1,1,0,0,0,1,1,0,0,0,1,1,0,0.0,0.0,1,1,0,-1,-1,-1,10,1,22,50,80
413,12,628,39,100,61,24,34,37,42,5,12,34,39,51,12,0.001940161339732462,0.011675005956635693,45,73,28,2,4,3,4,2,83,52,33
414,28,28,41,41,0,84,84,42,42,0,28,28,41,41,0,0.002723033459273631,0.002723033459273631,46,46,0,-1,3,3,9,6,29,70,80
415,110,726,75,100,25,164,164,74,74,0,110,164,75,85,10,0.010313489226998877,0.019707954661492902,67,81,14,2,2,2,10,7,22,21,33
416,6,108,33,79,46,26,26,35,35,0,6,9,33,35,2,0.0010211375472276116,0.0019061234214915416,40,44,4,4,4,4,5,1,88,71,74
417,132,132,82,82,0,222,222,90,90,0,132,132,82,82,0,0.011913271384322134,0.011913271384322134,73,73,0,-1,2,2,10,5,36,25,87
418,0,0,1,1,0,0,0,1,1,0,0,0,1,1,0,0.0,0.0,1,1,0,-1,-1,-1,8,0,15,93,92
419,48,664,51,100,49,122,132,62,66,4,48,122,51,78,27,0.0030634126416828346,0.012559991830899623,50,70,20,2,3,3,12,6,2,70,8
420,1,1,26,26,0,5,5,26,26,0,1,1,26,26,0,3.4037918240920386e-05,3.4037918240920386e-05,26,26,0,-1,6,6,5,1,88,68,98
421,0,102,1,77,76,0,9,1,27,26,0,2,1,27,26,0.0,0.0,1,1,0,4,-1,5,8,0,57,98,65
422,22,228,49,97,48,22,22,49,49,0,22,22,50,50,0,0.0031314884781646754,0.008203138296061813,49,67,18,3,3,3,2,2,93,52,21
423,40,142,53,88,35,72,72,77,77,0,40,44,67,69,2,0.00970080669866231,0.009905034208107831,71,72,1,4,2,2,3,1,96,90,63
424,24,24,50,50,0,32,32,64,64,0,32,32,64,64,0,0.002723033459273631,0.002723033459273631,47,47,0,-1,3,3,2,3,89,54,40
425,2,1642,26,100,74,18,126,28,61,33,2,126,26,79,53,0.0,0.01865277919602437,1,80,79,1,5,2,14,1,16,68,12
426,22,228,47,95,48,28,28,45,45,0,22,28,47,48,1,0.002484768031587188,0.02117158514585248,47,86,39,3,3,3,3,2,60,52,10
427,152,358,86,96,10,256,256,90,90,0,152,160,86,86,0,0.01596378365499166,0.019163347969638176,76,79,3,3,2,2,13,9,13,39,29
428,0,0,1,1,0,0,0,1,1,0,0,0,1,1,0,0.0,0.0,1,1,0,-1,-1,-1,7,0,24,96,97
429,230,1870,89,100,11,312,356,90,97,7,230,356,89,99,10,0.01232172640321318,0.040028591851322376,69,95,26,1,2,2,16,9,9,31,7
430,100,100,63,63,0,100,100,47,47,0,100,100,63,63,0,0.05037611899656217,0.053643759147690526,97,98,1,2,1,1,10,29,22,0,29
431,0,206,1,94,93,0,16,1,32,31,0,9,1,36,35,0.0,0.0013615167296368155,1,42,41,3,-1,4,6,0,32,80,43
432,0,102,1,83,82,0,4,1,29,28,0,4,1,32,31,0.0,0.0020082371762143027,1,43,42,4,-1,5,2,0,89,86,29
433,464,670,98,100,2,288,288,98,98,0,288,288,98,98,0,0.03727152047380782,0.03897341638585384,96,96,0,3,2,2,9,30,54,7,53
434,0,0,1,1,0,0,0,1,1,0,0,0,1,1,0,0.0,0.0,1,1,0,-1,-1,-1,6,0,65,80,76
435,22,1662,41,100,59,80,114,41,61,20,22,114,41,76,35,0.0008509479560230097,0.019707954661492902,37,82,45,1,3,2,10,2,18,56,33
436,22,228,50,99,49,22,22,55,55,0,22,22,57,57,0,0.004356853534837809,0.025392287007726607,52,88,36,3,3,3,2,3,97,29,0
437,6,6,29,29,0,36,36,33,33,0,6,6,29,29,0,0.0002382654276864427,0.0002382654276864427,33,33,0,-1,4,4,10,1,18,88,40
438,28,28,45,45,0,74,74,42,42,0,28,28,45,45,0,0.0019061234214915416,0.0019061234214915416,43,43,0,-1,3,3,9,3,28,54,87
439,198,404,91,98,7,158,158,80,80,0,158,158,86,86,0,0.019707954661492902,0.023690391095680587,83,85,2,3,2,2,9,18,23,5,57
440,16,16,33,33,0,66,66,44,44,0,16,16,33,33,0,0.0018380475850097008,0.0018380475850097008,42,42,0,-1,3,3,6,1,40,53,89
441,28,644,45,99,54,92,102,41,56,15,28,75,45,55,10,0.0024507301133462676,0.009190237925048503,47,67,20,2,3,3,12,3,6,54,44
442,0,616,1,100,99,0,28,1,44,43,0,28,1,51,50,0.0,0.02375846693216243,1,90,89,2,-1,3,3,0,94,36,7
443,62,1702,53,100,47,92,126,47,68,21,62,126,53,77,24,0.00353994349705572,0.026004969536063176,51,87,36,1,2,2,8,3,42,54,33
444,324,530,98,100,2,96,96,89,89,0,96,96,89,89,0,0.03699921712788046,0.03975628850539501,94,94,0,3,2,2,3,29,64,1,29
445,2,208,26,93,67,4,14,26,31,5,2,14,26,38,12,6.807583648184077e-05,0.002110350930937064,27,45,18,3,5,4,3,2,82,58,70
446,106,312,81,97,16,72,72,83,83,0,72,72,83,83,0,0.01695088328397835,0.019027196296674494,81,84,3,3,2,2,3,6,58,77,75
447,6,212,31,93,62,14,18,35,39,4,6,18,31,44,13,0.001055175465468532,0.007522379931243405,39,66,27,3,4,4,3,2,92,42,77
448,0,206,1,93,92,0,8,1,31,30,0,8,1,35,34,0.0,0.001055175465468532,1,39,38,3,-1,4,2,0,68,80,52
449,237,437,95,100,5,72,72,80,80,0,72,72,80,80,0,0.03332312195786106,0.041185881071513664,93,95,2,3,2,2,3,29,66,11,19
450,606,1222,99,100,1,512,512,99,99,0,512,512,99,99,0,0.03808843051158991,0.04397699036726914,93,98,5,2,2,2,17,29,20,11,21
451,0,206,1,91,90,0,9,1,26,25,0,6,1,26,25,0.0,0.000442492937131965,1,31,30,3,-1,4,4,0,67,40,65
452,16,222,35,92,57,108,108,62,62,0,16,23,35,45,10,0.0020763130126961434,0.0027911092957554717,44,48,4,3,3,3,8,1,15,53,56
453,126,742,84,100,16,90,90,69,69,0,90,90,73,73,0,0.013376901868681712,0.019673916743251984,77,86,9,2,2,2,6,14,32,14,24
454,0,0,1,1,0,0,0,1,1,0,0,0,1,1,0,0.0,0.0,1,1,0,-1,-1,-1,4,0,83,92,98
455,8,8,34,34,0,10,10,31,31,0,8,8,34,34,0,0.000442492937131965,0.000442492937131965,33,33,0,-1,4,4,3,2,94,63,66
456,135,751,87,100,13,32,32,58,58,0,32,32,59,59,0,0.01872085503250621,0.026889955410327106,85,89,4,2,3,3,2,16,68,18,24
457,100,100,67,67,0,100,100,66,66,0,100,100,72,72,0,0.07553014057660233,0.07553014057660233,100,100,0,-1,1,1,6,36,59,2,93
458,56,672,59,100,41,88,88,80,80,0,56,88,65,80,15,0.005377991082065421,0.011504816365431091,57,70,13,2,2,2,4,2,77,52,72
459,60,266,64,96,32,38,38,59,59,0,38,38,62,62,0,0.006058749446883829,0.016508390346846386,57,81,24,3,3,3,3,6,92,28,6
460,2,1642,27,100,73,6,56,27,50,23,2,50,27,53,26,6.807583648184077e-05,0.02631131080023146,27,89,62,1,5,2,5,1,37,78,73
461,6,622,29,100,71,34,48,30,32,2,6,22,29,42,13,0.00037441710065012424,0.001055175465468532,32,35,3,2,4,3,13,1,13,60,95
462,24,230,48,93,45,28,28,44,44,0,24,28,49,50,1,0.0016678579938050988,0.0053439531638245,42,54,12,3,3,3,3,4,92,64,90
463,101,717,77,100,23,88,88,71,71,0,88,88,71,71,0,0.009734844616903231,0.01841451376833793,69,81,12,2,2,2,4,8,53,44,27
464,124,124,78,78,0,144,144,91,91,0,124,124,90,90,0,0.012968446849790666,0.012968446849790666,74,74,0,-1,2,2,6,7,51,21,67
465,46,662,52,100,48,84,108,46,70,24,46,108,52,79,27,0.005854521937438306,0.018857006705469893,55,79,24,2,2,2,9,2,26,83,14
466,100,100,67,67,0,100,100,74,74,0,100,100,75,75,0,0.035875965825930084,0.0368971033731577,93,93,0,3,1,1,5,6,63,34,43
467,174,174,87,87,0,196,196,94,94,0,174,174,91,91,0,0.014908608189523128,0.014908608189523128,75,75,0,-1,2,2,9,8,23,17,50
468,199,405,93,100,7,96,96,95,95,0,96,96,95,95,0,0.033084856530174615,0.041185881071513664,91,95,4,3,2,2,3,15,55,16,14
469,0,616,1,100,99,0,58,1,42,41,0,44,1,49,48,0.0,0.00704584907587052,1,58,57,2,-1,3,7,0,46,85,72
470,2,618,29,100,71,5,24,30,41,11,2,24,29,47,18,0.0002042275094455223,0.009734844616903231,32,68,36,2,5,3,3,1,60,65,31
471,95,196,77,94,17,32,32,64,64,0,32,32,64,64,0,0.019061234214915415,0.019197385887879097,82,82,0,5,3,3,2,16,89,18,55
472,74,74,63,63,0,110,110,76,76,0,74,74,62,62,0,0.007147962830593281,0.007147962830593281,63,63,0,-1,2,2,6,6,59,28,67
473,22,638,51,100,49,38,48,49,53,4,22,48,51,55,4,0.0040845501889104465,0.01776779332176044,54,83,29,2,3,3,3,3,87,29,8
474,100,100,69,69,0,100,100,87,87,0,100,100,87,87,0,0.04649579631709724,0.04649579631709724,96,96,0,6,1,1,4,5,83,25,78
475,40,141,51,82,31,80,80,56,56,0,40,41,51,51,0,0.0045270431260424114,0.004799346471969774,52,53,1,5,2,2,6,2,65,94,88
476,120,221,85,93,8,64,64,64,64,0,64,64,67,67,0,0.016168011164437182,0.016236087000919025,81,81,0,5,3,3,4,18,77,30,95
477,0,616,1,100,99,0,62,1,42,41,0,62,1,57,56,0.0,0.021852343510670887,1,85,84,2,-1,3,7,0,24,79,11
478,100,100,63,63,0,100,100,45,45,0,100,100,63,63,0,0.022328874366043774,0.05908982606623779,84,100,16,1,1,1,11,13,19,24,3
479,108,210,75,89,14,220,220,85,85,0,108,110,75,75,0,0.007011811157629599,0.007011811157629599,60,60,0,4,2,2,12,6,3,26,95
480,128,128,79,79,0,146,146,80,80,0,128,128,80,80,0,0.008101024541339052,0.008101024541339052,63,63,0,-1,2,2,8,5,10,47,96
481,0,206,1,92,91,0,27,1,27,26,0,6,1,27,26,0.0,0.0016338200755641784,1,41,40,3,-1,4,10,0,36,80,71
482,28,644,45,100,55,86,106,43,57,14,28,106,45,77,32,0.002382654276864427,0.011845195547840293,46,72,26,2,3,3,10,3,36,54,27
483,0,616,1,100,99,0,126,1,58,57,0,82,1,56,55,0.0,0.009020048333843901,1,62,61,2,-1,3,15,0,7,93,17
484,76,692,63,100,37,64,64,63,63,0,64,64,64,64,0,0.009973110044589673,0.019367575479083698,71,84,13,2,3,3,4,6,79,77,24
485,58,264,63,97,34,34,34,44,44,0,34,34,55,55,0,0.010347527145239796,0.013989584397018279,72,78,6,3,3,3,4,8,72,8,28
486,214,414,98,100,2,46,46,83,83,0,46,46,83,83,0,0.034820790360461554,0.035705776234725484,96,96,0,3,2,2,2,29,99,11,64
487,16,16,32,32,0,114,114,65,65,0,16,16,32,32,0,0.0026889955410327104,0.0026889955410327104,45,45,0,-1,3,3,9,3,29,46,87
488,0,206,1,94,93,0,10,1,30,29,0,10,1,38,37,0.0,0.002586881786309949,1,49,48,3,-1,4,3,0,66,36,41
489,72,72,66,66,0,70,70,59,59,0,70,70,66,66,0,0.008101024541339052,0.008101024541339052,66,66,0,-1,3,3,5,6,80,34,92
490,0,616,1,100,99,0,56,1,50,49,0,56,1,53,52,0.0,0.012832295176826986,1,75,74,2,-1,3,5,0,37,84,39
491,0,0,1,1,0,0,0,1,1,0,0,0,1,1,0,0.0,0.0,1,1,0,-1,-1,-1,4,0,73,40,87
492,6,212,27,89,62,20,36,28,33,5,6,25,27,43,16,0.00013615167296368154,0.002723033459273631,29,45,16,3,4,4,6,1,40,65,22
493,6,1646,29,100,71,24,122,32,65,33,6,122,29,77,48,0.0,0.032029681064706085,1,90,89,1,4,2,8,1,42,95,10
494,0,206,1,86,85,0,40,1,33,32,0,19,1,41,40,0.0,0.0031314884781646754,1,47,46,3,-1,4,8,0,27,97,22
495,6,212,29,93,64,14,18,32,35,3,6,18,29,44,15,0.0002042275094455223,0.015351101126655093,31,79,48,3,4,4,3,1,82,4,15
496,6,622,28,100,72,26,52,31,35,4,6,34,28,46,18,0.00037441710065012424,0.0030974505599237552,32,46,14,2,4,3,9,1,31,4,70
497,110,316,77,98,21,76,76,51,51,0,76,76,63,63,0,0.007488342013002485,0.011198475101262807,64,70,6,3,3,3,6,13,59,24,47
498,0,616,1,100,99,0,40,1,40,39,0,40,1,53,52,0.0,0.020831205963443275,1,85,84,2,-1,3,5,0,80,86,0
499,79,285,66,95,29,78,78,73,73,0,78,78,73,73,0,0.007794683277170768,0.015623404472582456,64,80,16,3,2,2,4,6,79,28,27
500,54,155,65,92,27,22,22,52,52,0,22,22,55,55,0,0.010449640899962559,0.010619830491167161,70,70,0,5,3,3,2,8,98,8,78
501,42,143,50,85,35,84,84,64,64,0,42,43,51,51,0,0.003199564314646516,0.003199564314646516,48,48,0,5,2,2,5,2,50,61,58
502,12,114,36,85,49,14,14,32,32,0,12,14,36,40,4,0.0004084550188910446,0.005922597773920147,34,56,22,4,4,4,3,2,96,63,8
503,0,1640,1,100,99,0,106,1,57,56,0,82,1,57,56,0.0,0.016508390346846386,1,75,74,1,-1,2,11,1,5,50,20
504,280,280,94,94,0,128,128,93,93,0,128,128,93,93,0,0.03638653459954389,0.03638653459954389,93,93,0,-1,2,2,5,27,70,10,36
505,268,268,98,98,0,96,96,95,95,0,96,96,95,95,0,0.04278566322883692,0.04278566322883692,95,95,0,-1,2,2,3,30,60,7,98
506,38,654,49,100,51,66,66,44,44,0,38,66,49,55,6,0.003199564314646516,0.02117158514585248,48,84,36,2,3,3,6,6,40,70,1
507,0,206,1,89,88,0,14,1,27,26,0,6,1,27,26,0.0,0.0007488342013002485,1,34,33,3,-1,4,9,0,29,92,78
508,157,773,91,100,9,72,72,77,77,0,72,72,79,79,0,0.023724429013921508,0.03002144388849178,89,92,3,2,2,2,3,15,96,16,90
509,338,544,96,99,3,240,240,96,96,0,240,240,96,96,0,0.024949794070594642,0.026923993328568024,84,86,2,3,2,2,9,19,54,15,94
510,6,1646,28,100,72,44,134,33,62,29,6,93,28,56,28,0.00017018959120460194,0.011062323428299126,30,62,32,1,4,2,16,1,9,4,57
511,100,100,65,65,0,100,100,45,45,0,100,100,65,65,0,0.027094182919772627,0.058034650600769254,91,100,9,1,1,1,10,9,12,27,1
512,34,240,55,98,43,32,32,69,69,0,32,32,69,69,0,0.003880322679464924,0.008611593314952858,53,67,14,3,3,3,2,3,93,54,44
513,0,0,1,1,0,0,0,1,1,0,0,0,1,1,0,0.0,0.0,1,1,0,-1,-1,-1,6,0,56,40,50
514,58,159,61,91,30,48,48,54,54,0,48,48,56,56,0,0.010177337554035196,0.010211375472276116,71,71,0,5,3,3,3,8,87,17,58
515,16,632,42,100,58,28,48,43,58,15,16,48,42,62,20,0.0007147962830593281,0.02032063718982947,37,87,50,2,3,3,3,1,75,49,23
516,56,672,59,100,41,122,132,76,78,2,56,132,59,83,24,0.006126825283365669,0.01317267435923619,60,74,14,2,2,2,8,3,39,29,48
517,0,206,1,93,92,0,42,1,35,34,0,42,1,52,51,0.0,0.005514142755029102,1,57,56,3,-1,4,9,1,23,50,24
518,344,944,96,100,4,352,352,96,96,0,352,352,96,96,0,0.02644746247319514,0.03713536880084414,88,94,6,2,2,2,13,15,13,16,18
519,8,8,38,38,0,12,12,37,37,0,8,8,38,38,0,0.001055175465468532,0.001055175465468532,38,38,0,-1,4,4,2,2,99,74,91
520,112,112,77,77,0,274,274,84,84,0,112,112,77,77,0,0.008475441641989176,0.008475441641989176,63,63,0,-1,2,2,16,4,4,72,98
521,437,1053,97,100,3,280,280,96,96,0,280,280,96,96,0,0.03672691378195309,0.0489124885122026,93,98,5,2,2,2,10,29,12,11,37
522,0,206,1,90,89,0,20,1,29,28,0,8,1,34,33,0.0,0.0017018959120460194,1,43,42,3,-1,4,8,0,30,36,75
523,32,1672,47,100,53,80,134,42,66,24,32,134,47,83,36,0.002552843868069029,0.032914666938970015,47,91,44,1,3,2,10,2,36,75,1
524,112,112,76,76,0,198,198,83,83,0,112,112,76,76,0,0.00881582082439838,0.00881582082439838,64,64,0,-1,2,2,10,7,11,62,69
525,16,1656,34,100,66,84,156,41,67,26,16,156,34,86,52,0.0009530617107457708,0.02995336805200994,38,90,52,1,3,2,12,2,14,42,0
526,0,616,1,100,99,0,54,1,37,36,0,34,1,45,44,0.0,0.006297014874570271,1,56,55,2,-1,3,8,0,27,91,38
527,16,632,32,100,68,124,154,60,64,4,16,82,32,59,27,0.0024166921951053475,0.009224275843289425,46,65,19,2,3,3,14,2,17,94,21
528,100,100,78,78,0,100,100,96,96,0,100,100,96,96,0,0.08325674801729126,0.09789305286088702,100,100,0,3,1,1,3,27,81,10,16
529,0,616,1,100,99,0,30,1,42,41,0,30,1,50,49,0.0,0.007318152421797883,1,62,61,2,-1,3,4,0,73,93,38
530,16,222,37,91,54,50,50,38,38,0,16,26,37,43,6,0.000442492937131965,0.0019061234214915416,36,43,7,3,3,3,8,1,10,49,54
531,100,100,61,61,0,100,100,44,44,0,100,100,61,61,0,0.04687021341774737,0.047448858027843016,96,96,0,3,1,1,12,27,6,10,51
532,100,100,71,71,0,100,100,76,76,0,100,100,77,77,0,0.059838660267538035,0.0647741584124715,98,99,1,2,1,1,5,22,50,9,21
533,342,958,96,100,4,176,176,99,99,0,176,176,99,99,0,0.039994553933081455,0.04578100003403792,93,96,3,2,2,2,5,27,80,10,21
534,0,206,1,93,92,0,14,1,33,32,0,8,1,34,33,0.0,0.0030293747234419145,1,48,47,3,-1,4,3,1,55,45,29
535,0,1640,1,100,99,0,79,1,36,35,0,41,1,51,50,0.0,0.008237176214302734,1,63,62,1,-1,2,13,0,13,40,56
536,0,616,1,100,99,0,40,1,32,31,0,24,1,44,43,0.0,0.0020422750944552232,1,43,42,2,-1,3,12,0,3,91,54
537,85,85,75,75,0,38,38,46,46,0,38,38,51,51,0,0.015351101126655093,0.015351101126655093,79,79,0,-1,3,3,3,12,96,37,98
538,0,102,1,77,76,0,5,1,26,25,0,2,1,26,25,0.0,0.0002382654276864427,1,31,30,4,-1,5,4,1,79,50,55
539,100,100,70,70,0,100,100,53,53,0,100,100,70,70,0,0.019469689233806462,0.047448858027843016,83,97,14,2,1,1,9,2,31,75,3
540,166,372,86,97,11,124,124,76,76,0,124,124,81,81,0,0.016712617856291908,0.020354675108070392,80,80,0,3,3,3,9,16,26,12,13
541,100,100,61,61,0,100,100,40,40,0,100,100,61,61,0,0.04244528404642772,0.04244528404642772,96,96,0,-1,1,1,14,27,8,10,50
542,0,616,1,100,99,0,114,1,60,59,0,114,1,77,76,0.0,0.027264372510977228,1,87,86,2,-1,3,9,1,54,50,11
543,440,1040,97,100,3,296,296,96,96,0,296,296,96,96,0,0.037850165083903466,0.041253956907995507,93,94,1,2,2,2,11,29,33,0,26
544,282,1922,96,100,4,288,312,97,99,2,288,312,97,99,2,0.026209197045508698,0.05731985431770993,88,100,12,1,2,2,12,20,14,23,1
545,316,316,98,98,0,144,144,95,95,0,144,144,95,95,0,0.03478675244222063,0.03478675244222063,94,94,0,-1,2,2,6,27,65,10,76
546,2,2,26,26,0,11,11,26,26,0,2,2,26,26,0,0.00013615167296368154,0.00013615167296368154,28,28,0,-1,5,5,10,2,22,58,87
547,14,220,37,90,53,36,36,38,38,0,14,22,37,44,7,0.0008509479560230097,0.002280540522141666,38,46,8,3,4,4,6,3,74,43,52
548,158,158,86,86,0,84,84,71,71,0,84,84,72,72,0,0.012900371013308825,0.012900371013308825,74,74,0,-1,2,2,5,14,80,32,98
549,6,212,30,94,64,12,12,30,30,0,6,14,30,37,7,0.00013615167296368154,0.0011913271384322134,30,38,8,3,4,4,4,1,53,65,74
550,56,262,63,95,32,48,48,66,66,0,48,48,67,67,0,0.005173763572619898,0.007624493685966166,60,64,4,3,3,3,3,6,76,28,22
551,16,222,39,91,52,68,68,43,43,0,16,32,39,50,11,0.0018380475850097008,0.004050512270669526,43,52,9,3,3,3,8,1,57,53,41
552,339,339,98,98,0,144,144,88,88,0,144,144,89,89,0,0.03516116954287076,0.03516116954287076,93,93,0,-1,2,2,6,29,34,11,89
553,0,206,1,88,87,0,44,1,33,32,0,6,1,27,26,0.0,0.001599782157323258,1,39,38,3,-1,4,14,0,17,97,94
554,94,300,61,95,34,238,238,81,81,0,94,100,61,62,1,0.010926171755335444,0.011028285510058205,68,68,0,3,2,2,14,5,17,25,95
555,0,616,1,100,99,0,28,1,45,44,0,28,1,52,51,0.0,0.023690391095680587,1,88,87,2,-1,3,3,0,81,84,0
556,114,114,77,77,0,130,130,67,67,0,114,114,77,77,0,0.008951972497362062,0.008951972497362062,65,65,0,-1,3,3,10,9,11,31,96
557,82,288,76,100,24,46,46,83,83,0,46,46,83,83,0,0.013104598522754349,0.016168011164437182,73,79,6,3,2,2,2,7,99,48,47
558,209,1849,93,100,7,128,152,93,98,5,128,152,93,98,5,0.031076619353960312,0.060689608223561044,89,100,11,1,2,2,5,15,70,16,30
559,144,144,84,84,0,182,182,87,87,0,144,144,82,82,0,0.010926171755335444,0.010926171755335444,73,73,0,-1,2,2,9,7,31,21,81
560,0,0,1,1,0,0,0,1,1,0,0,0,1,1,0,0.0,0.0,1,1,0,-1,-1,-1,5,0,50,40,89
561,108,108,74,74,0,172,172,86,86,0,108,108,74,74,0,0.012083460975526737,0.012083460975526737,71,71,0,-1,2,2,9,5,29,25,89
562,18,224,39,92,53,36,36,36,36,0,18,26,39,45,6,0.000442492937131965,0.0018040096667687805,34,42,8,3,3,3,5,2,50,56,83
563,145,761,83,100,17,204,204,79,79,0,145,204,83,87,4,0.009973110044589673,0.014636304843595765,65,74,9,2,2,2,11,8,5,44,26
564,144,1784,81,100,19,280,314,81,88,7,144,314,81,97,16,0.008066986623098132,0.03454848701453419,58,93,35,1,2,2,17,6,20,13,1
565,22,22,45,45,0,66,66,49,49,0,22,22,45,45,0,0.0019061234214915416,0.0019061234214915416,44,44,0,-1,3,3,6,2,44,52,98
566,168,168,89,89,0,110,110,80,80,0,110,110,83,83,0,0.013989584397018279,0.013989584397018279,77,77,0,-1,2,2,6,14,48,32,85
567,70,172,59,88,29,124,124,68,68,0,70,72,59,60,1,0.005684332346233704,0.0057524081827155455,59,59,0,4,3,3,9,5,31,47,95
568,177,177,91,91,0,72,72,83,83,0,72,72,83,83,0,0.023213860240307704,0.023213860240307704,85,85,0,-1,2,2,3,19,58,15,40
569,12,628,32,100,68,20,34,30,38,8,12,34,32,45,13,0.001157289220191293,0.00970080669866231,36,64,28,2,4,3,4,3,67,51,77
570,345,945,98,100,2,128,128,90,90,0,128,128,90,90,0,0.0370672929643623,0.04693828925422921,94,96,2,2,2,2,5,29,63,1,20
571,0,206,1,92,91,0,10,1,31,30,0,10,1,39,38,0.0,0.0034037918240920387,1,53,52,3,-1,4,3,0,76,98,35
572,0,1640,1,100,99,0,100,1,68,67,0,100,1,70,69,0.0,0.05218012866333095,1,97,96,1,-1,2,6,0,34,67,3
573,100,100,59,59,0,100,100,46,46,0,100,100,59,59,0,0.026243234963749616,0.036658837945471257,87,94,7,2,1,1,11,8,5,17,33
574,94,294,80,99,19,32,32,63,63,0,32,32,65,65,0,0.01232172640321318,0.021375812655298,76,86,10,3,3,3,2,14,98,14,5
575,40,656,52,100,48,106,116,66,67,1,40,116,52,75,23,0.0030293747234419145,0.021750229755948126,49,84,35,2,2,2,7,1,24,53,9
576,0,206,1,90,89,0,20,1,32,31,0,14,1,38,37,0.0,0.002995336805200994,1,49,48,3,-1,4,6,0,44,36,35
577,0,616,1,100,99,0,120,1,56,55,0,108,1,79,78,0.0,0.010960209673576363,1,69,68,2,-1,3,14,0,17,97,14
578,0,616,1,100,99,0,22,1,41,40,0,16,1,40,39,0.0,0.004663194799006093,1,53,52,2,-1,3,2,0,91,40,53
579,28,644,41,100,59,64,84,39,41,2,28,84,41,57,16,0.0011232513019503727,0.01865277919602437,38,82,44,2,3,3,9,4,29,64,9
580,0,1640,1,100,99,0,124,1,65,64,0,124,1,78,77,0.0,0.026141121209026855,1,88,87,1,-1,2,10,0,11,40,16
581,0,206,1,89,88,0,21,1,31,30,0,8,1,33,32,0.0,0.0005786446100956465,1,35,34,3,-1,4,8,1,42,69,63
582,0,616,1,100,99,0,88,1,36,35,0,53,1,52,51,0.0,0.005377991082065421,1,56,55,2,-1,3,14,0,8,84,57
583,235,835,95,100,5,72,72,87,87,0,72,72,87,87,0,0.0337315769767521,0.056094489261036794,92,98,6,2,2,2,3,29,55,0,1
584,0,0,1,1,0,0,0,1,1,0,0,0,1,1,0,0.0,0.0,1,1,0,-1,-1,-1,2,0,68,86,36
585,129,329,82,97,15,104,104,80,80,0,104,104,81,81,0,0.01865277919602437,0.022703291466693896,80,86,6,3,2,2,5,12,63,37,57
586,370,576,100,100,0,96,96,90,90,0,96,96,90,90,0,0.045644848361074235,0.04687021341774737,96,96,0,3,2,2,3,40,82,3,61
587,548,648,99,100,1,328,328,100,100,0,328,328,100,100,0,0.04489601415977399,0.04496408999625583,95,95,0,4,2,2,10,40,12,3,4
588,2,618,26,100,74,8,46,27,38,11,2,46,26,49,23,0.0,0.019946220089179345,1,84,83,2,5,3,6,1,56,68,0
589,22,638,41,100,59,48,76,36,45,9,22,76,41,56,15,0.0009190237925048504,0.011504816365431091,37,70,33,2,3,3,9,2,35,74,33
590,45,45,60,60,0,22,22,54,54,0,22,22,54,54,0,0.0053439531638245,0.0053439531638245,57,57,0,-1,3,3,2,6,99,28,45
591,344,1944,96,100,4,320,320,95,95,0,320,320,96,96,0,0.024507301133462677,0.049184791858129955,87,100,13,1,2,2,14,19,17,15,1
592,2,1642,28,100,72,9,56,30,54,24,2,56,28,57,29,6.807583648184077e-05,0.02569862827189489,28,86,58,1,5,2,5,1,70,55,31
593,0,0,1,1,0,0,0,1,1,0,0,0,1,1,0,0.0,0.0,1,1,0,-1,-1,-1,8,0,30,59,96
594,0,102,1,83,82,0,4,1,30,29,0,2,1,28,27,0.0,0.0007828721195411688,1,39,38,4,-1,5,2,1,90,69,71
595,2,208,26,91,65,12,27,27,29,2,2,7,26,34,8,3.4037918240920386e-05,0.00017018959120460194,27,31,4,3,5,4,10,2,1,58,56
596,122,223,86,93,7,56,56,76,76,0,56,56,77,77,0,0.018006058749446885,0.018040096667687803,84,84,0,5,2,2,2,14,68,14,60
597,6,622,31,100,69,30,48,35,40,5,6,24,31,46,15,0.0005105687736138058,0.004016474352428605,37,49,12,2,4,3,7,1,62,49,75
598,37,37,60,60,0,12,12,39,39,0,12,12,44,44,0,0.007760645358929848,0.007760645358929848,65,65,0,-1,4,4,2,9,97,31,45
599,22,123,38,77,39,56,56,42,42,0,22,23,38,39,1,0.0014295925661186562,0.0014295925661186562,39,39,0,5,3,3,6,2,51,61,58
600,2,104,28,85,57,3,3,28,28,0,2,3,28,33,5,0.00010211375472276115,0.0012934408931549745,30,41,11,4,5,5,2,1,93,95,61
601,306,922,98,100,2,280,280,99,99,0,280,280,99,99,0,0.029374723441914292,0.03196160522822424,89,89,0,2,2,2,10,15,1,16,70
602,161,161,94,94,0,32,32,67,67,0,32,32,68,68,0,0.028728002995336805,0.028728002995336805,90,90,0,-1,3,3,2,29,97,1,86
603,80,1720,73,100,27,32,56,69,84,15,32,56,69,84,15,0.011811157629599374,0.0706286803499098,73,98,25,1,3,2,2,13,90,33,32
604,0,206,1,92,91,0,10,1,31,30,0,10,1,40,39,0.0,0.0025188059498281084,1,48,47,3,-1,4,3,0,85,66,41
605,0,616,1,100,99,0,62,1,38,37,0,45,1,51,50,0.0,0.005105687736138058,1,52,51,2,-1,3,9,0,29,67,28
606,40,1640,49,100,51,84,84,40,40,0,40,63,49,58,9,0.002212464685659825,0.012934408931549747,45,72,27,1,2,2,11,2,38,42,57
607,38,38,50,50,0,82,82,48,48,0,38,38,50,50,0,0.0029612988869600733,0.0029612988869600733,48,48,0,-1,3,3,7,6,24,70,80
608,0,616,1,100,99,0,54,1,38,37,0,54,1,59,58,0.0,0.0061949011198475104,1,59,58,2,-1,3,8,0,57,40,24
609,152,152,86,86,0,256,256,90,90,0,152,152,86,86,0,0.01596378365499166,0.01596378365499166,76,76,0,-1,2,2,13,9,13,39,79
610,0,0,1,1,0,0,0,1,1,0,0,0,1,1,0,0.0,0.0,1,1,0,-1,-1,-1,8,0,30,36,76
611,0,206,1,89,88,0,48,1,34,33,0,24,1,42,41,0.0,0.005582218591510943,1,58,57,3,-1,4,10,0,12,40,34
612,149,765,90,100,10,56,56,86,86,0,56,56,86,86,0,0.039279757650022125,0.0547670104496409,96,98,2,2,2,2,2,20,95,23,12
613,493,1093,99,100,1,208,208,99,99,0,208,208,99,99,0,0.049763436468225605,0.05575411007862759,96,98,2,2,2,2,7,36,46,2,38
614,32,632,49,100,51,48,48,47,47,0,32,32,49,49,0,0.001599782157323258,0.003880322679464924,43,50,7,2,3,3,6,3,65,51,94
615,0,101,1,77,76,0,10,1,25,24,0,1,1,25,24,0.0,0.0,1,1,0,5,-1,6,10,1,1,45,68
616,39,39,53,53,0,60,60,51,51,0,39,39,52,52,0,0.0045270431260424114,0.0045270431260424114,56,56,0,-1,3,3,5,4,80,22,69
617,16,632,44,100,56,28,48,46,53,7,16,48,43,55,12,0.0011232513019503727,0.026651689982640663,41,90,49,2,3,3,3,2,87,42,7
618,0,206,1,92,91,0,36,1,35,34,0,36,1,50,49,0.0,0.01943565131556554,1,84,83,3,-1,4,6,0,65,98,0
619,0,616,1,100,99,0,28,1,42,41,0,28,1,49,48,0.0,0.015146873617209572,1,79,78,2,-1,3,3,0,75,76,16
620,87,293,72,96,24,48,48,54,54,0,48,48,56,56,0,0.015317063208414174,0.021954457265393648,80,87,7,3,3,3,3,12,87,37,20
621,16,632,38,100,62,56,66,46,53,7,16,66,38,59,21,0.002280540522141666,0.025119983661799246,47,86,39,2,3,3,6,2,74,94,7
622,42,42,51,51,0,76,76,49,49,0,40,40,50,50,0,0.00353994349705572,0.00353994349705572,49,49,0,-1,3,3,6,6,40,41,66
623,132,748,86,100,14,70,70,63,63,0,70,70,66,66,0,0.012185574730249497,0.034718676605738796,72,93,21,2,3,3,5,14,49,14,9
624,52,154,58,90,32,48,48,67,67,0,48,48,70,70,0,0.006126825283365669,0.006467204465774873,56,57,1,4,3,3,3,6,96,13,56
625,80,286,73,100,27,32,32,64,64,0,32,32,64,64,0,0.012559991830899623,0.014772456516559448,74,76,2,3,3,3,2,13,89,33,70
626,6,622,30,100,70,26,50,35,45,10,6,50,30,56,26,0.000442492937131965,0.013785356887572755,36,76,40,2,4,3,5,1,80,49,5
627,0,102,1,81,80,0,6,1,30,29,0,4,1,31,30,0.0,0.0016678579938050988,1,41,40,4,-1,5,3,0,96,85,83
628,16,222,41,93,52,28,28,42,42,0,16,28,41,50,9,0.002212464685659825,0.007862759113652609,47,64,17,3,3,3,3,2,64,94,21
629,0,1640,1,100,99,0,102,1,60,59,0,102,1,74,73,0.0,0.034854828278702475,1,94,93,1,-1,2,8,1,15,45,0
630,2,104,29,81,52,8,8,31,31,0,2,7,29,35,6,0.0002042275094455223,0.0031314884781646754,31,49,18,4,5,5,4,1,77,60,41
631,100,100,63,63,0,100,100,45,45,0,100,100,63,63,0,0.020456788862793153,0.02324789815854862,81,88,7,3,1,1,11,7,19,62,90
632,0,101,1,75,74,0,10,1,24,23,0,1,1,24,23,0.0,3.4037918240920386e-05,1,25,24,5,-1,6,10,1,36,45,68
633,0,206,1,90,89,0,24,1,28,27,0,10,1,34,33,0.0,0.0010211375472276116,1,39,38,3,-1,4,10,0,1,89,43
634,22,638,44,100,56,46,56,43,48,5,22,56,44,57,13,0.003437829742332959,0.01844855168657885,49,80,31,2,3,3,6,3,69,29,23
635,0,616,1,100,99,0,42,1,40,39,0,42,1,50,49,0.0,0.0212056230640934,1,81,80,2,-1,3,6,0,69,89,10
636,16,222,46,96,50,12,12,41,41,0,12,12,41,41,0,0.002927260968719153,0.010075223799312433,49,69,20,3,4,4,2,6,95,41,33
637,16,222,34,90,56,84,88,41,41,0,16,39,34,48,14,0.0009530617107457708,0.003948398515946765,38,54,16,3,3,3,12,2,14,42,35
638,88,704,57,100,43,228,228,75,75,0,88,228,57,91,34,0.006977773239388679,0.02219272269308009,61,85,24,2,2,2,14,7,8,62,18
639,184,800,88,100,12,182,182,91,91,0,182,182,92,92,0,0.019776030497974745,0.027026107083290785,82,87,5,2,2,2,9,12,35,37,27
640,0,0,1,1,0,0,0,1,1,0,0,0,1,1,0,0.0,0.0,1,1,0,-1,-1,-1,3,1,87,69,98
641,84,84,64,64,0,100,100,68,68,0,84,84,63,63,0,0.006535280302256714,0.006535280302256714,59,59,0,-1,2,2,6,5,48,47,79
642,16,1656,33,100,67,94,148,49,78,29,16,148,33,83,50,0.0019061234214915416,0.02831954797644576,43,88,45,1,3,2,9,1,31,53,30
643,0,616,1,100,99,0,42,1,38,37,0,28,1,48,47,0.0,0.00439089145307873,1,50,49,2,-1,3,6,0,59,99,28
644,38,244,53,94,41,88,88,52,52,0,38,45,53,54,1,0.0028932230504782326,0.00353994349705572,50,52,2,3,3,3,8,6,21,70,64
645,0,206,1,92,91,0,20,1,34,33,0,20,1,45,44,0.0,0.007182000748834201,1,62,61,3,-1,4,4,0,47,84,77
646,0,616,1,100,99,0,86,1,36,35,0,29,1,42,41,0.0,0.00439089145307873,1,53,52,2,-1,3,14,0,17,96,22
647,2,618,26,99,73,12,56,26,33,7,2,24,26,44,18,3.4037918240920386e-05,0.004016474352428605,28,51,23,2,5,3,11,1,5,68,29
648,56,158,65,91,26,22,22,49,49,0,22,22,50,50,0,0.007318152421797883,0.007488342013002485,64,65,1,4,3,3,2,7,93,21,4
649,0,616,1,100,99,0,36,1,39,38,0,36,1,50,49,0.0,0.008475441641989176,1,65,64,2,-1,3,5,0,37,91,77
650,0,206,1,92,91,0,10,1,31,30,0,10,1,37,36,0.0,0.0032336022328874367,1,51,50,3,-1,4,3,0,64,66,73
651,377,583,99,100,1,152,152,95,95,0,152,152,95,95,0,0.05279281119166752,0.05463085877667722,98,99,1,3,2,2,5,36,88,2,75
652,8,214,38,97,59,8,8,33,33,0,8,8,38,38,0,0.0005105687736138058,0.004050512270669526,34,50,16,3,4,4,2,2,99,63,73
653,14,14,41,41,0,18,18,36,36,0,14,14,41,41,0,0.0011232513019503727,0.0011232513019503727,38,38,0,-1,4,4,3,4,66,64,85
654,24,24,48,48,0,36,36,41,41,0,24,24,48,48,0,0.0019741992579733825,0.0019741992579733825,44,44,0,-1,3,3,5,3,49,54,84
655,0,206,1,91,90,0,23,1,28,27,0,8,1,32,31,0.0,0.00010211375472276115,1,30,29,3,-1,4,10,0,0,82,56
656,2,208,26,91,65,13,24,28,28,0,2,10,26,34,8,0.0,0.0010211375472276116,1,39,38,3,5,4,10,1,1,68,43
657,0,206,1,90,89,0,20,1,29,28,0,8,1,34,33,0.0,0.0017018959120460194,1,43,42,3,-1,4,8,0,30,93,75
658,8,8,35,35,0,26,26,37,37,0,8,8,35,35,0,0.0010892133837094523,0.0010892133837094523,39,39,0,-1,4,4,5,2,70,74,84
659,492,492,98,98,0,400,400,99,99,0,400,400,99,99,0,0.041594336090404714,0.041594336090404714,95,95,0,-1,2,2,13,29,13,0,69
660,173,789,90,100,10,88,88,81,81,0,88,88,81,81,0,0.019061234214915415,0.03580788998944825,82,94,12,2,2,2,4,15,73,19,18
661,40,40,48,48,0,80,80,45,45,0,40,40,48,48,0,0.0034037918240920387,0.0034037918240920387,48,48,0,-1,2,2,9,1,31,71,89
662,0,616,1,100,99,0,74,1,40,39,0,74,1,61,60,0.0,0.018074134585928724,1,82,81,2,-1,3,9,0,54,66,23
663,22,228,50,93,43,38,38,55,55,0,22,38,50,57,7,0.004731270635487933,0.007998910786616291,56,64,8,3,3,3,3,3,76,29,26
664,0,1640,1,100,99,0,126,1,58,57,0,98,1,58,57,0.0,0.015248987371932332,1,76,75,1,-1,2,15,0,7,96,33
665,6,6,29,29,0,28,28,33,33,0,6,6,29,29,0,0.00037441710065012424,0.00037441710065012424,35,35,0,-1,4,4,8,1,10,88,79
666,78,694,69,100,31,62,72,77,82,5,62,72,78,82,4,0.013070560604513427,0.03512713162462984,75,93,18,2,2,2,3,7,58,48,11
667,146,146,87,87,0,88,88,76,76,0,88,88,79,79,0,0.02314578440382586,0.02314578440382586,87,87,0,-1,2,2,4,17,47,6,69
668,6,6,29,29,0,22,22,29,29,0,6,6,29,29,0,0.0002042275094455223,0.0002042275094455223,32,32,0,-1,4,4,10,1,18,55,99
669,15,631,49,100,51,12,22,35,51,16,12,22,43,53,10,0.0042547397801150485,0.015351101126655093,56,78,22,2,4,3,2,6,86,73,34
670,211,313,97,99,2,56,56,84,84,0,56,56,85,85,0,0.036760951700194014,0.03774805132918071,95,95,0,4,2,2,2,29,98,0,61
671,16,222,33,91,58,52,56,36,37,1,16,29,33,45,12,0.0005786446100956465,0.001599782157323258,35,41,6,3,3,3,9,1,31,49,64
672,22,22,41,41,0,60,60,35,35,0,22,22,41,41,0,0.0013274788113958951,0.0013274788113958951,39,39,0,-1,3,3,11,3,5,51,80
673,0,616,1,100,99,0,60,1,48,47,0,60,1,53,52,0.0,0.024200959869294394,1,89,88,2,-1,3,5,0,52,66,11
674,260,466,92,98,6,304,304,87,87,0,260,266,92,93,1,0.014023622315259198,0.014636304843595765,72,73,1,3,2,2,17,14,20,32,49
675,122,122,81,81,0,78,78,73,73,0,78,78,73,73,0,0.018176248340651485,0.018176248340651485,84,84,0,-1,2,2,4,9,79,39,84
676,100,100,67,67,0,100,100,54,54,0,100,100,67,67,0,0.056843323462337045,0.05704755097178257,99,99,0,4,1,1,9,29,35,11,55
677,351,1991,97,100,3,144,168,91,95,4,144,168,91,95,4,0.035569624561761805,0.05350760747472685,91,97,6,1,2,2,6,29,32,1,75
678,1,1,26,26,0,3,3,26,26,0,1,1,26,26,0,6.807583648184077e-05,6.807583648184077e-05,29,29,0,-1,6,6,3,1,75,68,98
679,100,100,63,63,0,100,100,39,39,0,100,100,63,63,0,0.018176248340651485,0.01834643793185609,78,78,0,3,1,1,14,8,17,44,95
680,184,184,88,88,0,182,182,91,91,0,182,182,92,92,0,0.019776030497974745,0.019776030497974745,82,82,0,-1,2,2,9,12,35,37,97
681,6,622,30,100,70,12,34,30,38,8,6,28,30,47,17,0.00034037918240920387,0.005037611899656217,33,54,21,2,4,3,4,1,53,4,29
682,32,648,50,100,50,66,66,51,51,0,32,66,50,61,11,0.0018040096667687805,0.00980292045338507,45,69,24,2,3,3,6,2,34,61,48
683,46,148,49,83,34,98,98,42,42,0,46,48,49,50,1,0.002552843868069029,0.0026549576227917903,46,47,1,4,2,2,12,3,2,51,95
684,6,6,33,33,0,14,14,33,33,0,6,6,33,33,0,0.0006467204465774873,0.0006467204465774873,36,36,0,-1,4,4,3,2,75,42,50
685,62,678,53,100,47,138,168,62,66,4,62,168,53,84,31,0.0027911092957554717,0.016202049082678104,48,72,24,2,2,2,14,3,25,54,12
686,291,497,98,100,2,72,72,79,79,0,72,72,80,80,0,0.03808843051158991,0.042955852820041523,95,95,0,3,2,2,3,29,75,1,44
687,0,616,1,100,99,0,114,1,62,61,0,114,1,74,73,0.0,0.02644746247319514,1,90,89,2,-1,3,9,1,28,50,0
688,1,207,25,96,71,2,12,25,36,11,1,12,25,41,16,0.0,0.005207801490860819,1,55,54,3,6,4,2,2,99,58,62
689,136,136,84,84,0,248,248,90,90,0,136,136,84,84,0,0.011675005956635693,0.011675005956635693,71,71,0,-1,2,2,11,7,38,62,85
690,0,0,1,1,0,0,0,1,1,0,0,0,1,1,0,0.0,0.0,1,1,0,-1,-1,-1,3,1,76,69,40
691,16,632,35,100,65,32,168,29,67,38,16,168,35,87,52,0.0008509479560230097,0.026209197045508698,35,87,52,2,3,3,13,2,13,58,0
692,0,0,1,1,0,0,0,1,1,0,0,0,1,1,0,0.0,0.0,1,1,0,-1,-1,-1,10,0,1,76,89
693,60,266,69,99,30,56,56,88,88,0,56,56,88,88,0,0.010892133837094524,0.017801831240001363,70,81,11,3,2,2,2,6,93,41,77
694,300,916,96,100,4,376,376,98,98,0,300,376,96,99,3,0.02542632492596753,0.032880629020729094,90,93,3,2,2,2,16,16,9,18,25
695,100,100,63,63,0,100,100,39,39,0,100,100,63,63,0,0.012559991830899623,0.018686817114265293,71,79,8,2,1,1,14,4,17,64,77
696,18,634,44,100,56,62,72,46,48,2,18,72,44,60,16,0.0015657442390823377,0.011266550937744648,43,70,27,2,3,3,7,2,62,61,48
697,6,212,32,93,61,10,18,32,34,2,6,18,32,45,13,0.0004084550188910446,0.01592974573675074,34,80,46,3,4,4,3,1,58,55,9
698,16,632,41,100,59,28,38,42,52,10,16,38,41,54,13,0.0009530617107457708,0.006126825283365669,39,59,20,2,3,3,3,2,64,42,26
699,182,284,86,94,8,320,320,92,92,0,182,184,86,86,0,0.012594029749140543,0.012798257258586064,72,72,0,4,2,2,14,6,16,77,55
700,0,206,1,91,90,0,30,1,34,33,0,30,1,49,48,0.0,0.006058749446883829,1,54,53,3,-1,4,7,0,62,91,31
701,62,678,59,100,41,88,88,73,73,0,62,88,62,73,11,0.006262976956329351,0.017359338302869398,58,82,24,2,2,2,4,6,83,70,17
702,24,24,49,49,0,46,46,40,40,0,24,24,49,49,0,0.0013274788113958951,0.0013274788113958951,41,41,0,-1,3,3,6,3,44,43,36
703,0,206,1,94,93,0,12,1,29,28,0,10,1,36,35,0.0,0.0018720855032506212,1,43,42,3,-1,4,4,0,53,87,70
704,84,186,64,90,26,100,100,68,68,0,84,86,63,64,1,0.006535280302256714,0.006603356138738555,59,59,0,4,2,2,6,5,48,47,4
705,73,73,61,61,0,68,68,66,66,0,73,73,69,69,0,0.006773545729943157,0.006773545729943157,58,58,0,-1,2,2,4,4,53,22,59
706,72,672,67,100,33,38,38,55,55,0,38,38,58,58,0,0.008475441641989176,0.022737329384934817,67,87,20,2,3,3,3,7,76,48,23
707,0,206,1,93,92,0,24,1,33,32,0,24,1,45,44,0.0,0.00442492937131965,1,54,53,3,-1,4,6,0,34,96,57
708,0,206,1,93,92,0,10,1,31,30,0,10,1,37,36,0.0,0.0053099152455835805,1,53,52,3,-1,4,3,0,60,99,34
709,130,336,83,94,11,142,142,79,79,0,142,142,85,85,0,0.009836958371625992,0.013002484768031588,69,75,6,3,2,2,8,13,57,24,28
710,134,334,80,97,17,166,166,88,88,0,134,142,83,83,0,0.013751318969331836,0.015521290717859695,75,75,0,3,2,2,8,6,21,77,54
711,373,989,98,100,2,232,232,91,91,0,232,232,93,93,0,0.0339017665679567,0.04312604241124613,93,96,3,2,2,2,10,29,22,11,33
712,183,799,89,100,11,94,94,72,72,0,94,94,73,73,0,0.02277136730317574,0.03454848701453419,85,89,4,2,2,2,5,16,80,18,39
713,0,616,1,100,99,0,38,1,36,35,0,30,1,46,45,0.0,0.0057524081827155455,1,54,53,2,-1,3,6,0,41,40,72
714,18,634,45,100,55,14,38,34,55,21,18,38,45,56,11,0.0011913271384322134,0.025290173253003846,41,87,46,2,4,3,3,4,60,64,7
715,0,102,1,82,81,0,5,1,29,28,0,4,1,31,30,0.0,0.00030634126416828345,1,32,31,4,-1,5,3,0,60,87,56
716,6,212,32,93,61,10,18,32,35,3,6,18,32,46,14,0.00030634126416828345,0.01317267435923619,33,75,42,3,4,4,3,1,64,65,37
717,78,78,60,60,0,90,90,67,67,0,78,78,65,65,0,0.008135062459579971,0.008135062459579971,60,60,0,-1,2,2,6,4,71,38,45
718,256,462,93,98,5,110,110,74,74,0,110,110,76,76,0,0.021511964328261683,0.023894618605126112,84,86,2,3,2,2,6,19,41,15,46
719,182,182,88,88,0,242,242,80,80,0,182,182,88,88,0,0.010790020082371761,0.010790020082371761,68,68,0,-1,2,2,14,9,8,31,40
720,22,1662,41,100,59,38,90,38,64,26,22,90,41,68,27,0.0013615167296368155,0.04329623200245073,39,96,57,1,3,2,6,3,34,51,2
721,144,744,82,100,18,112,112,92,92,0,112,112,92,92,0,0.012049423057285817,0.020695054290479593,72,86,14,2,2,2,4,6,83,13,33
722,6,622,29,100,71,13,40,29,41,12,6,40,29,52,23,0.0002723033459273631,0.016099935327955343,33,81,48,2,4,3,5,1,61,55,23
723,0,206,1,93,92,0,18,1,39,38,0,18,1,44,43,0.0,0.007794683277170768,1,67,66,3,-1,4,3,0,92,89,20
724,12,12,41,41,0,24,24,38,38,0,12,12,41,41,0,0.0005786446100956465,0.0005786446100956465,36,36,0,-1,4,4,4,2,72,63,85
725,16,222,37,94,57,30,34,34,37,3,16,24,37,48,11,0.0005446066918547262,0.0023486163586235067,36,45,9,3,3,3,6,1,59,88,75
726,10,10,41,41,0,18,18,38,38,0,10,10,41,41,0,0.0013274788113958951,0.0013274788113958951,41,41,0,-1,4,4,3,3,85,43,86
727,100,100,64,64,0,100,100,59,59,0,100,100,64,64,0,0.07175193165186017,0.07175193165186017,100,100,0,-1,1,1,6,36,40,2,84
728,362,568,97,100,3,224,224,97,97,0,224,224,97,97,0,0.037509785901494265,0.04084550188910446,93,96,3,3,2,2,8,27,57,10,47
729,46,146,60,89,29,38,38,59,59,0,38,38,62,62,0,0.010041185881071514,0.010279451308757957,70,70,0,4,3,3,3,5,92,25,63
730,16,632,36,100,64,72,92,46,54,8,16,92,36,66,30,0.001599782157323258,0.011334626774226489,40,70,30,2,3,3,7,1,43,53,48
731,88,190,60,87,27,126,126,69,69,0,88,90,60,61,1,0.007760645358929848,0.007760645358929848,60,60,0,4,2,2,7,4,24,72,95
732,6,6,32,32,0,18,18,36,36,0,6,6,32,32,0,0.0018040096667687805,0.0018040096667687805,45,45,0,-1,4,4,3,1,64,53,40
733,0,616,1,100,99,0,108,1,57,56,0,108,1,74,73,0.0,0.012049423057285817,1,72,71,2,-1,3,12,0,3,82,19
734,0,616,1,100,99,0,76,1,41,40,0,56,1,51,50,0.0,0.008271214132543654,1,63,62,2,-1,3,10,0,0,67,77
735,1,617,26,100,74,6,46,26,42,16,1,46,26,51,25,0.0,0.019265461724360937,1,84,83,2,6,3,6,2,65,58,11
736,0,0,1,1,0,0,0,1,1,0,0,0,1,1,0,0.0,0.0,1,1,0,-1,-1,-1,10,1,36,50,84
737,38,140,49,83,34,90,90,50,50,0,38,38,49,49,0,0.003199564314646516,0.0034037918240920387,49,50,1,4,3,3,9,6,23,70,65
738,0,616,1,100,99,0,102,1,54,53,0,78,1,53,52,0.0,0.008611593314952858,1,64,63,2,-1,3,16,0,4,97,8
739,34,240,56,96,40,22,22,49,49,0,22,22,53,53,0,0.006535280302256714,0.007862759113652609,63,67,4,3,3,3,2,7,90,62,52
740,0,102,1,77,76,0,16,1,27,26,0,2,1,26,25,0.0,0.00010211375472276115,1,27,26,4,-1,5,11,0,33,98,88
741,38,654,47,100,53,106,106,57,57,0,38,95,47,64,17,0.0016338200755641784,0.00881582082439838,41,66,25,2,3,3,10,3,12,43,44
742,84,185,73,93,20,72,72,80,80,0,72,72,80,80,0,0.011300588855985567,0.011334626774226489,74,74,0,6,2,2,3,9,66,31,58
743,24,126,50,85,35,44,44,50,50,0,24,44,50,56,6,0.002757071377514551,0.0034037918240920387,49,50,1,4,3,3,4,3,73,54,74
744,100,100,70,70,0,100,100,53,53,0,100,100,70,70,0,0.03887130263113108,0.03887130263113108,93,93,0,-1,1,1,9,18,31,30,84
745,6,212,32,93,61,10,18,32,34,2,6,18,32,45,13,0.00037441710065012424,0.013444977705163553,33,77,44,3,4,4,3,1,58,88,5
746,100,100,69,69,0,100,100,66,66,0,100,100,72,72,0,0.04680213758126553,0.05405221416658157,96,98,2,2,1,1,6,17,44,6,57
747,100,100,58,58,0,100,100,35,35,0,100,100,59,59,0,0.012764219340345145,0.03628442084482113,70,92,22,1,1,1,17,3,20,29,9
748,0,1640,1,100,99,0,104,1,57,56,0,104,1,74,73,0.0,0.01940161339732462,1,83,82,1,-1,2,10,0,18,99,33
749,80,1720,69,100,31,60,84,52,73,21,60,84,62,74,12,0.008101024541339052,0.04401102828551006,65,97,32,1,3,2,5,9,45,31,10
750,6,212,28,92,64,15,24,28,33,5,6,24,28,43,15,0.0002723033459273631,0.004765308553728854,31,50,19,3,4,4,6,1,56,55,57
751,88,189,73,92,19,48,48,64,64,0,48,48,66,66,0,0.012287688484972258,0.012287688484972258,73,73,0,6,3,3,3,8,85,17,58
752,12,628,43,100,57,12,22,37,53,16,12,22,42,53,11,0.002757071377514551,0.016372238673882704,47,80,33,2,4,3,2,2,99,83,39
753,100,100,69,69,0,100,100,55,55,0,100,100,69,69,0,0.049389019367575476,0.07158174206065557,97,100,3,2,1,1,9,29,26,0,1
754,16,16,42,42,0,22,22,42,42,0,16,16,42,42,0,0.00353994349705572,0.00353994349705572,52,52,0,-1,3,3,2,1,68,90,91
755,15,116,49,84,35,12,12,35,35,0,12,12,43,43,0,0.0042547397801150485,0.0042547397801150485,56,56,0,5,4,4,2,6,86,73,95
756,0,0,1,1,0,0,0,1,1,0,0,0,1,1,0,0.0,0.0,1,1,0,-1,-1,-1,10,0,22,91,40
757,40,656,47,100,53,45,90,39,63,24,40,90,47,68,21,0.006977773239388679,0.015487252799618776,56,78,22,2,2,2,6,1,51,78,21
758,192,808,86,100,14,320,320,95,95,0,192,216,86,87,1,0.012049423057285817,0.013785356887572755,70,71,1,2,2,2,14,7,25,21,54
759,142,142,83,83,0,110,110,81,81,0,110,110,82,82,0,0.0123557643214541,0.0123557643214541,73,73,0,-1,2,2,6,9,65,27,99
760,28,1668,51,100,49,28,52,46,77,31,28,52,51,79,28,0.0026549576227917903,0.04142414649920011,48,96,48,1,3,2,3,3,85,54,62
761,205,205,92,92,0,136,136,98,98,0,136,136,98,98,0,0.03158718812757412,0.03158718812757412,91,91,0,-1,2,2,4,15,77,16,66
762,28,234,40,90,50,42,42,36,36,0,28,36,40,44,4,0.0012594029749140542,0.0022465026039007454,37,40,3,3,3,3,6,4,51,64,61
763,128,334,85,99,14,94,94,75,75,0,94,94,75,75,0,0.018925082541951733,0.021750229755948126,81,83,2,3,2,2,5,9,49,39,72
764,16,632,42,100,58,28,38,43,51,8,16,38,42,54,12,0.0018380475850097008,0.008543517478471017,43,69,26,2,3,3,3,1,66,53,31
765,170,170,86,86,0,158,158,97,97,0,158,158,97,97,0,0.017018959120460194,0.017018959120460194,80,80,0,-1,2,2,6,9,34,27,76
766,223,223,90,90,0,160,160,86,86,0,160,160,88,88,0,0.02573266619013581,0.02573266619013581,87,87,0,-1,2,2,7,20,24,23,67
767,2,618,25,100,75,18,58,27,35,8,2,36,25,49,24,6.807583648184077e-05,0.005480104836788182,27,55,28,2,5,3,10,1,36,95,72
768,16,632,34,100,66,40,50,40,45,5,16,34,34,48,14,0.0018720855032506212,0.006399128629293032,44,57,13,2,3,3,5,2,50,94,75
769,46,662,48,100,52,130,144,61,62,1,46,144,48,83,35,0.0013955546478777359,0.016133973246196264,42,73,31,2,2,2,14,2,25,56,23
770,178,794,93,100,7,72,72,77,77,0,72,72,79,79,0,0.026855917492086184,0.04312604241124613,91,95,4,2,2,2,3,20,96,23,16
771,158,260,84,93,9,228,228,89,89,0,158,160,84,84,0,0.011198475101262807,0.011981347220803976,70,72,2,4,2,2,11,7,19,21,71
772,16,632,35,100,65,72,96,37,42,5,16,62,35,53,18,0.0014636304843595766,0.006501242384015794,40,56,16,2,3,3,11,1,5,71,35
773,0,206,1,90,89,0,12,1,31,30,0,8,1,36,35,0.0,0.0007488342013002485,1,38,37,3,-1,4,4,0,79,87,74
774,6,212,29,92,63,36,36,32,32,0,6,14,29,33,4,0.00017018959120460194,0.0009530617107457708,30,38,8,3,4,4,12,1,6,60,74
775,56,672,63,100,37,62,72,77,82,5,56,72,77,82,5,0.006909697402906838,0.0313829606181286,62,91,29,2,2,2,3,2,58,52,1
776,66,66,61,61,0,54,54,56,56,0,54,54,57,57,0,0.006535280302256714,0.006535280302256714,55,55,0,-1,3,3,4,6,67,13,96
777,0,206,1,94,93,0,18,1,35,34,0,18,1,44,43,0.0,0.008305252050784574,1,68,67,3,-1,4,3,0,66,82,14
778,194,810,90,100,10,118,118,92,92,0,118,118,92,92,0,0.02913645801422785,0.03533135913407536,87,91,4,2,2,2,5,16,70,12,26
779,0,0,1,1,0,0,0,1,1,0,0,0,1,1,0,0.0,0.0,1,1,0,-1,-1,-1,8,0,21,67,92
780,0,101,1,76,75,0,11,1,25,24,0,1,1,25,24,0.0,3.4037918240920386e-05,1,26,25,5,-1,6,11,0,38,89,95
781,626,626,100,100,0,384,384,100,100,0,384,384,100,100,0,0.05207801490860819,0.05207801490860819,99,99,0,-1,2,2,12,36,14,2,99
782,322,528,96,99,3,216,216,96,96,0,216,216,96,96,0,0.0313829606181286,0.033050818611933694,91,91,0,3,2,2,9,22,29,9,70
783,23,229,53,94,41,24,24,40,40,0,24,24,53,53,0,0.0038462847612240037,0.008577555396711936,53,66,13,3,4,4,4,6,78,35,38
784,78,694,58,100,42,122,122,72,72,0,78,122,58,79,21,0.00793083495013445,0.013581129378127233,62,75,13,2,2,2,8,4,10,38,21
785,132,132,83,83,0,180,180,80,80,0,132,132,83,83,0,0.01405766023350012,0.01405766023350012,76,76,0,-1,2,2,11,8,38,8,85
786,40,246,55,95,40,62,62,77,77,0,40,62,66,78,12,0.008135062459579971,0.011709043874876613,67,76,9,3,2,2,3,3,66,46,28
787,16,222,40,95,55,60,60,52,52,0,16,28,40,48,8,0.002757071377514551,0.005854521937438306,49,56,7,3,3,3,5,2,45,94,29
788,88,88,60,60,0,196,196,72,72,0,88,88,60,60,0,0.007590455767725246,0.007590455767725246,61,61,0,-1,2,2,12,7,14,62,85
789,16,117,41,84,43,24,24,43,43,0,16,17,42,45,3,0.0007488342013002485,0.0008509479560230097,36,37,1,5,3,3,3,1,55,49,60
790,0,616,1,100,99,0,94,1,44,43,0,94,1,59,58,0.0,0.027264372510977228,1,90,89,2,-1,3,9,0,29,76,3
791,0,206,1,90,89,0,25,1,29,28,0,6,1,28,27,0.0,0.0005446066918547262,1,36,35,3,-1,4,10,0,1,80,42
792,100,100,72,72,0,100,100,77,77,0,100,100,77,77,0,0.036454610436025735,0.03795227883862623,94,94,0,3,1,1,6,6,69,73,52
793,0,616,1,100,99,0,46,1,38,37,0,40,1,53,52,0.0,0.006637394056979475,1,60,59,2,-1,3,8,0,57,98,48
794,54,260,62,94,32,48,48,63,63,0,48,48,64,64,0,0.006875659484665918,0.010143299635794275,62,72,10,3,3,3,3,7,82,62,26
795,99,305,75,97,22,52,52,74,74,0,52,52,76,76,0,0.012662105585622384,0.031621226045815035,73,91,18,3,2,2,3,13,58,24,7
796,26,642,48,100,52,58,82,44,55,11,26,82,48,64,16,0.0053439531638245,0.026243234963749616,53,88,35,2,3,3,7,6,62,73,1
797,54,54,64,64,0,38,38,52,52,0,38,38,55,55,0,0.006433166547533953,0.006433166547533953,62,62,0,-1,3,3,3,4,66,72,79
798,0,616,1,100,99,0,62,1,38,37,0,45,1,51,50,0.0,0.005173763572619898,1,53,52,2,-1,3,9,0,29,99,28
799,0,616,1,100,99,0,46,1,36,35,0,30,1,45,44,0.0,0.0053439531638245,1,56,55,2,-1,3,8,0,10,66,38
800,12,218,39,95,56,14,14,34,34,0,12,18,39,44,5,0.00030634126416828345,0.0007488342013002485,33,35,2,3,4,4,3,2,60,56,88
801,2,104,26,77,51,12,14,27,28,1,2,4,26,28,2,3.4037918240920386e-05,0.00017018959120460194,27,31,4,4,5,5,10,2,1,58,65
802,2,618,26,100,74,6,46,26,47,21,2,46,26,54,28,6.807583648184077e-05,0.006126825283365669,27,57,30,2,5,3,5,1,61,78,47
803,0,0,1,1,0,0,0,1,1,0,0,0,1,1,0,0.0,0.0,1,1,0,-1,-1,-1,6,0,65,89,93
804,307,307,98,98,0,112,112,93,93,0,112,112,93,93,0,0.03625038292658021,0.03625038292658021,93,93,0,-1,2,2,4,29,47,0,85
805,126,742,82,100,18,180,180,80,80,0,126,142,82,85,3,0.013444977705163553,0.014704380680077607,74,76,2,2,2,2,11,8,38,17,42
806,22,228,41,94,53,48,52,36,38,2,22,58,41,55,14,0.0014295925661186562,0.0053099152455835805,41,54,13,3,3,3,9,3,35,51,13
807,0,101,1,81,80,0,2,1,25,24,0,1,1,25,24,0.0,0.00010211375472276115,1,28,27,5,-1,6,2,0,95,79,4
808,130,230,85,97,12,72,72,85,85,0,72,72,85,85,0,0.020456788862793153,0.023622315259198747,82,89,7,4,2,2,3,18,94,30,57
809,2,2,27,27,0,8,8,31,31,0,2,2,27,27,0,0.00030634126416828345,0.00030634126416828345,33,33,0,-1,5,5,4,1,79,88,93
810,118,118,87,87,0,46,46,82,82,0,46,46,82,82,0,0.018891044623710815,0.018891044623710815,81,81,0,-1,2,2,2,15,95,19,40
811,0,206,1,88,87,0,30,1,33,32,0,15,1,34,33,0.0,0.002825147213996392,1,47,46,3,-1,4,7,0,24,99,22
812,0,206,1,96,95,0,12,1,38,37,0,12,1,44,43,0.0,0.019810068416215663,1,84,83,3,-1,4,2,1,93,69,10
813,0,0,1,1,0,0,0,1,1,0,0,0,1,1,0,0.0,0.0,1,1,0,-1,-1,-1,12,0,6,59,45
814,116,218,76,89,13,228,228,75,75,0,116,118,76,76,0,0.00881582082439838,0.00888389666088022,64,65,1,4,2,2,14,7,16,48,65
815,52,258,56,94,38,44,44,49,49,0,44,44,55,55,0,0.008577555396711936,0.009258313761530345,66,68,2,3,3,3,4,6,79,34,74
816,1,103,25,82,57,3,6,25,28,3,1,2,25,26,1,0.00010211375472276115,0.0009530617107457708,29,37,8,4,6,5,3,1,66,68,71
817,362,362,97,97,0,224,224,97,97,0,224,224,97,97,0,0.037509785901494265,0.037509785901494265,93,93,0,-1,2,2,8,27,57,10,84
818,1,207,26,92,66,4,24,26,36,10,1,24,26,53,27,6.807583648184077e-05,0.019912182170938427,29,84,55,3,6,4,4,1,77,68,1
819,403,2003,100,100,0,120,120,100,100,0,120,120,100,100,0,0.06031519112291092,0.10170529970387011,97,100,3,1,2,2,3,36,66,2,0
820,2,104,26,71,45,10,10,28,28,0,2,4,26,28,2,0.00010211375472276115,0.00010211375472276115,29,29,0,4,5,5,7,1,24,68,95
821,77,693,62,100,38,60,70,51,55,4,60,70,57,62,5,0.006943735321147759,0.012185574730249497,61,73,12,2,3,3,5,8,37,57,90
822,0,616,1,100,99,0,46,1,42,41,0,46,1,51,50,0.0,0.014227849824704722,1,76,75,2,-1,3,6,0,65,85,12
823,154,154,90,90,0,88,88,76,76,0,88,88,79,79,0,0.02049082678103407,0.02049082678103407,85,85,0,-1,2,2,4,18,47,5,84
824,22,22,40,40,0,48,48,38,38,0,22,22,40,40,0,0.0005786446100956465,0.0005786446100956465,34,34,0,-1,3,3,7,2,46,56,86
825,2,618,28,100,72,8,23,28,35,7,2,20,28,44,16,0.00013615167296368154,0.006024711528642908,30,57,27,2,5,3,5,1,45,65,83
826,450,450,100,100,0,280,280,99,99,0,280,280,99,99,0,0.032199870655910685,0.032199870655910685,91,91,0,-1,2,2,10,27,18,10,67
827,209,311,93,96,3,128,128,93,93,0,128,128,93,93,0,0.031076619353960312,0.0313829606181286,89,89,0,4,2,2,5,15,70,16,88
828,139,139,90,90,0,56,56,84,84,0,56,56,84,84,0,0.02467749072466728,0.02467749072466728,87,87,0,-1,2,2,2,17,86,6,36
829,16,632,38,100,62,114,124,61,65,4,16,124,38,80,42,0.0020422750944552232,0.015725518227305217,43,76,33,2,3,3,9,1,54,53,12
830,0,0,1,1,0,0,0,1,1,0,0,0,1,1,0,0.0,0.0,1,1,0,-1,-1,-1,17,0,20,93,36
831,126,126,83,83,0,222,222,83,83,0,126,126,83,83,0,0.01153885428367201,0.01153885428367201,73,73,0,-1,2,2,13,8,13,17,45
832,237,338,93,98,5,96,96,87,87,0,96,96,87,87,0,0.027638789611627353,0.027672827529868275,90,90,0,5,2,2,3,19,87,15,65
833,42,658,50,100,50,60,60,49,49,0,40,60,49,56,7,0.004050512270669526,0.008271214132543654,50,64,14,2,3,3,5,6,50,41,29
834,58,658,58,100,42,110,110,77,77,0,58,110,58,80,22,0.004765308553728854,0.023111746485584943,56,85,29,2,2,2,6,6,44,70,9
835,81,287,75,99,24,32,32,63,63,0,32,32,65,65,0,0.012491915994417782,0.01763164164879676,78,83,5,3,3,3,2,13,98,33,62
836,16,16,36,36,0,60,60,37,37,0,16,16,36,36,0,0.0006467204465774873,0.0006467204465774873,37,37,0,-1,3,3,11,1,38,49,80
837,16,16,38,38,0,30,30,36,36,0,16,16,38,38,0,0.0007488342013002485,0.0007488342013002485,37,37,0,-1,3,3,6,1,74,4,36
838,100,100,73,73,0,100,100,87,87,0,100,100,87,87,0,0.055243541305013785,0.055243541305013785,98,98,0,-1,1,1,4,15,79,19,91
839,240,240,90,90,0,300,300,91,91,0,240,240,90,90,0,0.011845195547840293,0.011845195547840293,68,68,0,-1,2,2,14,9,25,31,79
840,100,100,70,70,0,100,100,73,73,0,100,100,74,74,0,0.059702508594574356,0.06664624391572212,100,100,0,2,1,1,6,30,71,7,34
841,40,40,51,51,0,102,102,66,66,0,40,40,51,51,0,0.004288777698355968,0.004288777698355968,53,53,0,-1,2,2,8,2,10,94,84
842,104,104,82,82,0,112,112,95,95,0,112,112,95,95,0,0.021035433472888797,0.021035433472888797,84,84,0,-1,2,2,4,5,73,25,86
843,100,100,60,60,0,100,100,50,50,0,100,100,60,60,0,0.028762040913577726,0.03427618366860683,90,92,2,2,1,1,9,14,28,14,38
844,0,1640,1,100,99,0,156,1,65,64,0,156,1,87,86,0.0,0.02828551005820484,1,89,88,1,-1,2,12,0,6,81,7
845,0,0,1,1,0,0,0,1,1,0,0,0,1,1,0,0.0,0.0,1,1,0,-1,-1,-1,14,0,16,66,92
846,24,230,48,93,45,38,38,59,59,0,24,38,49,61,12,0.0026209197045508697,0.006841621566424997,46,62,16,3,3,3,3,3,92,54,13
847,332,932,95,100,5,168,168,96,96,0,168,168,96,96,0,0.03240409816535621,0.04581503795227884,91,97,6,2,2,2,6,22,40,9,15
848,83,183,80,97,17,32,32,67,67,0,32,32,68,68,0,0.013376901868681712,0.017223186629905716,76,80,4,4,3,3,2,15,97,19,38
849,16,1656,34,100,66,40,136,33,63,30,16,108,34,74,40,0.0004084550188910446,0.02100139555464788,35,81,46,1,3,2,12,1,3,4,39
850,88,704,62,100,38,152,152,76,76,0,88,152,62,84,22,0.00803294870485721,0.015419176963136935,62,79,17,2,2,2,8,4,15,72,21
851,0,0,1,1,0,0,0,1,1,0,0,0,1,1,0,0.0,0.0,1,1,0,-1,-1,-1,3,0,94,76,89
852,297,913,97,100,3,96,96,72,72,0,96,96,72,72,0,0.03100854351747847,0.03859899928520372,92,95,3,2,3,3,6,29,71,1,34
853,208,1808,87,100,13,248,248,89,89,0,208,248,88,91,3,0.01923142380612002,0.04319411824772797,81,96,15,1,2,2,11,12,5,37,1
854,0,616,1,100,99,0,58,1,43,42,0,58,1,56,55,0.0,0.015146873617209572,1,77,76,2,-1,3,7,0,62,92,37
855,66,168,69,91,22,38,38,59,59,0,38,38,62,62,0,0.006773545729943157,0.007352190340038803,61,65,4,4,3,3,3,6,92,13,71
856,180,386,90,98,8,232,232,92,92,0,180,186,91,91,0,0.013955546478777357,0.015283025290173252,76,77,1,3,2,2,10,9,1,27,53
857,0,206,1,89,88,0,29,1,32,31,0,9,1,36,35,0.0,0.0013955546478777359,1,40,39,3,-1,4,9,0,26,82,54
858,0,0,1,1,0,0,0,1,1,0,0,0,1,1,0,0.0,0.0,1,1,0,-1,-1,-1,11,0,19,86,36
859,132,132,87,87,0,72,72,83,83,0,72,72,83,83,0,0.016338200755641786,0.016338200755641786,80,80,0,-1,2,2,3,14,58,14,85
860,44,146,52,81,29,102,102,68,68,0,44,46,52,52,0,0.00707988699411144,0.007113924912352361,62,62,0,4,3,3,7,4,43,72,95
861,0,0,1,1,0,0,0,1,1,0,0,0,1,1,0,0.0,0.0,1,1,0,-1,-1,-1,2,0,86,97,89
862,136,752,79,100,21,216,216,93,93,0,136,166,80,87,7,0.011368664692467409,0.016270124919159943,73,78,5,2,2,2,9,7,28,62,38
863,96,302,66,95,29,118,118,68,68,0,96,104,66,75,9,0.006501242384015794,0.007386228258279724,61,62,1,3,3,3,8,6,21,13,51
864,0,0,1,1,0,0,0,1,1,0,0,0,1,1,0,0.0,0.0,1,1,0,-1,-1,-1,4,1,84,50,91
865,6,107,29,75,46,27,27,30,30,0,6,7,29,32,3,0.0002382654276864427,0.00030634126416828345,31,33,2,6,4,4,12,1,14,65,78
866,22,638,50,100,50,28,38,44,54,10,22,38,50,57,7,0.00176997174852786,0.02324789815854862,42,88,46,2,3,3,3,2,76,74,10
867,273,273,95,95,0,248,248,98,98,0,248,248,98,98,0,0.0195377650702883,0.0195377650702883,82,82,0,-1,2,2,8,15,30,19,59
868,111,727,79,100,21,120,120,80,80,0,120,120,81,81,0,0.010415602981721638,0.023588277340957826,70,88,18,2,2,2,6,8,34,44,15
869,0,102,1,79,78,0,6,1,28,27,0,4,1,30,29,0.0,0.0018720855032506212,1,41,40,4,-1,5,3,0,94,80,75
870,100,100,65,65,0,100,100,47,47,0,100,100,65,65,0,0.030566050580346504,0.03403791824092039,89,93,4,2,1,1,11,9,38,39,72
871,24,640,46,100,54,58,68,38,39,1,24,68,46,58,12,0.001157289220191293,0.006535280302256714,40,59,19,2,3,3,8,4,15,64,34
872,207,413,93,100,7,96,96,89,89,0,96,96,89,89,0,0.02569862827189489,0.03315293236665646,89,93,4,3,2,2,3,17,64,6,33
873,0,616,1,100,99,0,116,1,55,54,0,108,1,74,73,0.0,0.011266550937744648,1,70,69,2,-1,3,14,0,16,66,14
874,0,616,1,99,98,0,78,1,40,39,0,46,1,47,46,0.0,0.004595118962524252,1,52,51,2,-1,3,11,0,33,86,47
875,60,266,59,94,35,54,54,53,53,0,54,54,57,57,0,0.005105687736138058,0.012083460975526737,56,75,19,3,3,3,4,5,79,47,31
876,16,632,33,100,67,25,52,32,39,7,16,46,33,52,19,0.0004084550188910446,0.005037611899656217,30,52,22,2,3,3,6,1,51,65,38
877,15,631,43,100,57,18,38,38,54,16,18,38,47,57,10,0.0035739814152966403,0.01766567956703768,53,83,30,2,4,3,3,6,76,73,14
878,40,40,57,57,0,68,68,76,76,0,40,40,57,57,0,0.004901460226692535,0.004901460226692535,57,57,0,-1,2,2,4,2,78,42,40
879,166,166,87,87,0,104,104,82,82,0,104,104,83,83,0,0.017223186629905716,0.017223186629905716,80,80,0,-1,2,2,5,13,50,33,67
880,0,0,1,1,0,0,0,1,1,0,0,0,1,1,0,0.0,0.0,1,1,0,-1,-1,-1,10,1,0,50,80
881,16,118,34,76,42,76,76,38,38,0,16,18,34,40,6,0.0007488342013002485,0.0008169100377820892,37,37,0,4,3,3,12,1,2,49,4
882,0,0,1,1,0,0,0,1,1,0,0,0,1,1,0,0.0,0.0,1,1,0,-1,-1,-1,10,0,1,96,79
883,40,40,51,51,0,102,102,66,66,0,40,40,51,51,0,0.004288777698355968,0.004288777698355968,53,53,0,-1,2,2,8,2,10,94,91
884,12,12,40,40,0,18,18,38,38,0,12,12,40,40,0,0.002212464685659825,0.002212464685659825,49,49,0,-1,4,4,3,2,76,75,50
885,462,1078,98,100,2,312,312,98,98,0,312,312,98,98,0,0.037475747983253344,0.05391606249361789,97,100,3,2,2,2,12,29,2,11,23
886,33,649,55,100,45,28,48,46,67,21,28,48,53,68,15,0.003880322679464924,0.022533101875489295,53,86,33,2,3,3,3,6,81,35,12
887,2,2,28,28,0,4,4,30,30,0,2,2,28,28,0,0.0002723033459273631,0.0002723033459273631,34,34,0,-1,5,5,2,1,89,60,69
888,420,1020,99,100,1,288,288,99,99,0,288,288,99,99,0,0.035025017869907075,0.038905340549372,93,93,0,2,2,2,9,29,28,0,26
889,16,16,35,35,0,40,40,35,35,0,16,16,35,35,0,0.0004084550188910446,0.0004084550188910446,36,36,0,-1,3,3,7,1,24,88,36
890,0,0,1,1,0,0,0,1,1,0,0,0,1,1,0,0.0,0.0,1,1,0,-1,-1,-1,5,0,50,66,82
891,56,262,55,94,39,154,154,72,72,0,56,82,55,58,3,0.00622893903808843,0.00980292045338507,58,68,10,3,2,2,10,3,36,29,47
892,140,756,89,100,11,32,32,69,69,0,32,32,69,69,0,0.021239660982334322,0.029715102624323496,87,90,3,2,3,3,2,19,93,15,24
893,0,0,1,1,0,0,0,1,1,0,0,0,1,1,0,0.0,0.0,1,1,0,-1,-1,-1,6,0,65,98,85
894,56,157,57,86,29,78,78,69,69,0,56,57,62,62,0,0.006841621566424997,0.006841621566424997,59,59,0,5,2,2,4,3,53,29,68
895,0,616,1,100,99,0,22,1,51,50,0,22,1,54,53,0.0,0.022022533101875488,1,88,87,2,-1,3,2,0,98,82,30
896,68,170,57,85,28,110,110,78,78,0,68,72,58,59,1,0.008679669151434699,0.008986010415602982,66,67,1,4,2,2,6,4,51,72,63
897,22,123,46,87,41,28,28,44,44,0,22,23,47,48,1,0.004118588107151367,0.004152626025392287,49,49,0,5,3,3,3,2,92,83,60
898,57,673,56,100,44,44,54,48,51,3,44,54,54,54,0,0.004152626025392287,0.02307770856734402,53,87,34,2,3,3,4,6,83,35,15
899,16,632,35,100,65,100,110,45,60,15,16,110,35,78,43,0.0026549576227917903,0.013410939786922631,47,76,29,2,3,3,10,2,1,94,19
900,100,100,58,58,0,100,100,35,35,0,100,100,59,59,0,0.05691139929881889,0.05691139929881889,100,100,0,-1,1,1,17,40,20,3,98
901,1,207,25,96,71,2,8,25,31,6,1,7,25,36,11,0.0,0.0021784267674189047,1,45,44,3,6,4,2,2,98,58,90
902,144,350,85,96,11,284,284,86,86,0,144,152,85,85,0,0.009939072126348753,0.011334626774226489,67,72,5,3,2,2,16,7,4,21,83
903,16,632,48,100,52,12,22,35,51,16,12,22,42,54,12,0.0028591851322373124,0.011164437183021887,51,72,21,2,4,3,2,6,98,41,72
904,96,712,78,100,22,72,72,85,85,0,72,72,85,85,0,0.016508390346846386,0.03985840226011777,81,94,13,2,2,2,3,8,60,20,11
905,100,100,65,65,0,100,100,47,47,0,100,100,65,65,0,0.023179822322066782,0.027672827529868275,84,88,4,2,1,1,11,9,38,31,44
906,6,212,28,89,61,42,60,32,34,2,6,14,28,31,3,0.0002042275094455223,0.0015657442390823377,29,39,10,3,4,4,14,1,17,4,61
907,0,206,1,88,87,0,17,1,27,26,0,6,1,28,27,0.0,0.00013615167296368154,1,29,28,3,-1,4,11,0,33,76,95
908,100,100,63,63,0,100,100,39,39,0,100,100,63,63,0,0.019095272133156337,0.02049082678103407,80,82,2,2,1,1,14,8,17,57,43
909,39,39,54,54,0,76,76,54,54,0,39,39,54,54,0,0.0042547397801150485,0.0042547397801150485,53,53,0,-1,3,3,6,4,32,22,79
910,40,246,51,94,43,102,102,61,61,0,40,46,51,52,1,0.0038462847612240037,0.005480104836788182,52,56,4,3,2,2,8,3,15,46,53
911,128,1768,78,100,22,118,142,63,71,8,128,142,78,79,1,0.012015385139044895,0.03791824092038531,76,94,18,1,3,2,8,8,42,8,16
912,28,644,44,100,56,64,84,41,47,6,28,84,44,65,21,0.0017018959120460194,0.01575955614554614,42,77,35,2,3,3,9,3,31,43,18
913,16,16,44,44,0,44,44,50,50,0,16,16,44,44,0,0.0018720855032506212,0.0018720855032506212,44,44,0,-1,3,3,4,1,84,53,99
914,86,702,59,100,41,126,126,69,69,0,86,126,59,77,18,0.009632730862180468,0.0156914803090643,66,76,10,2,2,2,7,6,24,34,48
915,50,50,60,60,0,54,54,55,55,0,54,54,60,60,0,0.005480104836788182,0.005480104836788182,56,56,0,-1,3,3,4,5,84,47,86
916,162,762,91,100,9,88,88,76,76,0,88,88,79,79,0,0.01940161339732462,0.025324211171244768,84,88,4,2,2,2,4,14,47,14,22
917,16,16,39,39,0,56,56,49,49,0,16,16,39,39,0,0.0034718676605738795,0.0034718676605738795,50,50,0,-1,3,3,6,3,69,46,96
918,16,632,35,100,65,88,88,48,48,0,16,50,35,52,17,0.003165526396405596,0.008509479560230097,49,64,15,2,3,3,8,1,15,90,62
919,12,12,38,38,0,44,44,36,36,0,12,12,38,38,0,0.0007488342013002485,0.0007488342013002485,38,38,0,-1,4,4,8,3,57,51,36
920,0,0,1,1,0,0,0,1,1,0,0,0,1,1,0,0.0,0.0,1,1,0,-1,-1,-1,5,1,50,45,67
921,58,264,68,98,30,46,46,82,82,0,46,46,83,83,0,0.011062323428299126,0.018142210422410564,71,83,12,3,2,2,2,4,98,72,17
922,0,616,1,100,99,0,54,1,51,50,0,54,1,54,53,0.0,0.027911092957554715,1,88,87,2,-1,3,4,0,83,76,11
923,6,107,31,80,49,14,14,32,32,0,6,7,31,33,2,0.00034037918240920387,0.00037441710065012424,32,32,0,6,4,4,3,1,94,60,58
924,282,898,94,100,6,296,296,90,90,0,296,296,94,94,0,0.02396269444160795,0.025766704108376733,87,89,2,2,2,2,14,15,25,16,54
925,2,2,28,28,0,7,7,28,28,0,2,2,28,28,0,0.00017018959120460194,0.00017018959120460194,31,31,0,-1,5,5,4,1,84,95,82
926,126,126,84,84,0,48,48,70,70,0,48,48,72,72,0,0.021784267674189048,0.021784267674189048,85,85,0,-1,3,3,3,15,94,16,91
927,16,16,36,36,0,44,44,36,36,0,16,16,36,36,0,0.0005446066918547262,0.0005446066918547262,36,36,0,-1,3,3,9,1,23,49,50
928,146,352,83,96,13,188,188,82,82,0,146,154,83,84,1,0.013513053541645392,0.014568229007113924,74,76,2,3,2,2,10,9,11,27,43
929,422,1038,99,100,1,144,144,91,91,0,144,144,92,92,0,0.047993464719697745,0.05248646992749923,99,99,0,2,2,2,6,36,51,2,26
930,100,100,69,69,0,100,100,55,55,0,100,100,69,69,0,0.049389019367575476,0.05592429966983219,97,98,1,3,1,1,9,29,26,0,33
931,16,222,40,92,52,28,32,38,40,2,16,29,40,47,7,0.0007828721195411688,0.002825147213996392,37,47,10,3,3,3,5,1,88,4,70
932,64,664,57,100,43,86,86,56,56,0,64,86,57,65,8,0.006705469893461316,0.024881718234112803,62,87,25,2,3,3,6,4,59,72,7
933,0,616,1,100,99,0,28,1,44,43,0,28,1,48,47,0.0,0.018108172504169646,1,84,83,2,-1,3,3,0,60,79,5
934,0,206,1,96,95,0,7,1,31,30,0,6,1,31,30,0.0,0.0006467204465774873,1,37,36,3,-1,4,2,0,98,67,42
935,0,616,1,100,99,0,70,1,41,40,0,41,1,54,53,0.0,0.007624493685966166,1,63,62,2,-1,3,9,0,28,89,25
936,16,16,36,36,0,68,68,41,41,0,16,16,36,36,0,0.0012594029749140542,0.0012594029749140542,39,39,0,-1,3,3,8,1,30,71,59
937,40,40,52,52,0,106,106,66,66,0,40,40,52,52,0,0.004356853534837809,0.004356853534837809,54,54,0,-1,2,2,7,3,24,46,98
938,224,430,91,96,5,246,246,95,95,0,246,246,95,95,0,0.017801831240001363,0.018176248340651485,78,78,0,3,2,2,10,13,12,33,88
939,148,354,85,97,12,110,110,83,83,0,110,110,83,83,0,0.01409169815174104,0.020626978453997753,73,80,7,3,2,2,6,14,71,32,77
940,2,208,26,87,61,12,52,28,33,5,2,28,26,44,18,0.0,0.003778208924742163,1,50,49,3,5,4,10,1,22,68,47
941,0,206,1,95,94,0,8,1,32,31,0,6,1,32,31,0.0,0.0014636304843595766,1,41,40,3,-1,4,2,0,89,76,53
942,0,206,1,94,93,0,20,1,33,32,0,8,1,34,33,0.0,0.0011913271384322134,1,39,38,3,-1,4,6,0,32,93,52
943,6,212,32,94,62,10,18,32,37,5,6,18,32,46,14,0.0002382654276864427,0.00616086320160659,31,62,31,3,4,4,3,1,81,88,44
944,46,46,48,48,0,140,140,65,65,0,46,46,48,48,0,0.0021784267674189047,0.0021784267674189047,43,43,0,-1,2,2,11,2,33,61,91
945,0,206,1,96,95,0,8,1,33,32,0,8,1,39,38,0.0,0.0053099152455835805,1,56,55,3,-1,4,2,1,93,45,21
946,0,102,1,75,74,0,11,1,27,26,0,2,1,25,24,0.0,0.00030634126416828345,1,29,28,4,-1,5,8,0,27,92,88
947,44,660,57,100,43,38,48,56,59,3,38,48,59,62,3,0.0057524081827155455,0.01678069369277375,58,82,24,2,3,3,3,4,58,38,39
948,0,616,1,100,99,0,38,1,58,57,0,38,1,60,59,0.0,0.02811532046700024,1,87,86,2,-1,3,3,0,92,93,11
949,6,622,30,100,70,7,18,30,40,10,6,17,30,44,14,0.0002723033459273631,0.005241839409101739,31,55,24,2,4,3,2,1,91,78,51
950,6,1646,28,100,72,20,104,29,62,33,6,104,28,80,52,6.807583648184077e-05,0.020695054290479593,28,84,56,1,4,2,9,1,31,95,14
951,0,616,1,100,99,0,70,1,41,40,0,41,1,54,53,0.0,0.007454304094761564,1,62,61,2,-1,3,9,0,28,82,25
952,0,101,1,70,69,0,11,1,25,24,0,1,1,25,24,0.0,3.4037918240920386e-05,1,27,26,5,-1,6,11,0,5,96,68
953,0,616,1,100,99,0,36,1,40,39,0,36,1,50,49,0.0,0.011300588855985567,1,72,71,2,-1,3,5,0,88,80,12
954,16,118,40,83,43,38,38,51,51,0,16,20,40,48,8,0.0038462847612240037,0.003982436434187685,51,51,0,4,3,3,3,1,94,90,56
955,82,82,72,72,0,22,22,42,42,0,22,22,46,46,0,0.01334286395044079,0.01334286395044079,76,76,0,-1,3,3,2,8,68,20,97
956,100,100,58,58,0,100,100,38,38,0,100,100,58,58,0,0.016133973246196264,0.016133973246196264,78,78,0,-1,1,1,16,8,9,57,76
957,112,112,84,84,0,86,86,90,90,0,86,86,90,90,0,0.0158616699002689,0.0158616699002689,79,79,0,-1,2,2,3,4,76,38,82
958,18,18,45,45,0,14,14,34,34,0,18,18,45,45,0,0.0011913271384322134,0.0011913271384322134,41,41,0,-1,4,4,3,4,60,64,89
959,94,94,76,76,0,32,32,58,58,0,32,32,59,59,0,0.0160318594914735,0.0160318594914735,80,80,0,-1,3,3,2,9,68,39,50
960,0,1640,1,100,99,0,66,1,53,52,0,58,1,60,59,0.0,0.020524864699274992,1,81,80,1,-1,2,6,1,69,45,26
961,32,238,48,93,45,34,34,40,40,0,32,41,48,50,2,0.0028591851322373124,0.004561081044283332,48,51,3,3,3,3,6,2,69,75,70
962,0,616,1,100,99,0,28,1,42,41,0,28,1,49,48,0.0,0.00622893903808843,1,60,59,2,-1,3,3,0,75,36,72
963,108,314,75,94,19,220,220,85,85,0,108,120,75,78,3,0.007011811157629599,0.00888389666088022,60,67,7,3,2,2,12,6,3,26,83
964,24,1664,44,100,56,86,120,41,62,21,24,120,44,79,35,0.001497668402600497,0.015827631982027978,41,78,37,1,3,2,11,3,38,43,31
965,135,751,88,100,12,38,38,46,46,0,38,38,51,51,0,0.019095272133156337,0.024405187378739916,83,89,6,2,3,3,3,16,96,18,72
966,6,622,31,99,68,66,76,37,40,3,6,48,31,54,23,0.001055175465468532,0.007794683277170768,39,62,23,2,4,3,11,1,19,71,77
967,16,222,39,93,54,28,38,36,40,4,16,38,39,49,10,0.0004765308553728854,0.009122162088566664,35,66,31,3,3,3,6,1,69,4,33
968,100,100,62,62,0,100,100,45,45,0,100,100,62,62,0,0.02290751897613942,0.02307770856734402,84,84,0,4,1,1,12,7,3,48,55
969,110,212,74,90,16,116,116,77,77,0,110,112,77,77,0,0.009394465434494027,0.009428503352734947,66,66,0,4,2,2,7,7,43,21,65
970,78,180,60,87,27,94,94,68,68,0,78,80,64,64,0,0.009360427516253106,0.009428503352734947,69,70,1,4,2,2,5,7,50,62,60
971,0,0,1,1,0,0,0,1,1,0,0,0,1,1,0,0.0,0.0,1,1,0,-1,-1,-1,6,0,56,80,93
972,135,341,88,99,11,38,38,46,46,0,38,38,51,51,0,0.019095272133156337,0.02038871302631131,83,86,3,3,3,3,3,16,96,18,43
973,0,101,1,81,80,0,4,1,25,24,0,1,1,25,24,0.0,0.0,1,1,0,5,-1,6,4,0,72,89,95
974,6,622,29,100,71,32,70,33,38,5,6,54,29,52,23,0.00013615167296368154,0.008305252050784574,28,64,36,2,4,3,10,1,22,4,17
975,16,1656,36,100,64,56,150,36,69,33,16,150,36,85,49,0.0004765308553728854,0.037339596310289665,36,96,60,1,3,2,11,1,38,88,0
976,63,269,57,95,38,84,84,64,64,0,63,69,60,61,1,0.006705469893461316,0.007828721195411689,59,63,4,3,2,2,5,4,50,22,53
977,2,2,28,28,0,5,5,28,28,0,2,2,28,28,0,6.807583648184077e-05,6.807583648184077e-05,29,29,0,-1,5,5,4,1,72,78,79
978,22,638,41,100,59,64,94,39,52,13,22,94,41,62,21,0.002280540522141666,0.025868817863099493,45,88,43,2,3,3,8,2,10,83,1
979,0,102,1,82,81,0,4,1,26,25,0,2,1,25,24,0.0,0.0002382654276864427,1,31,30,4,-1,5,3,0,85,36,88
980,0,102,1,78,77,0,21,1,27,26,0,2,1,26,25,0.0,0.0002042275094455223,1,28,27,4,-1,5,13,0,13,76,88
981,0,206,1,92,91,0,18,1,37,36,0,18,1,46,45,0.0,0.012049423057285817,1,74,73,3,-1,4,3,1,85,50,15
982,0,206,1,92,91,0,15,1,29,28,0,6,1,29,28,0.0,0.0008169100377820892,1,36,35,3,-1,4,6,0,65,85,71
983,62,268,66,98,32,38,38,51,51,0,38,38,54,54,0,0.008713707069675619,0.0195377650702883,65,80,15,3,3,3,3,9,94,31,5
984,228,428,96,100,4,32,32,58,58,0,32,32,60,60,0,0.030566050580346504,0.040913577725586306,93,96,3,3,3,3,2,29,91,1,23
985,6,212,29,89,60,42,46,34,34,0,6,12,29,34,5,0.0004084550188910446,0.0009870996289866913,36,38,2,3,4,4,9,1,28,88,71
986,92,194,67,90,23,78,78,68,68,0,78,78,71,71,0,0.009496579189216788,0.009836958371625992,69,69,0,4,2,2,4,7,83,48,42
987,0,0,1,1,0,0,0,1,1,0,0,0,1,1,0,0.0,0.0,1,1,0,-1,-1,-1,7,0,62,66,69
988,0,102,1,83,82,0,4,1,28,27,0,4,1,30,29,0.0,0.006024711528642908,1,61,60,4,-1,5,2,0,99,84,8
989,101,717,83,100,17,32,32,69,69,0,32,32,69,69,0,0.013989584397018279,0.03277851526600633,79,93,14,2,3,3,2,15,90,19,9
990,0,616,1,100,99,0,56,1,35,34,0,22,1,39,38,0.0,0.003608019333537561,1,50,49,2,-1,3,11,0,38,82,29
991,0,101,1,80,79,0,9,1,25,24,0,1,1,25,24,0.0,3.4037918240920386e-05,1,25,24,5,-1,6,9,0,31,97,58
992,16,16,42,42,0,22,22,42,42,0,16,16,42,42,0,0.0008509479560230097,0.0008509479560230097,38,38,0,-1,3,3,2,1,68,49,82
993,56,56,63,63,0,48,48,66,66,0,48,48,67,67,0,0.010245413390517035,0.010245413390517035,71,71,0,-1,3,3,3,6,76,77,66
994,246,246,93,93,0,272,272,87,87,0,272,272,96,96,0,0.017972020831205963,0.017972020831205963,80,80,0,-1,2,2,14,18,8,5,85
995,22,638,38,100,62,66,90,36,44,8,22,84,38,55,17,0.0002723033459273631,0.011743081793117532,33,74,41,2,3,3,10,2,0,56,39
996,18,224,52,97,45,32,32,63,63,0,18,32,54,64,10,0.002280540522141666,0.02130773681881616,46,86,40,3,3,3,2,2,98,52,7
997,214,315,96,100,4,56,56,82,82,0,56,56,82,82,0,0.03887130263113108,0.039109568058817525,97,97,0,5,2,2,2,27,89,10,60
998,94,300,71,95,24,76,76,60,60,0,76,76,65,65,0,0.010687906327649,0.012628067667381462,70,71,1,3,3,3,6,9,69,27,75
999,22,638,43,100,57,70,80,38,41,3,22,60,43,55,12,0.0012934408931549745,0.008509479560230097,41,66,25,2,3,3,10,3,1,51,25
