,FreeNet_pre_score,FreeNet_post_score,FreeNet_pre_rank,FreeNet_post_rank,FreeNet_delta_ranks,Reversed_pre_score,Reversed_post_score,Reversed_pre_rank,Reversed_post_rank,Reversed_delta_ranks,Independent_pre_score,Independent_post_score,Independent_pre_rank,Independent_post_rank,Independent_delta_ranks,Random_pre_score,Random_post_score,Random_pre_rank,Random_post_rank,Random_delta_ranks,dist_victim_relayer,dist_victim_vilain_pre,dist_victim_vilain_post,out_deg_victim,in_deg_villain,victim,villain,relayer
0,0,102,1,78,77,0,12,1,30,29,0,7,1,34,33,0.0,0.0022465026039007454,1,48,47,4,-1,5,6,0,32,82,73
1,100,100,80,80,0,100,100,98,98,0,100,100,98,98,0,0.12634875251029648,0.12634875251029648,100,100,0,-1,1,1,2,40,89,3,36
2,32,648,50,100,50,72,92,49,61,12,32,92,50,67,17,0.004186663943633207,0.020865243881684196,51,83,32,2,3,3,7,3,62,29,9
3,60,266,65,98,33,48,48,70,70,0,48,48,72,72,0,0.005548180673270023,0.006467204465774873,55,58,3,3,3,3,3,5,94,47,78
4,100,100,66,66,0,100,100,45,45,0,100,100,66,66,0,0.06821198815480445,0.0726369175261241,100,100,0,2,1,1,10,36,1,2,72
5,0,616,1,100,99,0,68,1,39,38,0,56,1,53,52,0.0,0.007386228258279724,1,61,60,2,-1,3,8,0,15,67,21
6,40,1680,48,100,52,96,150,53,84,31,40,150,48,88,40,0.005684332346233704,0.03008951972497362,55,90,35,1,2,2,7,1,46,90,19
7,0,616,1,100,99,0,30,1,42,41,0,30,1,50,49,0.0,0.0051397256543789785,1,56,55,2,-1,3,4,0,79,86,28
8,56,262,61,97,36,48,48,59,59,0,48,48,63,63,0,0.006399128629293032,0.011504816365431091,59,75,16,3,3,3,3,6,75,13,24
9,52,153,61,88,27,54,54,55,55,0,54,54,60,60,0,0.010381565063480718,0.010517716736444398,68,68,0,5,3,3,4,5,84,25,55
10,100,100,62,62,0,100,100,45,45,0,100,100,62,62,0,0.029034344259505088,0.041390108580959185,88,95,7,2,1,1,12,18,3,5,12
11,100,100,64,64,0,100,100,49,49,0,100,100,64,64,0,0.049763436468225605,0.049763436468225605,98,98,0,-1,1,1,8,22,42,9,92
12,100,100,59,59,0,100,100,45,45,0,100,100,59,59,0,0.05075053609721229,0.05303107661935396,97,98,1,2,1,1,10,29,0,1,94
13,0,206,1,96,95,0,12,1,34,33,0,12,1,42,41,0.0,0.007250076585316042,1,62,61,3,-1,4,2,0,86,99,17
14,66,272,57,95,38,112,112,66,66,0,64,72,57,60,3,0.00616086320160659,0.007760645358929848,58,62,4,3,2,2,8,6,21,41,83
15,16,16,37,37,0,64,64,36,36,0,16,16,37,37,0,0.00037441710065012424,0.00037441710065012424,35,35,0,-1,3,3,11,1,19,49,85
16,339,539,99,100,1,120,120,90,90,0,120,120,90,90,0,0.04806154055617958,0.0512611048708261,99,99,0,3,2,2,6,36,69,2,21
17,44,44,51,51,0,56,56,49,49,0,44,44,51,51,0,0.006331052792811192,0.006331052792811192,56,56,0,-1,3,3,6,7,69,62,86
18,56,157,54,86,32,100,100,45,45,0,56,57,54,55,1,0.0036760951700194017,0.003710133088260322,50,50,0,5,2,2,10,2,1,75,58
19,0,1640,1,100,99,0,72,1,78,77,0,72,1,79,78,0.0,0.05517546546853194,1,97,96,1,-1,2,3,0,75,79,7
20,8,214,38,94,56,24,24,38,38,0,8,24,38,50,12,0.0010211375472276116,0.005582218591510943,39,60,21,3,4,4,4,2,72,74,31
21,100,100,70,70,0,100,100,53,53,0,100,100,70,70,0,0.03985840226011777,0.03985840226011777,94,94,0,-1,1,1,9,15,31,16,67
22,0,0,1,1,0,0,0,1,1,0,0,0,1,1,0,0.0,0.0,1,1,0,-1,-1,-1,4,0,83,87,97
23,0,206,1,88,87,0,24,1,31,30,0,9,1,35,34,0.0,0.0012253650566731338,1,39,38,3,-1,4,8,0,10,85,64
24,0,0,1,1,0,0,0,1,1,0,0,0,1,1,0,0.0,0.0,1,1,0,-1,-1,-1,4,0,84,97,89
25,76,692,69,100,31,38,38,57,57,0,38,38,59,59,0,0.008101024541339052,0.03420810783212499,62,92,30,2,3,3,3,13,55,24,3
26,176,176,88,88,0,176,176,87,87,0,176,176,89,89,0,0.01681473161101467,0.01681473161101467,81,81,0,-1,2,2,8,13,57,33,69
27,6,6,31,31,0,12,12,37,37,0,6,6,31,31,0,0.0005786446100956465,0.0005786446100956465,35,35,0,-1,4,4,2,1,99,49,76
28,100,100,66,66,0,100,100,60,60,0,100,100,68,68,0,0.04472582456856938,0.044759862486810305,97,97,0,5,1,1,7,20,43,23,78
29,18,634,41,100,59,44,62,36,42,6,18,52,41,55,14,0.00030634126416828345,0.005650294427992784,34,56,22,2,3,3,7,2,24,56,72
30,90,191,77,94,17,22,22,42,42,0,22,22,45,45,0,0.01606589740971442,0.016202049082678104,80,80,0,5,3,3,2,12,91,37,60
31,16,16,43,43,0,30,30,45,45,0,16,16,44,44,0,0.0007488342013002485,0.0007488342013002485,38,38,0,-1,3,3,4,2,77,42,96
32,0,616,1,100,99,0,65,1,36,35,0,52,1,53,52,0.0,0.006569318220497634,1,59,58,2,-1,3,12,0,2,81,31
33,18,224,45,93,48,28,28,44,44,0,18,28,45,50,5,0.001599782157323258,0.005173763572619898,41,54,13,3,3,3,3,2,92,61,41
34,100,100,60,60,0,100,100,40,40,0,100,100,60,60,0,0.05800061268252834,0.05817080227373294,100,100,0,4,1,1,14,36,25,2,58
35,88,1728,73,100,27,72,96,80,86,6,72,96,80,86,6,0.014227849824704722,0.05429047959426801,78,97,19,1,2,2,3,4,87,38,14
36,40,246,48,93,45,176,176,70,70,0,40,46,48,52,4,0.003778208924742163,0.00445896728956057,52,54,2,3,2,2,12,3,6,46,42
37,0,206,1,92,91,0,38,1,33,32,0,6,1,29,28,0.0,0.0030293747234419145,1,49,48,3,-1,4,9,0,35,96,46
38,100,716,66,100,34,164,164,74,74,0,100,164,66,88,22,0.008951972497362062,0.01674665577453283,68,79,11,2,2,2,10,6,1,34,32
39,162,162,89,89,0,88,88,82,82,0,88,88,82,82,0,0.018993158378433576,0.018993158378433576,81,81,0,-1,2,2,4,14,78,14,85
40,100,100,69,69,0,100,100,69,69,0,100,100,71,71,0,0.042989890738282445,0.053439531638245004,96,97,1,2,1,1,6,9,34,39,33
41,0,616,1,100,99,0,36,1,40,39,0,36,1,50,49,0.0,0.012525953912658701,1,75,74,2,-1,3,5,0,88,36,12
42,62,62,61,61,0,54,54,54,54,0,54,54,58,58,0,0.008713707069675619,0.008713707069675619,65,65,0,-1,3,3,4,6,47,34,82
43,6,107,30,82,52,12,12,32,32,0,6,7,30,35,5,0.0005105687736138058,0.0005105687736138058,35,35,0,6,4,4,2,2,91,42,58
44,287,887,99,100,1,72,72,85,85,0,72,72,85,85,0,0.04431736954967834,0.05252050784574015,96,97,1,2,2,2,3,40,60,3,20
45,2,2,28,28,0,11,11,29,29,0,2,2,28,28,0,3.4037918240920386e-05,3.4037918240920386e-05,29,29,0,-1,5,5,7,1,62,95,99
46,0,206,1,93,92,0,14,1,34,33,0,14,1,42,41,0.0,0.0032336022328874367,1,47,46,3,-1,4,3,0,92,59,22
47,6,6,33,33,0,11,11,33,33,0,6,6,33,33,0,0.0002042275094455223,0.0002042275094455223,32,32,0,-1,4,4,4,1,72,4,96
48,128,744,80,100,20,120,120,78,78,0,120,120,78,78,0,0.012559991830899623,0.02188638142891181,72,84,12,2,2,2,6,9,41,27,20
49,154,154,89,89,0,64,64,68,68,0,64,64,71,71,0,0.021920419347152727,0.021920419347152727,84,84,0,-1,3,3,4,19,72,15,81
50,137,753,89,100,11,32,32,63,63,0,32,32,64,64,0,0.02011640968038395,0.03601211749889377,86,96,10,2,3,3,2,16,86,12,18
51,2,208,28,91,63,11,30,29,34,5,2,28,28,48,20,3.4037918240920386e-05,0.003778208924742163,29,49,20,3,5,4,7,1,62,95,47
52,63,269,61,93,32,64,64,60,60,0,64,64,63,63,0,0.007658531604207087,0.01950372715204738,63,83,20,3,3,3,4,8,83,57,23
53,88,294,71,95,24,72,72,77,77,0,72,72,77,77,0,0.013751318969331836,0.018108172504169646,78,83,5,3,2,2,3,9,82,27,62
54,100,100,76,76,0,100,100,97,97,0,100,100,97,97,0,0.05173763572619899,0.056298716770482315,98,98,0,3,1,1,3,3,94,51,72
55,0,1640,1,100,99,0,74,1,43,42,0,74,1,56,55,0.0,0.017257224548146634,1,79,78,1,-1,2,8,0,27,66,31
56,94,195,65,92,27,60,60,48,48,0,60,60,61,61,0,0.007250076585316042,0.007284114503556962,63,63,0,5,3,3,5,9,63,31,58
57,80,181,73,94,21,32,32,64,64,0,32,32,64,64,0,0.012559991830899623,0.012594029749140543,74,74,0,5,3,3,2,13,89,33,65
58,216,816,93,100,7,116,116,76,76,0,116,116,80,80,0,0.022328874366043774,0.05020592940535757,84,98,14,2,2,2,7,19,62,15,2
59,6,6,30,30,0,21,21,31,31,0,6,6,30,30,0,0.00013615167296368154,0.00013615167296368154,31,31,0,-1,4,4,9,1,54,60,96
60,96,302,71,98,27,88,88,71,71,0,88,88,71,71,0,0.009973110044589673,0.013989584397018279,70,76,6,3,2,2,4,7,53,48,47
61,16,118,35,77,42,78,78,45,45,0,16,18,35,40,5,0.002484768031587188,0.002484768031587188,47,47,0,4,3,3,8,2,15,94,95
62,304,510,97,100,3,182,182,89,89,0,182,182,89,89,0,0.031995643146465164,0.03771401341093979,93,94,1,3,2,2,9,27,26,10,27
63,0,0,1,1,0,0,0,1,1,0,0,0,1,1,0,0.0,0.0,1,1,0,-1,-1,-1,5,0,49,96,80
64,148,249,79,94,15,252,252,82,82,0,148,149,79,79,0,0.010313489226998877,0.010415602981721638,65,65,0,5,2,2,15,6,7,34,68
65,18,634,41,100,59,50,72,38,45,7,18,72,41,58,17,0.0004765308553728854,0.007862759113652609,36,62,26,2,3,3,7,2,43,56,77
66,190,290,89,95,6,222,222,83,83,0,222,222,90,90,0,0.020048333843902106,0.020763130126961436,82,82,0,4,2,2,13,16,13,18,51
67,0,0,1,1,0,0,0,1,1,0,0,0,1,1,0,0.0,0.0,1,1,0,-1,-1,-1,8,0,27,36,45
68,308,410,97,99,2,376,376,98,98,0,308,310,97,97,0,0.022703291466693896,0.022737329384934817,87,87,0,4,2,2,16,18,9,30,58
69,100,100,64,64,0,100,100,57,57,0,100,100,65,65,0,0.04435140746791926,0.044453521222642026,97,97,0,4,1,1,8,20,10,23,4
70,245,245,97,97,0,56,56,85,85,0,56,56,85,85,0,0.04322815616596889,0.04322815616596889,96,96,0,-1,2,2,2,29,90,0,93
71,156,258,88,95,7,88,88,81,81,0,88,88,81,81,0,0.021682153919466287,0.022839443139657578,85,85,0,4,2,2,4,14,73,14,64
72,119,221,84,93,9,78,78,75,75,0,78,78,77,77,0,0.011709043874876613,0.01667857993805099,73,84,11,4,2,2,4,13,77,24,31
73,44,644,51,100,49,66,66,54,54,0,44,66,51,61,10,0.007590455767725246,0.021954457265393648,62,82,20,2,3,3,6,4,69,38,15
74,0,101,1,84,83,0,2,1,24,23,0,1,1,24,23,0.0,0.00013615167296368154,1,30,29,5,-1,6,2,0,98,40,60
75,0,1640,1,100,99,0,96,1,62,61,0,96,1,67,66,0.0,0.046563872153579086,1,98,97,1,-1,2,7,1,62,45,3
76,16,16,38,38,0,58,58,44,44,0,16,16,38,38,0,0.0030634126416828346,0.0030634126416828346,48,48,0,-1,3,3,7,3,62,46,84
77,2,103,28,83,55,4,4,29,29,0,2,3,28,32,4,0.00017018959120460194,0.0002382654276864427,32,33,1,5,5,5,2,1,86,55,60
78,100,300,80,100,20,46,46,84,84,0,46,46,84,84,0,0.014432077334150244,0.01844855168657885,75,83,8,3,2,2,2,13,93,24,21
79,16,222,44,92,48,48,48,54,54,0,16,24,43,53,10,0.0020763130126961434,0.0035059055788147996,46,53,7,3,3,3,3,1,87,53,52
80,1,1,25,25,0,3,3,25,25,0,1,1,25,25,0,0.0,0.0,1,1,0,-1,6,6,3,1,96,68,85
81,128,744,78,100,22,182,182,82,82,0,128,182,79,87,8,0.008203138296061813,0.019673916743251984,63,84,21,2,2,2,9,5,28,47,19
82,6,212,28,92,64,32,36,35,35,0,6,36,28,46,18,0.0005446066918547262,0.0046972327172470135,34,49,15,3,4,4,6,1,56,49,13
83,29,1669,47,100,53,46,80,42,53,11,29,80,47,62,15,0.0036760951700194017,0.025051907825317403,49,86,37,1,3,2,6,6,48,73,62
84,160,160,91,91,0,72,72,80,80,0,72,72,80,80,0,0.023009632730862182,0.023009632730862182,86,86,0,-1,2,2,3,18,76,5,97
85,2,1642,25,100,75,6,84,25,63,38,2,84,25,68,43,0.0,0.035910003744171005,1,94,93,1,5,2,5,2,50,58,9
86,0,1640,1,100,99,0,142,1,61,60,0,128,1,84,83,0.0,0.016882807447496512,1,77,76,1,-1,2,13,0,13,36,14
87,0,0,1,1,0,0,0,1,1,0,0,0,1,1,0,0.0,0.0,1,1,0,-1,-1,-1,11,1,5,50,98
88,0,101,1,77,76,0,4,1,24,23,0,1,1,24,23,0.0,3.4037918240920386e-05,1,26,25,6,-1,7,4,0,84,97,58
89,150,766,87,100,13,88,88,81,81,0,88,88,81,81,0,0.020014295925661188,0.02661765206439974,83,89,6,2,2,2,4,17,73,6,72
90,0,0,1,1,0,0,0,1,1,0,0,0,1,1,0,0.0,0.0,1,1,0,-1,-1,-1,6,0,51,81,66
91,0,616,1,100,99,0,120,1,61,60,0,120,1,78,77,0.0,0.02127369890057524,1,82,81,2,-1,3,10,0,12,86,7
92,20,20,46,46,0,34,34,43,43,0,20,20,46,46,0,0.0011232513019503727,0.0011232513019503727,39,39,0,-1,3,3,4,3,79,43,66
93,112,728,85,100,15,48,48,67,67,0,48,48,70,70,0,0.017529527894074,0.022601177711971135,80,88,8,2,3,3,3,17,96,6,26
94,100,100,69,69,0,100,100,71,71,0,100,100,72,72,0,0.026787841655604345,0.027060145001531706,89,89,0,4,1,1,6,3,56,43,42
95,118,118,83,83,0,72,72,77,77,0,72,72,77,77,0,0.015146873617209572,0.015146873617209572,79,79,0,-1,2,2,3,9,64,27,84
96,6,622,28,100,72,44,58,33,34,1,6,24,28,42,14,0.00017018959120460194,0.0011232513019503727,30,37,7,2,4,3,16,1,9,4,63
97,60,266,56,95,39,104,104,64,64,0,60,75,56,56,0,0.006058749446883829,0.008713707069675619,55,67,12,3,2,2,9,6,35,73,22
98,86,292,78,100,22,22,22,49,49,0,22,22,53,53,0,0.017427414139351238,0.01855066544130161,82,82,0,3,3,3,2,18,90,30,54
99,144,245,82,91,9,224,224,88,88,0,144,145,82,83,1,0.010075223799312433,0.010075223799312433,70,70,0,6,2,2,11,7,33,21,78
100,2,2,27,27,0,12,12,29,29,0,2,2,27,27,0,0.0002042275094455223,0.0002042275094455223,31,31,0,-1,5,5,6,1,48,60,87
101,146,1746,90,100,10,96,96,94,94,0,96,96,94,94,0,0.022430988120766535,0.0516014840532353,86,97,11,1,2,2,3,9,94,27,51
102,232,832,91,100,9,320,320,92,92,0,232,320,91,94,3,0.019571802988529223,0.02566459035365397,80,87,7,2,2,2,14,12,16,37,77
103,0,616,1,100,99,0,52,1,44,43,0,52,1,57,56,0.0,0.010619830491167161,1,73,72,2,-1,3,6,0,48,89,8
104,0,102,1,75,74,0,10,1,26,25,0,2,1,25,24,0.0,0.00010211375472276115,1,29,28,4,-1,5,8,1,15,69,65
105,0,0,1,1,0,0,0,1,1,0,0,0,1,1,0,0.0,0.0,1,1,0,-1,-1,-1,7,0,62,86,67
106,0,102,1,82,81,0,4,1,29,28,0,4,1,31,30,0.0,0.00034037918240920387,1,33,32,4,-1,5,2,0,68,79,63
107,8,8,37,37,0,10,10,32,32,0,8,8,37,37,0,0.0004765308553728854,0.0004765308553728854,36,36,0,-1,4,4,3,2,85,56,97
108,129,329,82,97,15,104,104,80,80,0,104,104,81,81,0,0.01865277919602437,0.019776030497974745,80,82,2,3,2,2,5,12,63,37,54
109,100,100,67,67,0,100,100,54,54,0,100,100,67,67,0,0.02032063718982947,0.02032063718982947,81,81,0,-1,1,1,8,1,27,71,40
110,0,616,1,100,99,0,46,1,35,34,0,34,1,45,44,0.0,0.005548180673270023,1,56,55,2,-1,3,8,0,27,92,72
111,2,2,26,26,0,12,12,27,27,0,2,2,26,26,0,0.00010211375472276115,0.00010211375472276115,29,29,0,-1,5,5,10,1,11,78,76
112,22,638,40,100,60,58,76,35,40,5,22,56,40,55,15,0.00030634126416828345,0.0057524081827155455,33,58,25,2,3,3,10,2,11,63,38
113,100,100,58,58,0,100,100,35,35,0,100,100,59,59,0,0.022635215630212056,0.023996732359848873,86,86,0,3,1,1,17,8,20,17,83
114,2,618,26,100,74,17,132,26,61,35,2,124,26,77,51,0.0,0.014840532353041287,1,76,75,2,5,3,16,1,9,78,16
115,100,100,75,75,0,100,100,89,89,0,100,100,89,89,0,0.060213077368188164,0.060553456550597365,98,98,0,4,1,1,4,19,73,15,56
116,0,616,1,100,99,0,100,1,46,45,0,82,1,59,58,0.0,0.013887470642295518,1,74,73,2,-1,3,10,0,22,82,37
117,78,284,58,96,38,122,122,72,72,0,78,87,58,60,2,0.00793083495013445,0.009360427516253106,62,67,5,3,2,2,8,4,10,38,64
118,0,206,1,92,91,0,32,1,34,33,0,32,1,49,48,0.0,0.009394465434494027,1,67,66,3,-1,4,6,0,59,40,33
119,6,622,29,100,71,35,106,31,56,25,6,96,29,57,28,0.0002042275094455223,0.012900371013308825,31,70,39,2,4,3,15,1,7,65,6
120,88,704,60,100,40,196,196,72,72,0,88,104,60,75,15,0.007590455767725246,0.009292351679771264,61,64,3,2,2,2,12,7,14,62,53
121,92,708,67,100,33,134,144,86,87,1,92,144,67,87,20,0.009496579189216788,0.025256135334762925,67,87,20,2,2,2,6,4,44,72,18
122,6,212,30,92,62,18,23,32,32,0,6,12,30,35,5,0.00034037918240920387,0.0007488342013002485,31,36,5,3,4,4,6,1,65,55,4
123,12,218,36,95,59,18,18,38,38,0,12,18,36,43,7,0.0022465026039007454,0.0040845501889104465,45,50,5,3,4,4,3,2,96,83,61
124,314,314,95,95,0,264,264,93,93,0,264,264,93,93,0,0.02314578440382586,0.02314578440382586,85,85,0,-1,2,2,12,19,3,15,40
125,22,228,49,97,48,22,22,49,49,0,22,22,50,50,0,0.0031314884781646754,0.023520201504475986,49,87,38,3,3,3,2,2,93,52,11
126,0,616,1,100,99,0,58,1,42,41,0,58,1,51,50,0.0,0.016508390346846386,1,81,80,2,-1,3,7,0,46,80,16
127,104,104,75,75,0,240,240,77,77,0,104,104,75,75,0,0.005548180673270023,0.005548180673270023,56,56,0,-1,2,2,16,5,4,47,40
128,0,206,1,93,92,0,14,1,29,28,0,8,1,35,34,0.0,0.0010211375472276116,1,38,37,3,-1,4,6,0,34,86,51
129,12,212,34,88,54,34,34,34,34,0,12,12,34,34,0,0.0002382654276864427,0.0005786446100956465,32,36,4,3,4,4,7,2,24,63,49
130,2,618,26,99,73,15,102,28,56,28,2,54,26,53,27,6.807583648184077e-05,0.007488342013002485,28,62,34,2,5,3,12,1,6,68,25
131,69,275,71,98,27,62,62,82,82,0,62,62,82,82,0,0.013513053541645392,0.02198849518363457,74,86,12,3,2,2,3,6,92,73,39
132,6,212,30,94,64,12,12,30,30,0,6,14,30,37,7,0.00013615167296368154,0.0011913271384322134,30,38,8,3,4,4,4,1,53,65,74
133,16,632,41,100,59,28,28,48,48,0,16,28,42,53,11,0.0030974505599237552,0.012866333095067906,49,75,26,2,3,3,3,3,55,46,33
134,0,206,1,95,94,0,14,1,31,30,0,14,1,38,37,0.0,0.0038462847612240037,1,50,49,3,-1,4,3,0,94,81,13
135,6,6,30,30,0,32,32,31,31,0,6,6,30,30,0,0.00017018959120460194,0.00017018959120460194,30,30,0,-1,4,4,11,1,38,60,98
136,167,167,89,89,0,112,112,92,92,0,112,112,92,92,0,0.020797168045202357,0.020797168045202357,85,85,0,-1,2,2,4,15,83,19,76
137,375,975,100,100,0,96,96,92,92,0,96,96,92,92,0,0.05051227066952585,0.05936212941216515,96,98,2,2,2,2,3,40,96,3,19
138,0,206,1,97,96,0,8,1,34,33,0,8,1,40,39,0.0,0.003199564314646516,1,49,48,3,-1,4,2,0,97,59,83
139,116,322,87,100,13,56,56,82,82,0,56,56,82,82,0,0.0195377650702883,0.020695054290479593,83,84,1,3,2,2,2,14,89,32,61
140,0,206,1,89,88,0,21,1,28,27,0,6,1,28,27,0.0,0.0005786446100956465,1,37,36,3,-1,4,9,1,28,69,71
141,51,667,57,100,43,56,66,45,47,2,51,66,57,60,3,0.005480104836788182,0.009632730862180468,56,68,12,2,3,3,6,6,48,35,47
142,16,222,37,94,57,56,56,44,44,0,16,24,37,45,8,0.0018040096667687805,0.002757071377514551,45,48,3,3,3,3,6,1,34,53,51
143,62,268,53,93,40,132,132,63,63,0,62,74,53,56,3,0.0018380475850097008,0.003710133088260322,42,51,9,3,2,2,12,4,3,64,83
144,100,100,58,58,0,100,100,35,35,0,100,100,59,59,0,0.05691139929881889,0.05691139929881889,100,100,0,-1,1,1,17,40,20,3,81
145,100,100,60,60,0,100,100,50,50,0,100,100,60,60,0,0.028762040913577726,0.028762040913577726,90,90,0,-1,1,1,9,14,28,14,69
146,16,16,38,38,0,44,44,39,39,0,16,16,38,38,0,0.0010892133837094523,0.0010892133837094523,38,38,0,-1,3,3,7,2,62,42,50
147,2,104,27,76,49,14,15,28,28,0,2,4,27,28,1,6.807583648184077e-05,0.0002723033459273631,27,31,4,4,5,5,8,1,39,95,55
148,328,534,95,99,4,224,224,96,96,0,224,224,96,96,0,0.025051907825317403,0.025970931617822254,86,87,1,3,2,2,8,19,42,15,83
149,100,100,72,72,0,100,100,87,87,0,100,100,87,87,0,0.08461826474692807,0.08461826474692807,99,99,0,-1,1,1,4,40,53,3,76
150,24,230,47,95,48,38,38,46,46,0,24,38,48,50,2,0.0030634126416828346,0.010109261717553355,49,74,25,3,3,3,3,6,96,70,27
151,40,656,55,100,45,100,120,71,86,15,40,120,55,88,33,0.00704584907587052,0.04738078219136117,62,96,34,2,2,2,6,1,32,90,3
152,218,834,92,100,8,166,166,83,83,0,166,166,88,88,0,0.020524864699274992,0.038905340549372,83,94,11,2,2,2,8,17,15,6,1
153,238,238,90,90,0,192,192,87,87,0,192,192,88,88,0,0.020252561353347628,0.020252561353347628,82,82,0,-1,2,2,9,16,54,12,85
154,0,616,1,100,99,0,38,1,56,55,0,38,1,58,57,0.0,0.019946220089179345,1,87,86,2,-1,3,3,0,55,82,16
155,100,100,64,64,0,100,100,45,45,0,100,100,64,64,0,0.04401102828551006,0.052418394091017395,96,98,2,2,1,1,10,15,18,16,17
156,80,182,58,83,25,132,132,72,72,0,80,82,58,60,2,0.012151536812008578,0.012287688484972258,70,70,0,4,2,2,8,5,27,25,95
157,58,58,66,66,0,62,62,82,82,0,58,58,83,83,0,0.010415602981721638,0.010415602981721638,70,70,0,-1,2,2,3,3,60,54,50
158,0,0,1,1,0,0,0,1,1,0,0,0,1,1,0,0.0,0.0,1,1,0,-1,-1,-1,6,1,40,45,98
159,100,100,77,77,0,100,100,96,96,0,100,100,96,96,0,0.07022022533101875,0.08359712719970047,99,100,1,2,1,1,3,19,76,15,5
160,54,54,59,59,0,80,80,70,70,0,54,54,60,60,0,0.007794683277170768,0.007794683277170768,64,64,0,-1,3,3,5,4,45,72,69
161,16,632,35,100,65,108,118,62,65,3,16,118,35,77,42,0.0020763130126961434,0.0160318594914735,44,79,35,2,3,3,8,1,15,53,30
162,0,102,1,75,74,0,12,1,28,27,0,2,1,26,25,0.0,0.0004765308553728854,1,33,32,4,-1,5,6,0,65,85,49
163,0,101,1,79,78,0,3,1,25,24,0,1,1,25,24,0.0,3.4037918240920386e-05,1,26,25,5,-1,6,3,1,58,50,60
164,0,1640,1,100,99,0,140,1,62,61,0,111,1,79,78,0.0,0.018006058749446885,1,77,76,1,-1,2,14,0,17,80,37
165,24,640,50,100,50,22,32,49,68,19,22,32,53,68,15,0.0029612988869600733,0.01157289220191293,49,73,24,2,3,3,2,6,90,70,75
166,110,726,75,100,25,158,158,78,78,0,110,126,75,78,3,0.009360427516253106,0.012764219340345145,67,72,5,2,2,2,9,7,29,21,90
167,22,22,40,40,0,78,78,38,38,0,22,22,40,40,0,0.0011232513019503727,0.0011232513019503727,39,39,0,-1,3,3,12,2,6,74,96
168,92,708,67,100,33,78,78,68,68,0,78,78,71,71,0,0.009496579189216788,0.0141938119064638,69,76,7,2,2,2,4,7,83,48,41
169,0,616,1,100,99,0,50,1,38,37,0,50,1,57,56,0.0,0.008373327887266415,1,65,64,2,-1,3,8,0,57,67,32
170,101,202,81,93,12,54,54,55,55,0,54,54,60,60,0,0.016202049082678104,0.016406276592123625,79,80,1,5,3,3,4,12,73,37,60
171,192,1832,93,100,7,72,96,85,94,9,72,96,85,94,9,0.029510875114877974,0.08618400898601042,88,99,11,1,2,2,3,19,60,15,0
172,176,776,88,100,12,118,118,72,72,0,118,118,82,82,0,0.01317267435923619,0.020899281799925118,72,84,12,2,2,2,9,14,23,14,8
173,190,190,88,88,0,228,228,89,89,0,190,190,88,88,0,0.015351101126655093,0.015351101126655093,78,78,0,-1,2,2,11,9,38,27,89
174,70,70,65,65,0,60,60,49,49,0,60,60,59,59,0,0.00789679703189353,0.00789679703189353,63,63,0,-1,3,3,5,9,88,31,96
175,0,616,1,100,99,0,54,1,34,33,0,16,1,34,33,0.0,0.003267640151128357,1,48,47,2,-1,3,10,0,22,85,46
176,100,100,69,69,0,100,100,55,55,0,100,100,69,69,0,0.049389019367575476,0.05020592940535757,97,98,1,4,1,1,9,29,26,0,43
177,0,616,1,100,99,0,34,1,42,41,0,34,1,51,50,0.0,0.006262976956329351,1,58,57,2,-1,3,4,0,79,81,62
178,16,632,47,100,53,22,22,49,49,0,16,22,48,49,1,0.002382654276864427,0.0265495762279179,47,89,42,2,3,3,2,1,93,53,1
179,50,1690,58,100,42,38,72,56,84,28,38,72,57,84,27,0.006705469893461316,0.04561081044283331,59,97,38,1,3,2,3,6,60,26,73
180,16,632,34,100,66,122,122,62,62,0,16,50,34,53,19,0.0018040096667687805,0.004595118962524252,41,54,13,2,3,3,12,1,2,53,41
181,6,622,29,100,71,36,78,33,46,13,6,78,29,65,36,0.0004765308553728854,0.014704380680077607,35,78,43,2,4,3,8,2,39,42,18
182,124,740,77,100,23,150,150,85,85,0,124,150,83,88,5,0.010415602981721638,0.020763130126961436,71,86,15,2,2,2,7,7,46,21,20
183,16,222,35,91,56,90,90,43,43,0,16,24,35,45,10,0.0011232513019503727,0.0015317063208414173,40,41,1,3,3,3,10,1,1,71,74
184,6,622,29,100,71,13,36,29,37,8,6,36,29,52,23,0.00010211375472276115,0.0068075836481840775,30,59,29,2,4,3,5,1,61,60,25
185,178,778,89,100,11,190,190,77,77,0,190,190,91,91,0,0.012832295176826986,0.0160318594914735,74,77,3,2,2,2,11,14,19,32,35
186,56,672,51,100,49,158,168,66,66,0,56,92,51,57,6,0.005071649817897137,0.00891793457912114,55,65,10,2,2,2,14,2,25,75,35
187,2,2,27,27,0,6,6,29,29,0,2,2,27,27,0,0.00013615167296368154,0.00013615167296368154,30,30,0,-1,5,5,3,1,58,4,97
188,273,273,95,95,0,248,248,98,98,0,248,248,98,98,0,0.0195377650702883,0.0195377650702883,82,82,0,-1,2,2,8,15,30,19,93
189,373,973,97,100,3,248,248,90,90,0,248,248,92,92,0,0.031655263964055956,0.03437829742332959,90,93,3,2,2,2,11,29,38,11,26
190,249,349,96,98,2,48,48,62,62,0,48,48,64,64,0,0.032063718982947,0.03213179481942884,91,91,0,5,3,3,3,30,64,7,55
191,44,660,58,100,42,64,64,68,68,0,44,64,63,70,7,0.00789679703189353,0.01783586915824228,67,82,15,2,3,3,4,7,72,62,17
192,244,450,93,100,7,102,102,93,93,0,102,102,93,93,0,0.03267640151128357,0.03427618366860683,91,91,0,3,2,2,4,22,84,9,75
193,16,632,36,100,64,28,50,34,44,10,16,50,36,51,15,0.0007147962830593281,0.01153885428367201,36,74,38,2,3,3,5,1,52,4,33
194,0,102,1,71,70,0,8,1,25,24,0,2,1,25,24,0.0,0.0,1,1,0,4,-1,5,7,0,24,59,95
195,180,386,90,98,8,132,132,74,74,0,132,132,81,81,0,0.020456788862793153,0.02198849518363457,83,83,0,3,2,2,8,17,21,6,94
196,0,206,1,92,91,0,20,1,35,34,0,16,1,44,43,0.0,0.004765308553728854,1,55,54,3,-1,4,4,0,78,82,62
197,100,100,61,61,0,100,100,44,44,0,100,100,61,61,0,0.024337111542258077,0.029749140542564417,87,89,2,2,1,1,12,14,6,14,62
198,144,144,83,83,0,64,64,59,59,0,64,64,63,63,0,0.012730181422104225,0.012730181422104225,75,75,0,-1,3,3,4,14,53,32,89
199,224,430,88,97,9,252,252,94,94,0,224,230,89,91,2,0.016304162837400864,0.016508390346846386,75,75,0,3,2,2,11,8,5,8,49
200,0,616,1,100,99,0,48,1,36,35,0,33,1,49,48,0.0,0.006535280302256714,1,58,57,2,-1,3,7,0,24,86,34
201,110,110,82,82,0,72,72,85,85,0,72,72,85,85,0,0.01504475986248681,0.01504475986248681,77,77,0,-1,2,2,3,6,94,77,96
202,68,274,65,97,32,78,78,77,77,0,68,78,77,78,1,0.0088498587426393,0.012151536812008578,67,76,9,3,2,2,4,4,78,72,28
203,101,1741,70,100,30,138,162,69,79,10,101,162,70,86,16,0.007658531604207087,0.025494400762449368,62,88,26,1,2,2,9,8,28,57,14
204,35,241,52,97,45,38,38,51,51,0,38,38,54,54,0,0.005207801490860819,0.009598692943939549,53,69,16,3,3,3,3,6,94,73,72
205,0,0,1,1,0,0,0,1,1,0,0,0,1,1,0,0.0,0.0,1,1,0,-1,-1,-1,9,1,23,50,85
206,0,616,1,100,99,0,110,1,56,55,0,104,1,75,74,0.0,0.013751318969331836,1,70,69,2,-1,3,14,0,25,81,30
207,255,871,95,100,5,288,288,95,95,0,288,288,95,95,0,0.017393376221110316,0.018788930868988054,80,81,1,2,2,2,12,15,6,19,52
208,90,1730,63,100,37,100,134,66,90,24,90,134,69,91,22,0.007147962830593281,0.029681064706082574,57,91,34,1,2,2,6,6,51,28,27
209,36,652,44,100,56,92,102,41,54,13,36,54,44,51,7,0.004322815616596889,0.004901460226692535,51,52,1,2,3,3,11,6,33,73,56
210,6,622,31,100,69,14,28,36,45,9,6,28,31,50,19,0.0006467204465774873,0.015146873617209572,38,79,41,2,4,3,3,2,85,42,30
211,0,0,1,1,0,0,0,1,1,0,0,0,1,1,0,0.0,0.0,1,1,0,-1,-1,-1,6,0,32,76,67
212,2,208,27,88,61,18,30,30,32,2,2,10,27,34,7,0.00034037918240920387,0.002382654276864427,33,44,11,3,5,4,9,1,54,88,75
213,170,170,88,88,0,104,104,73,73,0,104,104,79,79,0,0.01674665577453283,0.01674665577453283,81,81,0,-1,2,2,5,13,52,33,93
214,126,742,78,100,22,152,152,76,76,0,126,142,78,81,3,0.010143299635794275,0.012491915994417782,66,73,7,2,2,2,8,7,15,48,46
215,100,100,69,69,0,100,100,55,55,0,100,100,69,69,0,0.016202049082678104,0.021784267674189048,78,82,4,3,1,1,9,1,26,49,24
216,100,100,60,60,0,100,100,52,52,0,100,100,60,60,0,0.02403077027808979,0.02978317846080534,86,89,3,2,1,1,9,6,29,26,47
217,0,616,1,99,98,0,112,1,57,56,0,86,1,55,54,0.0,0.006501242384015794,1,56,55,2,-1,3,17,1,20,50,24
218,142,142,85,85,0,112,112,93,93,0,112,112,93,93,0,0.019129310051397258,0.019129310051397258,83,83,0,-1,2,2,4,13,47,33,80
219,146,146,89,89,0,72,72,77,77,0,72,72,79,79,0,0.020763130126961436,0.020763130126961436,88,88,0,-1,2,2,3,16,96,12,50
220,22,1662,41,100,59,36,84,36,63,27,22,84,41,68,27,0.0009870996289866913,0.041968753191054836,38,96,58,1,3,2,5,3,50,51,0
221,121,223,79,91,12,88,88,73,73,0,88,88,74,74,0,0.010517716736444398,0.011947309302563056,70,71,1,4,2,2,4,8,83,44,94
222,52,258,50,94,44,62,62,48,48,0,50,57,50,57,7,0.003880322679464924,0.0048674223084516155,49,50,1,3,3,3,6,6,56,41,61
223,100,100,81,81,0,100,100,96,96,0,100,100,96,96,0,0.050954763606657814,0.06426358963885768,98,99,1,2,1,1,3,1,92,45,18
224,0,206,1,92,91,0,22,1,32,31,0,8,1,34,33,0.0,0.0012934408931549745,1,39,38,3,-1,4,5,0,63,86,61
225,62,163,59,90,31,22,22,42,42,0,22,22,46,46,0,0.00881582082439838,0.008951972497362062,64,64,0,5,3,3,2,6,68,34,65
226,173,789,90,100,10,112,112,95,95,0,112,112,95,95,0,0.02644746247319514,0.04203682902753668,89,95,6,2,2,2,4,16,73,18,16
227,0,206,1,92,91,0,27,1,29,28,0,8,1,33,32,0.0,0.0007488342013002485,1,37,36,3,-1,4,12,0,6,87,74
228,56,672,52,100,48,80,80,61,61,0,56,80,52,66,14,0.005650294427992784,0.015453214881377854,54,76,22,2,2,2,6,3,56,29,33
229,172,788,87,100,13,110,110,83,83,0,110,110,83,83,0,0.022601177711971135,0.026821879573845263,84,88,4,2,2,2,6,18,71,30,47
230,140,346,84,99,15,54,54,56,56,0,54,54,57,57,0,0.014261887742945642,0.03260832567480173,76,92,16,3,3,3,4,15,67,19,10
231,91,1731,58,100,42,128,172,70,85,15,91,172,58,89,31,0.006569318220497634,0.027774941284591036,58,89,31,1,2,2,9,6,29,35,32
232,73,689,59,100,41,164,174,74,79,5,73,111,59,78,19,0.0053099152455835805,0.01143674052894925,56,74,18,2,2,2,10,4,1,22,34
233,0,616,1,100,99,0,56,1,45,44,0,56,1,57,56,0.0,0.022430988120766535,1,85,84,2,-1,3,6,1,74,50,10
234,100,100,69,69,0,100,100,69,69,0,100,100,71,71,0,0.07335171380918343,0.07743626399809388,100,100,0,3,1,1,6,36,34,2,31
235,0,1640,1,100,99,0,80,1,54,53,0,80,1,65,64,0.0,0.036080193335375606,1,94,93,1,-1,2,6,0,59,81,0
236,0,101,1,82,81,0,2,1,24,23,0,1,1,24,23,0.0,0.0002042275094455223,1,30,29,5,-1,6,2,0,89,80,55
237,156,156,83,83,0,200,200,81,81,0,156,156,83,83,0,0.014670342761836687,0.014670342761836687,76,76,0,-1,2,2,11,13,19,33,82
238,134,750,80,100,20,176,176,85,85,0,134,176,80,88,8,0.011300588855985567,0.016304162837400864,74,80,6,2,2,2,8,7,42,21,38
239,213,829,93,100,7,48,48,64,64,0,48,48,66,66,0,0.030191633479696382,0.05388202457537697,90,97,7,2,3,3,3,29,85,11,10
240,6,622,29,100,71,22,80,29,40,11,6,70,29,55,26,0.0002042275094455223,0.009088124170325743,32,67,35,2,4,3,10,1,18,55,27
241,32,648,48,100,52,86,86,56,56,0,32,86,48,64,16,0.004731270635487933,0.026141121209026855,54,89,35,2,3,3,6,3,48,29,11
242,182,782,86,100,14,150,150,74,74,0,150,150,82,82,0,0.012900371013308825,0.016712617856291908,73,76,3,2,3,3,10,14,12,14,28
243,119,325,81,98,17,78,78,72,72,0,78,78,75,75,0,0.018993158378433576,0.02641342455495422,82,88,6,3,2,2,4,12,47,37,27
244,295,895,96,100,4,120,120,88,88,0,120,120,87,87,0,0.033425235712583816,0.04482793832329215,94,97,3,2,2,2,6,29,71,11,15
245,0,616,1,100,99,0,58,1,38,37,0,30,1,50,49,0.0,0.006058749446883829,1,59,58,2,-1,3,8,0,30,92,62
246,0,0,1,1,0,0,0,1,1,0,0,0,1,1,0,0.0,0.0,1,1,0,-1,-1,-1,10,0,18,85,87
247,32,238,53,95,42,38,38,57,57,0,32,38,59,59,0,0.002484768031587188,0.009939072126348753,46,67,21,3,3,3,3,2,85,52,20
248,2,2,27,27,0,5,5,27,27,0,2,2,27,27,0,0.0,0.0,1,1,0,-1,5,5,4,1,53,68,59
249,100,100,67,67,0,100,100,54,54,0,100,100,67,67,0,0.05245243200925832,0.05395010041185881,98,98,0,3,1,1,9,27,35,10,46
250,82,288,71,96,25,84,84,74,74,0,84,84,75,75,0,0.010449640899962559,0.011368664692467409,71,74,3,3,2,2,5,7,45,48,64
251,2,104,29,83,54,5,5,30,30,0,2,4,29,31,2,0.0,0.000442492937131965,1,33,32,4,5,5,3,1,60,95,49
252,0,616,1,100,99,0,42,1,35,34,0,22,1,41,40,0.0,0.0035739814152966403,1,47,46,2,-1,3,8,0,27,84,29
253,108,724,85,100,15,56,56,82,82,0,56,56,82,82,0,0.02130773681881616,0.031485074372851356,85,94,9,2,2,2,2,9,89,39,48
254,0,206,1,92,91,0,24,1,31,30,0,11,1,34,33,0.0,0.002757071377514551,1,48,47,3,-1,4,6,0,59,36,73
255,16,222,35,92,57,70,74,43,43,0,16,27,35,46,11,0.0011232513019503727,0.003880322679464924,38,51,13,3,3,3,8,2,15,42,73
256,146,247,87,95,8,134,134,90,90,0,134,134,90,90,0,0.016474352428605468,0.016610504101569147,81,82,1,5,2,2,6,8,48,8,65
257,260,361,98,99,1,96,96,93,93,0,96,96,93,93,0,0.036454610436025735,0.036488648354266656,95,95,0,6,2,2,3,22,66,9,58
258,157,773,91,100,9,56,56,85,85,0,56,56,85,85,0,0.026855917492086184,0.05340549372000408,88,98,10,2,2,2,2,15,90,16,0
259,49,665,56,100,44,70,70,63,63,0,49,70,55,65,10,0.005037611899656217,0.014670342761836687,56,78,22,2,3,3,5,4,49,22,48
260,254,254,95,95,0,224,224,98,98,0,224,224,98,98,0,0.024507301133462677,0.024507301133462677,86,86,0,-1,2,2,8,18,21,30,66
261,1,617,23,100,77,4,30,23,37,14,1,30,23,43,20,3.4037918240920386e-05,0.0088498587426393,24,62,38,2,6,3,4,2,67,58,20
262,40,656,50,100,50,144,174,72,75,3,40,174,50,86,36,0.004663194799006093,0.018108172504169646,54,79,25,2,2,2,10,3,22,46,37
263,106,106,79,79,0,78,78,73,73,0,78,78,73,73,0,0.014534191088873005,0.014534191088873005,77,77,0,-1,2,2,4,8,79,20,40
264,0,206,1,87,86,0,35,1,29,28,0,8,1,33,32,0.0,0.0011913271384322134,1,38,37,3,-1,4,16,0,9,93,83
265,87,287,61,95,34,118,118,66,66,0,87,118,61,77,16,0.00803294870485721,0.014704380680077607,62,77,15,3,3,3,8,8,15,44,17
266,122,738,79,100,21,176,176,74,74,0,122,138,79,81,2,0.009190237925048503,0.01232172640321318,64,68,4,2,2,2,12,8,2,44,90
267,68,68,65,65,0,34,34,47,47,0,34,34,55,55,0,0.007726607440688927,0.007726607440688927,64,64,0,-1,3,3,4,7,77,48,98
268,100,100,59,59,0,100,100,40,40,0,100,100,59,59,0,0.01766567956703768,0.02198849518363457,78,85,7,2,1,1,15,5,7,47,28
269,100,100,77,77,0,100,100,96,96,0,100,100,96,96,0,0.07022022533101875,0.07889989448245345,99,100,1,2,1,1,3,19,76,15,17
270,8,8,34,34,0,36,36,33,33,0,8,8,34,34,0,0.0005786446100956465,0.0005786446100956465,37,37,0,-1,4,4,8,2,39,63,66
271,132,1772,82,100,18,264,288,93,94,1,132,288,82,94,12,0.011981347220803976,0.03795227883862623,72,93,21,1,2,2,12,5,6,25,9
272,94,196,67,88,21,158,158,83,83,0,94,98,68,68,0,0.012117498893767658,0.012764219340345145,71,72,1,4,2,2,9,5,26,25,51
273,90,706,65,100,35,136,136,81,81,0,90,136,66,81,15,0.011777119711358454,0.019265461724360937,72,81,9,2,2,2,7,6,43,77,44
274,244,860,94,100,6,160,160,91,91,0,160,160,91,91,0,0.024881718234112803,0.04870826100275707,88,98,10,2,2,2,7,15,43,16,0
275,0,102,1,86,85,0,4,1,29,28,0,4,1,32,31,0.0,0.002825147213996392,1,49,48,4,-1,5,2,0,97,79,47
276,386,386,96,96,0,310,310,97,97,0,310,310,97,97,0,0.026039007454304094,0.026039007454304094,88,88,0,-1,2,2,11,19,33,15,82
277,0,0,1,1,0,0,0,1,1,0,0,0,1,1,0,0.0,0.0,1,1,0,-1,-1,-1,6,0,71,66,40
278,110,211,83,94,11,48,48,67,67,0,48,48,70,70,0,0.018108172504169646,0.018108172504169646,81,81,0,6,3,3,3,18,96,30,68
279,0,1640,1,100,99,0,62,1,76,75,0,62,1,79,78,0.0,0.05384798665713605,1,97,96,1,-1,2,3,0,75,76,0
280,66,272,55,93,38,76,76,55,55,0,66,76,55,59,4,0.006126825283365669,0.013989584397018279,53,75,22,3,3,3,6,6,71,28,20
281,16,222,38,89,51,60,60,39,39,0,16,35,38,46,8,0.0010892133837094523,0.005514142755029102,39,54,15,3,3,3,9,1,54,71,34
282,0,0,1,1,0,0,0,1,1,0,0,0,1,1,0,0.0,0.0,1,1,0,-1,-1,-1,14,0,17,89,97
283,22,228,43,92,49,158,158,66,66,0,22,28,43,47,4,0.004663194799006093,0.005582218591510943,54,54,0,3,3,3,13,3,13,29,71
284,16,118,48,86,38,22,22,52,52,0,16,22,51,54,3,0.0033016780693692774,0.0035059055788147996,52,53,1,4,3,3,2,3,98,46,56
285,46,46,59,59,0,28,28,45,45,0,28,28,50,50,0,0.007726607440688927,0.007726607440688927,64,64,0,-1,3,3,3,7,58,21,93
286,0,616,1,100,99,0,82,1,36,35,0,43,1,47,46,0.0,0.004629156880765172,1,54,53,2,-1,3,14,0,25,76,57
287,234,234,93,93,0,182,182,82,82,0,182,182,88,88,0,0.02049082678103407,0.02049082678103407,84,84,0,-1,2,2,9,16,28,12,59
288,0,1640,1,100,99,0,74,1,63,62,0,74,1,69,68,0.0,0.038360733857517273,1,96,95,1,-1,2,5,0,88,59,5
289,8,8,35,35,0,18,18,38,38,0,8,8,35,35,0,0.0004084550188910446,0.0004084550188910446,34,34,0,-1,4,4,3,2,96,56,85
290,98,199,78,92,14,48,48,64,64,0,48,48,66,66,0,0.011334626774226489,0.011368664692467409,69,69,0,5,3,3,3,14,85,14,78
291,190,396,89,97,8,166,166,86,86,0,166,166,88,88,0,0.015725518227305217,0.018754892950747133,79,81,2,3,2,2,8,14,57,14,47
292,318,518,96,100,4,200,200,95,95,0,200,200,95,95,0,0.03260832567480173,0.03332312195786106,91,92,1,3,2,2,8,22,21,9,61
293,12,628,32,100,68,20,30,30,37,7,12,30,32,43,11,0.0006126825283365669,0.007692569522448007,34,62,28,2,4,3,4,2,67,63,26
294,0,206,1,89,88,0,16,1,32,31,0,6,1,32,31,0.0,0.0002382654276864427,1,32,31,3,-1,4,9,1,26,69,88
295,129,329,85,99,14,56,56,84,84,0,56,56,84,84,0,0.01783586915824228,0.02038871302631131,82,86,4,3,2,2,2,13,86,24,29
296,24,1664,48,100,52,74,122,46,73,27,24,122,48,79,31,0.0020422750944552232,0.04026685727900882,45,96,51,1,3,2,8,3,57,54,3
297,100,100,65,65,0,100,100,45,45,0,100,100,65,65,0,0.050784574015453214,0.050784574015453214,99,99,0,-1,1,1,10,27,12,10,79
298,0,616,1,100,99,0,28,1,42,41,0,28,1,49,48,0.0,0.006399128629293032,1,57,56,2,-1,3,3,0,96,97,47
299,154,360,90,98,8,88,88,76,76,0,88,88,79,79,0,0.02049082678103407,0.024371149460498995,85,88,3,3,2,2,4,18,47,5,57
300,122,328,87,98,11,48,48,65,65,0,48,48,68,68,0,0.017801831240001363,0.0230436706491031,83,87,4,3,3,3,3,17,66,6,21
301,100,100,62,62,0,100,100,45,45,0,100,100,62,62,0,0.029034344259505088,0.029034344259505088,88,88,0,-1,1,1,12,18,3,5,89
302,260,466,95,100,5,120,120,85,85,0,120,120,87,87,0,0.029544913033118896,0.031076619353960312,89,90,1,3,2,2,6,22,74,9,53
303,80,286,64,95,31,56,56,49,49,0,56,56,58,58,0,0.008407365805507334,0.010449640899962559,65,68,3,3,3,3,6,13,69,24,46
304,334,540,95,99,4,216,216,85,85,0,216,216,87,87,0,0.03441233534157051,0.034684638687497875,94,94,0,3,2,2,12,29,2,0,56
305,60,266,69,98,29,32,32,63,63,0,32,32,64,64,0,0.008747744987916539,0.02130773681881616,66,87,21,3,3,3,2,7,86,48,37
306,100,100,64,64,0,100,100,59,59,0,100,100,64,64,0,0.04581503795227884,0.06637394056979475,98,99,1,1,1,1,6,17,40,6,20
307,0,616,1,100,99,0,124,1,59,58,0,76,1,56,55,0.0,0.007352190340038803,1,61,60,2,-1,3,14,0,25,89,21
308,100,100,66,66,0,100,100,67,67,0,100,100,73,73,0,0.06783757105415433,0.06783757105415433,99,99,0,-1,1,1,5,30,52,7,36
309,30,132,53,86,33,22,22,42,42,0,22,22,46,46,0,0.003914360597705844,0.0045270431260424114,53,56,3,4,3,3,2,6,68,41,71
310,40,656,47,100,53,64,78,40,43,3,40,78,47,57,10,0.004050512270669526,0.014840532353041287,49,73,24,2,3,3,8,6,27,73,19
311,0,1640,1,100,99,0,144,1,70,69,0,144,1,81,80,0.0,0.03618230709009837,1,96,95,1,-1,2,10,0,11,97,3
312,198,198,92,92,0,80,80,74,74,0,80,80,75,75,0,0.02825147213996392,0.02825147213996392,86,86,0,-1,3,3,5,22,70,9,93
313,16,222,36,93,57,104,104,64,64,0,16,22,36,40,4,0.0030634126416828346,0.004629156880765172,50,52,2,3,3,3,9,3,35,46,94
314,2,2,28,28,0,12,12,29,29,0,2,2,28,28,0,3.4037918240920386e-05,3.4037918240920386e-05,29,29,0,-1,5,5,7,1,46,65,87
315,0,206,1,90,89,0,22,1,32,31,0,14,1,35,34,0.0,0.0012594029749140542,1,39,38,3,-1,4,7,0,43,96,54
316,0,616,1,100,99,0,30,1,43,42,0,30,1,51,50,0.0,0.010313489226998877,1,67,66,2,-1,3,4,0,84,86,21
317,2,618,28,100,72,7,30,29,45,16,2,30,28,54,26,0.00010211375472276115,0.013615167296368155,30,77,47,2,5,3,4,1,78,65,12
318,46,662,68,100,32,32,32,67,67,0,32,32,68,68,0,0.00966676878042139,0.025970931617822254,69,88,19,2,3,3,2,5,97,25,5
319,213,413,91,98,7,176,176,85,85,0,176,176,89,89,0,0.026073045372545015,0.030532012662105586,88,89,1,3,2,2,8,20,30,23,38
320,94,710,68,100,32,78,78,68,68,0,78,78,71,71,0,0.00796487286837537,0.01763164164879676,65,82,17,2,2,2,4,5,83,47,8
321,258,464,94,98,4,168,168,93,93,0,168,168,94,94,0,0.026787841655604345,0.028728002995336805,88,88,0,3,2,2,6,15,44,16,90
322,0,0,1,1,0,0,0,1,1,0,0,0,1,1,0,0.0,0.0,1,1,0,-1,-1,-1,5,0,49,79,82
323,0,206,1,91,90,0,24,1,33,32,0,8,1,35,34,0.0,0.0013615167296368155,1,40,39,3,-1,4,6,0,44,98,61
324,282,882,99,100,1,56,56,86,86,0,56,56,86,86,0,0.04261547363763232,0.060417304877633686,97,98,1,2,2,2,2,40,95,3,1
325,10,10,36,36,0,30,30,39,39,0,10,10,36,36,0,0.0014295925661186562,0.0014295925661186562,43,43,0,-1,4,4,5,3,88,43,98
326,100,100,66,66,0,100,100,43,43,0,100,100,66,66,0,0.015180911535450491,0.017359338302869398,74,79,5,3,1,1,11,3,33,43,35
327,0,0,1,1,0,0,0,1,1,0,0,0,1,1,0,0.0,0.0,1,1,0,-1,-1,-1,10,0,18,82,59
328,40,40,55,55,0,52,52,76,76,0,40,40,69,69,0,0.004288777698355968,0.004288777698355968,54,54,0,-1,2,2,3,1,55,53,76
329,58,674,55,100,45,100,154,45,74,29,58,154,55,82,27,0.002110350930937064,0.028625889240614044,43,91,48,2,2,2,10,4,12,64,3
330,377,977,98,100,2,152,152,94,94,0,152,152,94,94,0,0.03832669593927635,0.051533408216753465,94,97,3,2,2,2,5,29,52,11,15
331,405,405,98,98,0,184,184,94,94,0,184,184,94,94,0,0.035739814152966405,0.035739814152966405,93,93,0,-1,2,2,7,29,43,1,85
332,100,100,59,59,0,100,100,46,46,0,100,100,59,59,0,0.026243234963749616,0.02811532046700024,87,89,2,2,1,1,11,8,5,17,64
333,120,120,88,88,0,56,56,93,93,0,56,56,93,93,0,0.02188638142891181,0.02188638142891181,87,87,0,-1,2,2,2,12,99,37,89
334,0,616,1,100,99,0,54,1,35,34,0,36,1,48,47,0.0,0.004561081044283332,1,55,54,2,-1,3,10,0,18,66,35
335,158,774,83,100,17,184,184,94,94,0,158,184,87,94,7,0.015657442390823378,0.027264372510977228,76,88,12,2,2,2,7,6,24,77,32
336,232,232,88,88,0,258,258,94,94,0,232,232,88,88,0,0.011981347220803976,0.011981347220803976,69,69,0,-1,2,2,12,13,2,24,67
337,169,169,86,86,0,238,238,90,90,0,169,169,86,86,0,0.008951972497362062,0.008951972497362062,64,64,0,-1,2,2,11,8,19,57,98
338,246,862,95,100,5,144,144,92,92,0,144,144,92,92,0,0.024064808196330712,0.02668572790088158,87,89,2,2,2,2,6,19,48,15,94
339,56,672,53,100,47,138,158,64,65,1,56,104,53,75,22,0.003914360597705844,0.011232513019503728,54,70,16,2,2,2,14,2,8,75,34
340,162,778,84,100,16,240,240,88,88,0,162,240,84,89,5,0.017393376221110316,0.035025017869907075,76,96,20,2,2,2,12,9,2,39,9
341,2,618,27,100,73,4,18,29,46,17,2,18,27,48,21,0.00010211375472276115,0.01664454201981007,29,79,50,2,5,3,2,1,99,65,16
342,22,228,41,91,50,88,88,47,47,0,22,32,41,45,4,0.0012594029749140542,0.0034718676605738795,40,52,12,3,3,3,8,2,10,61,70
343,540,1156,100,100,0,240,240,98,98,0,240,240,98,98,0,0.04646175839885633,0.049933626059430206,96,98,2,2,2,2,9,40,29,3,35
344,2,208,27,93,66,4,18,27,39,12,2,18,27,44,17,6.807583648184077e-05,0.010721944245889922,27,72,45,3,5,4,3,1,92,55,6
345,128,334,79,96,17,138,138,75,75,0,128,138,80,86,6,0.010109261717553355,0.010960209673576363,69,69,0,3,2,2,9,9,29,31,64
346,100,100,77,77,0,72,72,77,77,0,72,72,77,77,0,0.009564655025698629,0.009564655025698629,72,72,0,-1,2,2,3,6,82,13,69
347,6,212,32,92,60,14,18,32,34,2,6,18,32,47,15,3.4037918240920386e-05,0.005616256509751864,27,55,28,3,4,4,3,1,87,95,25
348,136,136,91,91,0,56,56,84,84,0,56,56,85,85,0,0.02661765206439974,0.02661765206439974,90,90,0,-1,2,2,2,18,98,30,67
349,1,1,24,24,0,3,3,24,24,0,1,1,24,24,0,6.807583648184077e-05,6.807583648184077e-05,27,27,0,-1,6,6,3,2,92,58,50
350,0,1640,1,100,99,0,80,1,44,43,0,80,1,58,57,0.0,0.018176248340651485,1,79,78,1,-1,2,9,0,28,79,14
351,0,0,1,1,0,0,0,1,1,0,0,0,1,1,0,0.0,0.0,1,1,0,-1,-1,-1,3,0,81,76,79
352,0,0,1,1,0,0,0,1,1,0,0,0,1,1,0,0.0,0.0,1,1,0,-1,-1,-1,3,0,87,81,99
353,16,222,37,94,57,66,66,48,48,0,16,36,37,49,12,0.0015317063208414173,0.005582218591510943,43,54,11,3,3,3,6,1,59,53,38
354,62,678,55,100,45,134,154,66,73,7,62,154,55,85,30,0.004220701861874128,0.025868817863099493,51,88,37,2,2,2,10,6,22,70,10
355,42,1682,57,100,43,32,56,64,81,17,32,56,64,81,17,0.008271214132543654,0.08363116511794139,68,99,31,1,3,2,2,5,89,25,3
356,32,648,51,100,49,54,54,55,55,0,32,54,51,59,8,0.004901460226692535,0.01664454201981007,56,80,24,2,3,3,4,3,73,29,6
357,0,206,1,90,89,0,24,1,33,32,0,15,1,37,36,0.0,0.002484768031587188,1,47,46,3,-1,4,6,0,74,66,22
358,129,129,83,83,0,96,96,74,74,0,96,96,74,74,0,0.016304162837400864,0.016304162837400864,79,79,0,-1,3,3,6,15,69,19,92
359,199,405,91,98,7,168,168,87,87,0,168,168,89,89,0,0.02396269444160795,0.0245413390517036,86,87,1,3,2,2,9,15,35,16,43
360,179,179,91,91,0,80,80,65,65,0,80,80,69,69,0,0.01872085503250621,0.01872085503250621,83,83,0,-1,3,3,5,18,37,5,82
361,42,658,59,100,41,48,48,66,66,0,48,48,67,67,0,0.00970080669866231,0.02413288403281255,70,88,18,2,3,3,3,5,76,25,5
362,0,101,1,77,76,0,4,1,24,23,0,1,1,24,23,0.0,0.0,1,1,0,6,-1,7,4,0,84,40,78
363,96,198,78,93,15,72,72,85,85,0,72,72,85,85,0,0.016508390346846386,0.017155110793423873,81,83,2,4,2,2,3,8,60,20,51
364,234,440,93,100,7,156,156,87,87,0,156,156,89,89,0,0.022499063957248374,0.024303073624017155,85,85,0,3,2,2,8,16,21,12,53
365,50,50,52,52,0,134,134,62,62,0,44,44,49,49,0,0.0035059055788147996,0.0035059055788147996,51,51,0,-1,3,3,14,6,8,41,96
366,0,102,1,77,76,0,10,1,26,25,0,2,1,25,24,0.0,0.00013615167296368154,1,29,28,4,-1,5,8,0,30,36,65
367,108,314,75,94,19,220,220,85,85,0,108,118,75,77,2,0.007011811157629599,0.008305252050784574,60,66,6,3,2,2,12,6,3,26,43
368,182,388,91,99,8,118,118,93,93,0,118,118,93,93,0,0.023996732359848873,0.026004969536063176,85,88,3,3,2,2,5,18,49,30,53
369,153,359,87,98,11,104,104,88,88,0,104,104,88,88,0,0.018312400013615168,0.019878144252697506,81,83,2,3,2,2,5,15,88,19,94
370,37,139,54,84,30,56,56,45,45,0,37,38,54,54,0,0.0048674223084516155,0.0048674223084516155,57,57,0,4,3,3,6,6,44,35,95
371,0,616,1,100,99,0,80,1,43,42,0,70,1,60,59,0.0,0.011266550937744648,1,71,70,2,-1,3,9,0,54,91,39
372,0,616,1,100,99,0,114,1,64,63,0,114,1,76,75,0.0,0.0245413390517036,1,87,86,2,-1,3,9,0,29,84,0
373,56,672,53,100,47,138,168,64,67,3,56,110,53,75,22,0.003914360597705844,0.011947309302563056,54,70,16,2,2,2,14,2,8,75,38
374,60,162,54,86,32,168,168,68,68,0,60,62,54,54,0,0.005718370264474625,0.005888559855679227,55,55,0,4,3,3,13,6,13,26,4
375,0,206,1,91,90,0,19,1,30,29,0,6,1,27,26,0.0,0.0009870996289866913,1,36,35,3,-1,4,6,0,56,81,71
376,16,117,42,86,44,28,28,43,43,0,16,17,42,44,2,0.0018380475850097008,0.0020763130126961434,43,47,4,5,3,3,3,1,66,53,60
377,22,22,40,40,0,70,70,35,35,0,22,22,40,40,0,0.0017018959120460194,0.0017018959120460194,41,41,0,-1,3,3,12,3,3,51,82
378,32,648,51,100,49,76,76,54,54,0,32,76,51,65,14,0.004935498144933456,0.01320671227747711,54,77,23,2,3,3,6,3,32,29,14
379,194,810,90,100,10,132,132,98,98,0,132,132,98,98,0,0.020150447598624867,0.03577385207120733,81,93,12,2,2,2,5,14,70,14,23
380,56,672,59,100,41,32,32,58,58,0,32,32,60,60,0,0.006671431975220395,0.019163347969638176,59,84,25,2,3,3,2,6,91,13,32
381,0,0,1,1,0,0,0,1,1,0,0,0,1,1,0,0.0,0.0,1,1,0,-1,-1,-1,16,0,9,59,45
382,0,616,1,100,99,0,56,1,45,44,0,56,1,57,56,0.0,0.02205657102011641,1,86,85,2,-1,3,6,0,74,67,10
383,212,828,88,100,12,232,242,77,79,2,212,228,88,90,2,0.012525953912658701,0.013615167296368155,71,72,1,2,2,2,14,14,16,32,49
384,6,107,32,81,49,18,18,35,35,0,6,7,32,36,4,0.0006467204465774873,0.0006807583648184077,35,35,0,5,4,4,3,1,87,49,58
385,55,157,55,85,30,56,56,48,48,0,55,56,56,56,0,0.004561081044283332,0.004799346471969774,53,53,0,4,3,3,6,6,65,28,56
386,2,618,26,100,74,12,76,27,40,13,2,56,26,53,27,3.4037918240920386e-05,0.0088498587426393,27,68,41,2,5,3,10,2,1,58,17
387,112,318,79,95,16,182,182,87,87,0,112,182,79,91,12,0.009870996289866912,0.012900371013308825,69,71,2,3,2,2,9,7,23,62,35
388,14,630,45,100,55,12,22,41,47,6,12,22,41,50,9,0.0026549576227917903,0.011981347220803976,47,73,26,2,4,3,2,6,95,70,17
389,145,351,90,100,10,48,48,68,68,0,48,48,69,69,0,0.019878144252697506,0.03094046768099663,85,91,6,3,3,3,3,18,81,5,18
390,0,206,1,88,87,0,21,1,30,29,0,6,1,29,28,0.0,0.0007147962830593281,1,36,35,3,-1,4,9,0,54,59,71
391,0,0,1,1,0,0,0,1,1,0,0,0,1,1,0,0.0,0.0,1,1,0,-1,-1,-1,5,1,61,69,89
392,0,616,1,100,99,0,62,1,42,41,0,62,1,57,56,0.0,0.021069471391129718,1,84,83,2,-1,3,7,0,24,93,1
393,0,0,1,1,0,0,0,1,1,0,0,0,1,1,0,0.0,0.0,1,1,0,-1,-1,-1,8,1,42,50,40
394,0,0,1,1,0,0,0,1,1,0,0,0,1,1,0,0.0,0.0,1,1,0,-1,-1,-1,2,0,86,99,89
395,1,1,26,26,0,3,3,26,26,0,1,1,26,26,0,3.4037918240920386e-05,3.4037918240920386e-05,26,26,0,-1,6,6,3,1,55,68,45
396,96,712,67,100,33,56,66,44,49,5,56,66,52,60,8,0.009258313761530345,0.015317063208414174,66,75,9,2,3,3,6,13,56,24,44
397,72,688,57,100,43,144,144,63,63,0,72,88,57,59,2,0.0020082371762143027,0.0037441710065012424,43,50,7,2,2,2,14,3,17,43,53
398,16,616,35,100,65,80,80,41,41,0,16,64,35,55,20,0.0010211375472276116,0.008611593314952858,39,67,28,2,3,3,10,1,18,71,27
399,150,766,83,100,17,134,134,90,90,0,134,134,90,90,0,0.018040096667687803,0.02634534871847238,80,89,9,2,2,2,6,12,56,37,14
400,0,616,1,100,99,0,36,1,35,34,0,36,1,48,47,0.0,0.006262976956329351,1,57,56,2,-1,3,5,0,50,87,34
401,0,1640,1,100,99,0,126,1,68,67,0,126,1,77,76,0.0,0.041968753191054836,1,96,95,1,-1,2,7,1,24,45,2
402,210,210,90,90,0,152,152,82,82,0,152,152,86,86,0,0.02042275094455223,0.02042275094455223,82,82,0,-1,2,2,8,17,10,6,86
403,137,137,88,88,0,48,48,54,54,0,48,48,56,56,0,0.020967357636406957,0.020967357636406957,86,86,0,-1,3,3,3,16,87,18,96
404,92,298,66,95,29,86,86,56,56,0,86,86,62,62,0,0.009190237925048503,0.01855066544130161,68,79,11,3,3,3,6,8,51,44,19
405,22,1662,40,100,60,110,164,60,75,15,22,164,40,84,44,0.0020082371762143027,0.02100139555464788,44,80,36,1,3,2,10,2,11,61,19
406,582,1198,100,100,0,368,368,98,98,0,368,368,98,98,0,0.04789135096497498,0.054324517512508934,99,100,1,2,2,2,14,36,17,2,77
407,16,632,34,100,66,54,94,34,41,7,16,60,34,55,21,0.00037441710065012424,0.006058749446883829,34,57,23,2,3,3,12,1,14,88,72
408,70,276,64,95,31,96,96,70,70,0,70,96,65,74,9,0.007113924912352361,0.008407365805507334,63,66,3,3,3,3,6,5,32,47,54
409,67,683,62,100,38,98,108,52,68,16,67,108,62,76,14,0.006705469893461316,0.012730181422104225,63,73,10,2,3,3,8,8,39,57,34
410,16,117,38,78,40,34,34,39,39,0,16,17,38,41,3,0.002927260968719153,0.002927260968719153,51,51,0,6,3,3,4,3,53,46,58
411,78,180,64,88,24,110,110,81,81,0,78,80,64,64,0,0.00891793457912114,0.010790020082371761,67,68,1,4,2,2,6,7,65,62,46
412,100,100,63,63,0,100,100,45,45,0,100,100,63,63,0,0.022328874366043774,0.024779604479390042,84,89,5,3,1,1,11,13,19,24,73
413,1,207,25,92,67,3,10,25,31,6,1,10,25,39,14,0.0,0.0011232513019503727,1,39,38,3,6,4,3,2,76,58,43
414,22,228,46,95,49,22,22,42,42,0,22,22,45,45,0,0.0030974505599237552,0.011164437183021887,49,73,24,3,3,3,2,2,91,75,20
415,0,206,1,92,91,0,24,1,36,35,0,16,1,43,42,0.0,0.004765308553728854,1,54,53,3,-1,4,4,0,77,80,62
416,0,0,1,1,0,0,0,1,1,0,0,0,1,1,0,0.0,0.0,1,1,0,-1,-1,-1,8,0,15,40,66
417,16,16,43,43,0,34,34,46,46,0,16,16,43,43,0,0.0020422750944552232,0.0020422750944552232,45,45,0,-1,3,3,4,1,73,53,50
418,140,140,84,84,0,182,182,87,87,0,140,140,85,85,0,0.01497668402600497,0.01497668402600497,76,76,0,-1,2,2,9,8,23,20,85
419,50,151,58,84,26,102,102,66,66,0,50,50,58,58,0,0.007658531604207087,0.007658531604207087,63,63,0,5,2,2,8,6,57,73,68
420,6,206,29,91,62,14,14,30,30,0,6,6,29,29,0,0.00010211375472276115,0.0007488342013002485,29,37,8,3,4,4,5,1,52,65,71
421,92,708,76,100,24,48,48,67,67,0,48,48,70,70,0,0.012525953912658701,0.016099935327955343,76,79,3,2,3,3,3,8,96,17,88
422,18,119,39,78,39,58,58,35,35,0,18,19,39,39,0,0.0006126825283365669,0.0006126825283365669,37,37,0,5,3,3,10,2,11,56,68
423,226,1866,92,100,8,176,200,85,95,10,176,200,89,95,6,0.019571802988529223,0.044045066203750975,82,97,15,1,2,2,8,18,42,30,16
424,100,100,78,78,0,100,100,88,88,0,100,100,88,88,0,0.04738078219136117,0.06154055617958406,96,98,2,2,1,1,4,8,78,44,19
425,6,212,29,89,60,48,48,35,35,0,6,44,29,52,23,0.0005786446100956465,0.008135062459579971,35,64,29,3,4,4,8,1,15,49,17
426,138,138,82,82,0,158,158,74,74,0,138,138,82,82,0,0.009054086252084823,0.009054086252084823,66,66,0,-1,2,2,9,9,28,31,93
427,40,40,50,50,0,86,86,54,54,0,40,40,50,50,0,0.004731270635487933,0.004731270635487933,53,53,0,-1,2,2,7,2,43,94,82
428,260,876,94,100,6,264,264,93,93,0,264,264,94,94,0,0.022601177711971135,0.03369753905851118,85,92,7,2,2,2,12,18,14,30,6
429,1,103,24,84,60,3,6,24,30,6,1,6,24,30,6,0.0,0.0007828721195411688,1,35,34,4,6,5,3,1,92,78,43
430,101,1741,74,100,26,250,284,79,85,6,101,284,74,95,21,0.007352190340038803,0.024881718234112803,61,85,24,1,2,2,16,8,4,57,19
431,100,100,66,66,0,100,100,67,67,0,100,100,73,73,0,0.05915790190271963,0.06045134279587461,98,98,0,3,1,1,5,22,52,9,64
432,182,1782,87,100,13,136,136,77,77,0,136,136,83,83,0,0.01783586915824228,0.05854521937438306,82,99,17,1,2,2,7,18,24,30,2
433,158,364,81,99,18,278,278,80,80,0,158,174,81,82,1,0.010347527145239796,0.013444977705163553,60,72,12,3,2,2,16,6,9,34,41
434,16,16,34,34,0,68,68,41,41,0,16,16,34,34,0,0.002314578440382586,0.002314578440382586,45,45,0,-1,3,3,8,2,42,94,98
435,100,100,67,67,0,100,100,54,54,0,100,100,67,67,0,0.034105994077402224,0.03948398515946765,94,97,3,2,1,1,8,8,27,8,72
436,29,235,51,94,43,28,28,43,43,0,28,28,50,50,0,0.004016474352428605,0.007113924912352361,53,64,11,3,3,3,3,6,66,73,35
437,340,940,97,100,3,182,182,87,87,0,182,182,92,92,0,0.033084856530174615,0.0494230572858164,91,98,7,2,2,2,9,29,23,11,9
438,16,118,45,87,42,22,22,49,49,0,16,18,48,50,2,0.003948398515946765,0.0046972327172470135,53,55,2,4,3,3,2,3,90,46,71
439,18,634,48,100,52,34,44,47,52,5,18,44,48,57,9,0.0020082371762143027,0.01678069369277375,45,79,34,2,3,3,4,2,78,52,19
440,183,183,85,85,0,192,192,87,87,0,192,192,88,88,0,0.01776779332176044,0.01776779332176044,77,77,0,-1,2,2,9,15,54,19,86
441,0,102,1,82,81,0,4,1,30,29,0,4,1,32,31,0.0,0.0013955546478777359,1,42,41,4,-1,5,2,0,90,76,83
442,63,269,58,95,37,114,114,67,67,0,63,69,58,60,2,0.005377991082065421,0.00622893903808843,55,58,3,3,2,2,9,4,23,22,71
443,16,222,36,93,57,36,36,38,38,0,16,30,36,47,11,0.0007147962830593281,0.0020763130126961434,36,44,8,3,3,3,5,2,52,42,64
444,2,618,28,100,72,9,38,28,36,8,2,38,28,46,18,3.4037918240920386e-05,0.008169100377820893,26,62,36,2,5,3,6,1,71,95,31
445,128,1768,80,100,20,252,276,83,89,6,128,276,80,96,16,0.0068075836481840775,0.02906838217774601,60,90,30,1,2,2,14,5,8,47,16
446,260,876,94,100,6,264,264,93,93,0,264,264,94,94,0,0.022601177711971135,0.038258620102794516,85,93,8,2,2,2,12,18,14,30,16
447,76,282,62,95,33,90,90,65,65,0,76,90,61,67,6,0.009088124170325743,0.013887470642295518,66,75,9,3,2,2,6,6,74,34,24
448,88,294,59,94,35,142,142,68,68,0,88,106,59,74,15,0.007113924912352361,0.009156200006807584,60,64,4,3,3,3,12,8,2,57,70
449,6,622,28,99,71,23,68,28,33,5,6,34,28,44,16,6.807583648184077e-05,0.0016678579938050988,28,40,12,2,4,3,17,1,20,78,54
450,62,1702,52,100,48,154,178,66,75,9,62,148,52,81,29,0.003778208924742163,0.019163347969638176,51,83,32,1,2,2,10,6,0,70,20
451,16,1656,33,100,67,30,158,32,82,50,16,158,33,86,53,0.00030634126416828345,0.033050818611933694,31,91,60,1,3,2,9,1,31,60,1
452,6,6,28,28,0,14,14,30,30,0,6,6,28,28,0,0.00013615167296368154,0.00013615167296368154,30,30,0,-1,4,4,5,1,50,65,96
453,331,433,99,100,1,88,88,71,71,0,88,88,71,71,0,0.03182545355526056,0.03240409816535621,94,94,0,4,2,2,4,29,53,1,56
454,175,1815,86,100,14,104,128,85,92,7,104,128,85,92,7,0.025290173253003846,0.04700636509071105,85,98,13,1,2,2,5,20,70,23,34
455,6,622,30,100,70,15,46,30,38,8,6,46,30,52,22,0.0,0.007658531604207087,1,63,62,2,4,3,6,1,41,95,24
456,100,100,59,59,0,100,100,39,39,0,100,100,59,59,0,0.02644746247319514,0.02644746247319514,88,88,0,-1,1,1,14,9,16,39,97
457,0,616,1,100,99,0,32,1,57,56,0,32,1,58,57,0.0,0.021920419347152727,1,89,88,2,-1,3,2,0,68,86,9
458,124,330,77,96,19,150,150,85,85,0,124,150,83,88,5,0.010415602981721638,0.011130399264780965,71,73,2,3,2,2,7,7,46,21,74
459,159,759,87,100,13,104,104,82,82,0,104,104,82,82,0,0.018040096667687803,0.024575376969944517,82,86,4,2,2,2,5,15,80,19,31
460,0,206,1,90,89,0,26,1,33,32,0,6,1,28,27,0.0,0.0025188059498281084,1,47,46,3,-1,4,7,0,43,96,46
461,6,622,29,100,71,28,80,31,40,9,6,80,29,58,29,0.0,0.011981347220803976,1,70,69,2,4,3,10,1,22,65,5
462,2,208,27,93,66,4,10,27,30,3,2,10,27,40,13,6.807583648184077e-05,0.011232513019503728,27,72,45,3,5,4,3,1,92,60,12
463,100,202,69,90,21,94,94,72,72,0,94,94,73,73,0,0.00966676878042139,0.010075223799312433,70,70,0,4,2,2,5,7,80,21,42
464,0,616,1,100,99,0,28,1,45,44,0,28,1,53,52,0.0,0.009258313761530345,1,65,64,2,-1,3,3,0,87,80,38
465,96,96,78,78,0,56,56,82,82,0,56,56,82,82,0,0.015521290717859695,0.015521290717859695,79,79,0,-1,2,2,2,7,89,48,36
466,323,939,97,100,3,152,152,99,99,0,152,152,99,99,0,0.04278566322883692,0.060417304877633686,96,100,4,2,2,2,5,29,70,11,16
467,291,497,96,100,4,96,96,91,91,0,96,96,91,91,0,0.03863303720344464,0.04169644984512747,94,94,0,3,2,2,3,29,76,1,29
468,104,310,84,100,16,52,52,80,80,0,52,52,82,82,0,0.01684876952925559,0.021920419347152727,83,85,2,3,2,2,3,14,60,32,21
469,16,222,36,90,54,72,72,46,46,0,16,34,36,47,11,0.00353994349705572,0.007011811157629599,49,61,12,3,3,3,7,1,43,90,26
470,6,212,31,92,61,18,18,38,38,0,6,18,31,46,15,0.0010892133837094523,0.00445896728956057,39,54,15,3,4,4,3,1,85,71,47
471,72,72,55,55,0,136,136,64,64,0,72,72,55,55,0,0.00881582082439838,0.00881582082439838,60,60,0,-1,3,3,11,6,5,34,91
472,22,638,40,100,60,62,76,44,54,10,22,76,40,59,19,0.0022465026039007454,0.010449640899962559,39,66,27,2,3,3,6,2,71,61,34
473,100,100,60,60,0,100,100,50,50,0,100,100,60,60,0,0.05119302903434426,0.05119302903434426,98,98,0,-1,1,1,9,27,28,10,89
474,100,100,58,58,0,100,100,35,35,0,100,100,59,59,0,0.013751318969331836,0.013921508560536438,71,71,0,3,1,1,17,6,20,35,88
475,116,322,81,97,16,94,94,78,78,0,94,94,78,78,0,0.013615167296368155,0.014772456516559448,76,76,0,3,2,2,5,8,45,17,61
476,118,1718,79,100,21,126,126,80,80,0,126,126,83,83,0,0.012628067667381462,0.03625038292658021,74,94,20,1,2,2,7,9,62,27,12
477,0,206,1,94,93,0,16,1,34,33,0,16,1,37,36,0.0,0.006058749446883829,1,58,57,3,-1,4,4,1,53,50,24
478,0,206,1,94,93,0,12,1,31,30,0,12,1,36,35,0.0,0.0019061234214915416,1,44,43,3,-1,4,2,0,91,98,54
479,0,0,1,1,0,0,0,1,1,0,0,0,1,1,0,0.0,0.0,1,1,0,-1,-1,-1,10,0,18,91,93
480,6,6,30,30,0,15,15,28,28,0,6,6,30,30,0,6.807583648184077e-05,6.807583648184077e-05,29,29,0,-1,4,4,9,2,54,58,66
481,0,101,1,81,80,0,2,1,25,24,0,1,1,25,24,0.0,0.00010211375472276115,1,28,27,5,-1,6,2,0,68,85,65
482,46,246,59,94,35,28,28,45,45,0,28,28,50,50,0,0.005480104836788182,0.012696143503863304,56,73,17,3,3,3,3,6,58,13,33
483,16,222,38,93,55,72,72,49,49,0,16,26,38,47,9,0.0030634126416828346,0.004016474352428605,48,50,2,3,3,3,7,2,62,94,64
484,104,310,82,98,16,112,112,95,95,0,112,112,95,95,0,0.021035433472888797,0.023111746485584943,84,85,1,3,2,2,4,5,73,25,70
485,14,220,45,96,51,12,12,41,41,0,12,12,41,41,0,0.0026549576227917903,0.009632730862180468,47,68,21,3,4,4,2,6,95,70,27
486,100,100,72,72,0,100,100,77,77,0,100,100,77,77,0,0.026004969536063176,0.029510875114877974,86,90,4,3,1,1,6,4,69,64,35
487,184,800,87,100,13,248,248,90,90,0,184,219,88,90,2,0.01330882603219987,0.018142210422410564,72,80,8,2,2,2,11,8,33,17,22
488,100,100,59,59,0,100,100,39,39,0,100,100,59,59,0,0.023622315259198747,0.02396269444160795,84,85,1,3,1,1,14,8,16,20,88
489,81,697,75,100,25,22,32,49,68,19,22,32,50,68,18,0.015351101126655093,0.027672827529868275,78,88,10,2,3,3,2,17,93,6,34
490,174,790,87,100,13,192,192,86,86,0,192,192,89,89,0,0.020150447598624867,0.023281936076789543,83,84,1,2,2,2,9,12,28,37,35
491,0,206,1,96,95,0,18,1,35,34,0,18,1,44,43,0.0,0.005480104836788182,1,56,55,3,-1,4,3,0,75,80,44
492,80,696,72,100,28,48,48,66,66,0,48,48,67,67,0,0.009292351679771264,0.02382654276864427,69,87,18,2,3,3,3,9,76,31,5
493,140,140,83,83,0,220,220,86,86,0,140,140,83,83,0,0.014772456516559448,0.014772456516559448,72,72,0,-1,2,2,12,8,2,20,84
494,0,206,1,94,93,0,14,1,32,31,0,14,1,40,39,0.0,0.004935498144933456,1,54,53,3,-1,4,3,0,66,87,57
495,270,886,94,100,6,88,88,73,73,0,88,88,74,74,0,0.0315531502093332,0.04183260151809115,89,95,6,2,2,2,4,27,83,10,17
496,8,109,37,84,47,10,10,32,32,0,8,9,37,40,3,0.00030634126416828345,0.00030634126416828345,32,32,0,5,4,4,3,2,85,63,95
497,46,252,49,93,44,128,128,59,59,0,46,59,50,55,5,0.0028932230504782326,0.003948398515946765,49,54,5,3,2,2,14,2,8,83,64
498,0,0,1,1,0,0,0,1,1,0,0,0,1,1,0,0.0,0.0,1,1,0,-1,-1,-1,8,0,42,36,99
499,0,616,1,100,99,0,96,1,40,39,0,96,1,63,62,0.0,0.01327478811395895,1,74,73,2,-1,3,13,0,13,85,12
500,2,2,26,26,0,17,17,26,26,0,2,2,26,26,0,0.0,0.0,1,1,0,-1,5,5,16,1,9,68,92
501,115,115,72,72,0,164,164,69,69,0,115,115,72,72,0,0.007216038667075122,0.007216038667075122,57,57,0,-1,2,2,11,6,5,35,92
502,212,418,90,98,8,120,120,88,88,0,120,120,87,87,0,0.023213860240307704,0.02542632492596753,85,87,2,3,2,2,6,19,71,15,83
503,0,616,1,100,99,0,22,1,48,47,0,22,1,52,51,0.0,0.02729841042921815,1,88,87,2,-1,3,2,0,90,98,10
504,0,616,1,100,99,0,34,1,46,45,0,22,1,50,49,0.0,0.003608019333537561,1,52,51,2,-1,3,4,0,77,85,52
505,118,324,86,98,12,72,72,79,79,0,72,72,80,80,0,0.02038871302631131,0.023996732359848873,85,88,3,3,2,2,3,9,75,39,13
506,104,310,71,96,25,148,148,71,71,0,104,120,71,74,3,0.00704584907587052,0.00891793457912114,61,66,5,3,2,2,9,6,28,26,41
507,16,1656,36,100,64,56,98,39,53,14,16,80,36,58,22,0.0007147962830593281,0.01596378365499166,36,77,41,1,3,2,9,2,35,42,26
508,1,1,26,26,0,5,5,26,26,0,1,1,26,26,0,0.00010211375472276115,0.00010211375472276115,28,28,0,-1,6,6,5,2,37,58,76
509,6,212,32,94,62,14,14,34,34,0,6,12,32,38,6,0.002586881786309949,0.0033016780693692774,48,49,1,3,4,4,3,1,60,90,4
510,10,216,36,93,57,28,36,36,40,4,10,36,36,49,13,0.001157289220191293,0.010449640899962559,41,68,27,3,4,4,6,3,69,43,19
511,76,276,69,98,29,32,32,58,58,0,32,32,60,60,0,0.011062323428299126,0.014466115252391163,71,78,7,3,3,3,2,6,91,77,35
512,100,100,62,62,0,100,100,43,43,0,100,100,62,62,0,0.037475747983253344,0.039143605977058446,93,93,0,2,1,1,12,19,14,15,61
513,36,652,52,100,48,88,108,52,65,13,36,108,52,77,25,0.00439089145307873,0.020831205963443275,54,83,29,2,3,3,8,6,21,73,30
514,24,230,50,98,48,22,22,47,47,0,22,22,52,52,0,0.0028932230504782326,0.007828721195411689,49,65,16,3,3,3,2,6,89,70,57
515,0,616,1,100,99,0,54,1,34,33,0,22,1,39,38,0.0,0.00353994349705572,1,52,51,2,-1,3,10,0,11,79,29
516,6,622,29,100,71,58,84,33,37,4,6,44,29,52,23,0.0002723033459273631,0.007794683277170768,30,63,33,2,4,3,13,1,13,88,77
517,56,158,57,91,34,28,28,48,48,0,28,28,54,54,0,0.00622893903808843,0.007011811157629599,59,59,0,4,3,3,3,6,55,13,51
518,100,100,69,69,0,100,100,55,55,0,100,100,69,69,0,0.03151911229109228,0.03883726471289016,90,94,4,2,1,1,8,14,30,14,27
519,0,206,1,93,92,0,24,1,33,32,0,24,1,45,44,0.0,0.006977773239388679,1,62,61,3,-1,4,6,0,34,86,8
520,36,242,53,95,42,28,28,43,43,0,28,28,50,50,0,0.0038462847612240037,0.008407365805507334,52,68,16,3,3,3,3,6,66,41,62
521,16,222,35,93,58,110,110,59,59,0,16,23,35,43,8,0.003437829742332959,0.004356853534837809,50,53,3,3,3,3,10,1,36,90,61
522,112,214,86,95,9,32,32,70,70,0,32,32,70,70,0,0.019707954661492902,0.021750229755948126,84,85,1,4,3,3,2,18,95,30,75
523,38,654,51,100,49,72,92,49,61,12,38,92,51,67,16,0.002586881786309949,0.027740903366350114,47,90,43,2,3,3,7,6,62,70,11
524,81,697,60,100,40,112,112,67,67,0,81,112,60,77,17,0.005582218591510943,0.011913271384322134,56,69,13,2,2,2,8,6,27,35,48
525,111,213,83,93,10,64,64,68,68,0,64,64,71,71,0,0.01405766023350012,0.0141938119064638,79,79,0,4,3,3,4,15,72,19,55
526,0,616,1,100,99,0,34,1,42,41,0,34,1,51,50,0.0,0.014874570271282209,1,79,78,2,-1,3,4,0,79,97,15
527,0,1640,1,100,99,0,84,1,58,57,0,84,1,65,64,0.0,0.035705776234725484,1,94,93,1,-1,2,5,0,52,79,9
528,164,164,87,87,0,164,164,77,77,0,164,164,87,87,0,0.011777119711358454,0.011777119711358454,72,72,0,-1,2,2,10,14,36,32,93
529,16,222,40,97,57,20,24,44,44,0,16,24,40,50,10,0.0009530617107457708,0.004901460226692535,35,52,17,3,3,3,3,1,94,4,13
530,2,1642,27,100,73,6,52,29,77,48,2,52,27,79,52,6.807583648184077e-05,0.03849688553048095,30,95,65,1,5,2,3,1,85,60,62
531,361,567,97,100,3,158,158,82,82,0,158,158,87,87,0,0.030395860989141904,0.03240409816535621,89,91,2,3,2,2,9,29,35,1,70
532,0,0,1,1,0,0,0,1,1,0,0,0,1,1,0,0.0,0.0,1,1,0,-1,-1,-1,3,0,75,98,89
533,158,158,94,94,0,46,46,83,83,0,46,46,83,83,0,0.02917049593246877,0.02917049593246877,94,94,0,-1,2,2,2,22,99,9,67
534,0,206,1,92,91,0,30,1,38,37,0,30,1,49,48,0.0,0.012117498893767658,1,72,71,3,-1,4,5,0,37,84,5
535,0,0,1,1,0,0,0,1,1,0,0,0,1,1,0,0.0,0.0,1,1,0,-1,-1,-1,6,0,41,89,87
536,62,678,56,100,44,132,142,64,65,1,62,92,56,60,4,0.0042547397801150485,0.00881582082439838,55,63,8,2,3,3,12,6,14,35,26
537,74,74,60,60,0,100,100,66,66,0,74,74,60,60,0,0.006671431975220395,0.006671431975220395,59,59,0,-1,2,2,6,6,44,26,84
538,146,146,82,82,0,116,116,76,76,0,116,116,80,80,0,0.015283025290173252,0.015283025290173252,77,77,0,-1,2,2,7,13,62,33,87
539,66,682,64,100,36,70,70,59,59,0,70,70,66,66,0,0.009564655025698629,0.019741992579733823,69,82,13,2,3,3,5,6,80,77,8
540,0,616,1,100,99,0,100,1,47,46,0,100,1,61,60,0.0,0.014704380680077607,1,75,74,2,-1,3,10,0,11,80,12
541,0,206,1,91,90,0,11,1,29,28,0,6,1,29,28,0.0,0.0002723033459273631,1,32,31,3,-1,4,4,0,83,82,4
542,136,237,85,92,7,88,88,77,77,0,88,88,77,77,0,0.01504475986248681,0.015146873617209572,79,79,0,5,2,2,4,13,79,33,65
543,34,136,52,84,32,54,54,54,54,0,34,54,52,57,5,0.006297014874570271,0.006773545729943157,59,59,0,4,3,3,4,7,47,62,51
544,16,16,38,38,0,56,56,46,46,0,16,16,38,38,0,0.0032336022328874367,0.0032336022328874367,50,50,0,-1,3,3,6,1,74,90,93
545,152,152,84,84,0,88,88,73,73,0,88,88,74,74,0,0.017052997038701112,0.017052997038701112,82,82,0,-1,2,2,4,8,83,8,89
546,0,616,1,100,99,0,28,1,39,38,0,28,1,48,47,0.0,0.012866333095067906,1,78,77,2,-1,3,3,0,82,66,6
547,0,0,1,1,0,0,0,1,1,0,0,0,1,1,0,0.0,0.0,1,1,0,-1,-1,-1,3,0,55,99,85
548,2,208,26,88,62,8,16,26,28,2,2,8,26,33,7,6.807583648184077e-05,0.00034037918240920387,27,35,8,3,5,4,7,1,24,78,88
549,102,102,83,83,0,80,80,95,95,0,80,80,95,95,0,0.016882807447496512,0.016882807447496512,82,82,0,-1,2,2,2,4,68,38,86
550,0,206,1,90,89,0,15,1,28,27,0,6,1,28,27,0.0,0.00037441710065012424,1,33,32,3,-1,4,8,0,39,36,60
551,125,125,83,83,0,72,72,77,77,0,72,72,77,77,0,0.01929949964260186,0.01929949964260186,84,84,0,-1,2,2,3,12,82,37,69
552,22,22,42,42,0,146,146,67,67,0,22,22,42,42,0,0.0046972327172470135,0.0046972327172470135,57,57,0,-1,3,3,11,3,19,29,82
553,120,326,75,96,21,158,158,74,74,0,120,158,75,86,11,0.006331052792811192,0.009598692943939549,59,67,8,3,2,2,9,6,28,13,22
554,216,318,95,97,2,128,128,95,95,0,128,128,95,95,0,0.023996732359848873,0.024405187378739916,87,87,0,4,2,2,5,18,45,5,74
555,100,100,58,58,0,100,100,35,35,0,100,100,59,59,0,0.03230198441063344,0.04149222233568195,92,96,4,1,1,1,17,19,20,15,47
556,22,228,45,94,49,56,56,45,45,0,22,29,45,48,3,0.002586881786309949,0.003914360597705844,47,49,2,3,3,3,6,2,59,75,61
557,2,1642,26,100,74,15,112,26,57,31,2,82,26,56,30,0.0,0.016338200755641786,1,74,73,1,5,2,14,1,25,78,44
558,22,638,41,100,59,92,130,36,61,25,22,107,41,74,33,0.001157289220191293,0.008713707069675619,37,64,27,2,3,3,14,3,16,51,24
559,442,544,100,100,0,168,168,99,99,0,168,168,99,99,0,0.04935498144933456,0.049389019367575476,99,99,0,4,2,2,6,36,71,2,63
560,70,70,57,57,0,130,130,65,65,0,70,70,57,57,0,0.005718370264474625,0.005718370264474625,56,56,0,-1,3,3,10,5,36,47,67
561,42,142,59,87,28,38,38,55,55,0,38,38,58,58,0,0.007454304094761564,0.007624493685966166,64,64,0,4,3,3,3,6,76,34,63
562,67,67,64,64,0,38,38,49,49,0,38,38,54,54,0,0.007488342013002485,0.007488342013002485,60,60,0,-1,3,3,3,8,87,44,93
563,128,128,86,86,0,56,56,80,80,0,56,56,81,81,0,0.01861874127778345,0.01861874127778345,83,83,0,-1,2,2,2,14,91,32,98
564,100,100,64,64,0,100,100,57,57,0,100,100,66,66,0,0.03965417475067225,0.03965417475067225,93,93,0,4,1,1,7,15,46,19,95
565,40,40,58,58,0,44,44,67,67,0,40,40,67,67,0,0.00616086320160659,0.00616086320160659,62,62,0,-1,2,2,3,2,81,42,97
566,6,6,32,32,0,12,12,35,35,0,6,6,32,32,0,0.0005105687736138058,0.0005105687736138058,37,37,0,-1,4,4,2,1,98,49,45
567,0,102,1,76,75,0,7,1,25,24,0,2,1,25,24,0.0,0.0002723033459273631,1,30,29,4,-1,5,6,0,56,59,55
568,16,1656,33,100,67,136,214,61,73,12,16,214,33,89,56,0.0027911092957554717,0.03788420300214439,48,97,49,1,3,2,15,2,7,94,3
569,303,303,97,97,0,136,136,99,99,0,136,136,99,99,0,0.040913577725586306,0.040913577725586306,95,95,0,-1,2,2,4,29,84,0,92
570,150,766,82,100,18,198,198,83,83,0,150,198,82,90,8,0.01055175465468532,0.014636304843595765,73,79,6,2,2,2,10,7,0,48,13
571,38,654,49,100,51,62,62,43,43,0,38,62,49,58,9,0.002144388849177984,0.009905034208107831,46,69,23,2,3,3,7,3,43,54,77
572,100,100,59,59,0,100,100,39,39,0,100,100,59,59,0,0.026958031246808945,0.02818339630348208,89,89,0,3,1,1,14,15,16,19,53
573,0,206,1,91,90,0,24,1,36,35,0,24,1,49,48,0.0,0.004629156880765172,1,55,54,3,-1,4,4,0,83,80,62
574,6,6,31,31,0,66,66,37,37,0,6,6,31,31,0,0.001055175465468532,0.001055175465468532,39,39,0,-1,4,4,11,1,19,71,81
575,6,622,29,100,71,23,50,30,37,7,6,37,29,50,21,0.00013615167296368154,0.0057524081827155455,31,56,25,2,4,3,8,1,10,65,25
576,70,276,60,94,34,76,76,54,54,0,70,76,63,65,2,0.005377991082065421,0.010960209673576363,52,70,18,3,3,3,6,5,56,47,21
577,18,120,41,77,36,46,46,43,43,0,18,20,41,41,0,0.0014295925661186562,0.0016338200755641784,42,43,1,4,3,3,6,2,65,61,55
578,18,18,40,40,0,86,86,35,35,0,18,18,40,40,0,0.0007147962830593281,0.0007147962830593281,35,35,0,-1,3,3,14,2,16,56,96
579,16,16,48,48,0,22,22,52,52,0,16,16,51,51,0,0.003437829742332959,0.003437829742332959,53,53,0,-1,3,3,2,1,98,90,66
580,6,212,29,90,61,32,32,34,34,0,6,16,29,36,7,0.00013615167296368154,0.002280540522141666,31,44,13,3,4,4,8,1,10,4,70
581,56,56,54,54,0,196,196,73,73,0,56,56,54,54,0,0.005888559855679227,0.005888559855679227,57,57,0,-1,2,2,12,3,6,29,59
582,6,6,32,32,0,18,18,35,35,0,6,6,32,32,0,0.0016338200755641784,0.0016338200755641784,43,43,0,-1,4,4,3,1,58,53,84
583,160,760,85,100,15,176,176,85,85,0,160,176,87,88,1,0.01494264610776405,0.02651553830967698,78,87,9,2,2,2,8,8,42,17,12
584,22,22,40,40,0,66,66,37,37,0,22,22,40,40,0,0.002212464685659825,0.002212464685659825,46,46,0,-1,3,3,10,2,11,75,36
585,172,372,88,96,8,136,136,81,81,0,136,136,82,82,0,0.017087034956942034,0.023009632730862182,80,85,5,3,2,2,7,18,43,5,25
586,6,622,32,100,68,36,66,36,48,12,6,66,32,58,26,0.0009870996289866913,0.020967357636406957,37,83,46,2,4,3,6,1,44,71,9
587,16,222,37,93,56,42,46,38,42,4,16,42,37,51,14,0.0011232513019503727,0.005582218591510943,38,56,18,3,3,3,6,1,65,71,26
588,64,64,56,56,0,130,130,65,65,0,64,64,56,56,0,0.006637394056979475,0.006637394056979475,60,60,0,-1,3,3,10,4,22,72,96
589,0,0,1,1,0,0,0,1,1,0,0,0,1,1,0,0.0,0.0,1,1,0,-1,-1,-1,8,0,30,66,69
590,8,624,35,100,65,42,104,35,63,28,8,104,35,77,42,0.0005105687736138058,0.023996732359848873,35,86,51,2,4,3,9,2,35,56,0
591,78,284,60,94,34,100,100,63,63,0,78,90,61,65,4,0.008203138296061813,0.010279451308757957,64,70,6,3,2,2,6,4,41,72,29
592,42,42,53,53,0,44,44,49,49,0,40,40,52,52,0,0.003437829742332959,0.003437829742332959,52,52,0,-1,3,3,4,6,53,41,96
593,54,156,55,87,32,64,64,60,60,0,54,64,55,62,7,0.007590455767725246,0.007828721195411689,61,63,2,4,3,3,4,4,83,72,88
594,100,100,62,62,0,100,100,45,45,0,100,100,62,62,0,0.042683549474114166,0.042683549474114166,96,96,0,-1,1,1,12,20,3,23,96
595,1,1,26,26,0,6,6,26,26,0,1,1,26,26,0,3.4037918240920386e-05,3.4037918240920386e-05,28,28,0,-1,6,6,6,1,41,78,79
596,0,1640,1,100,99,0,184,1,69,68,0,184,1,88,87,0.0,0.023894618605126112,1,89,88,1,-1,2,14,0,8,59,15
597,78,180,61,87,26,152,152,80,80,0,78,81,61,62,1,0.008169100377820893,0.008305252050784574,63,63,0,4,2,2,8,7,30,62,63
598,0,0,1,1,0,0,0,1,1,0,0,0,1,1,0,0.0,0.0,1,1,0,-1,-1,-1,3,0,76,97,89
599,0,206,1,92,91,0,34,1,33,32,0,15,1,35,34,0.0,0.002723033459273631,1,48,47,3,-1,4,9,0,35,84,22
600,2,2,29,29,0,4,4,30,30,0,2,2,29,29,0,0.0002723033459273631,0.0002723033459273631,34,34,0,-1,5,5,2,1,97,88,99
601,16,16,36,36,0,40,40,40,40,0,16,16,36,36,0,0.0004084550188910446,0.0004084550188910446,34,34,0,-1,3,3,5,1,52,49,67
602,22,638,44,100,56,42,56,41,48,7,22,56,44,57,13,0.0007147962830593281,0.018074134585928724,37,79,42,2,3,3,6,2,69,63,15
603,2,618,27,99,72,13,92,28,41,13,2,69,27,55,28,0.0,0.005820484019197386,1,57,56,2,5,3,11,2,19,58,57
604,212,212,90,90,0,166,166,83,83,0,166,166,88,88,0,0.013376901868681712,0.013376901868681712,75,75,0,-1,2,2,8,14,15,32,45
605,2,618,28,100,72,5,28,28,43,15,2,28,28,53,25,0.00017018959120460194,0.012015385139044895,31,75,44,2,5,3,3,1,76,65,33
606,0,616,1,100,99,0,110,1,57,56,0,110,1,71,70,0.0,0.03114469519044215,1,90,89,2,-1,3,10,0,0,86,11
607,56,56,51,51,0,112,112,67,67,0,56,56,52,52,0,0.0051397256543789785,0.0051397256543789785,55,55,0,-1,2,2,8,3,27,29,76
608,1,1,26,26,0,4,4,26,26,0,1,1,26,26,0,3.4037918240920386e-05,3.4037918240920386e-05,26,26,0,-1,6,6,4,1,47,78,99
609,0,616,1,100,99,0,58,1,37,36,0,53,1,53,52,0.0,0.010075223799312433,1,66,65,2,-1,3,8,0,15,80,39
610,6,1646,28,100,72,26,104,31,62,31,6,104,28,80,52,0.00037441710065012424,0.02117158514585248,32,84,52,1,4,2,9,1,31,4,14
611,32,648,46,100,54,70,74,42,42,0,32,74,46,56,10,0.0019741992579733825,0.012049423057285817,44,73,29,2,3,3,8,3,10,51,19
612,358,358,98,98,0,312,312,98,98,0,312,312,98,98,0,0.02491575615235372,0.02491575615235372,88,88,0,-1,2,2,12,19,6,15,45
613,1,617,26,99,73,12,98,26,41,15,1,79,26,57,31,0.00010211375472276115,0.010007147962830594,27,67,40,2,6,3,12,1,14,78,33
614,233,433,99,100,1,56,56,82,82,0,56,56,82,82,0,0.037373634228530586,0.038224582184553595,96,96,0,3,2,2,2,29,89,11,64
615,10,216,39,95,56,8,8,32,32,0,8,8,38,38,0,0.0020422750944552232,0.0057524081827155455,44,58,14,3,4,4,2,3,95,54,72
616,198,814,91,100,9,158,158,80,80,0,158,158,86,86,0,0.019707954661492902,0.02297559481262126,83,85,2,2,2,2,9,18,23,5,29
617,0,102,1,82,81,0,6,1,27,26,0,2,1,27,26,0.0,0.00030634126416828345,1,33,32,4,-1,5,4,0,78,81,49
618,184,1784,84,100,16,166,166,84,84,0,166,166,85,85,0,0.011947309302563056,0.02757071377514551,69,87,18,1,2,2,8,13,27,24,21
619,47,663,55,100,45,86,86,63,63,0,47,86,55,67,12,0.004731270635487933,0.019980258007420267,55,85,30,2,3,3,6,6,34,35,15
620,6,212,33,93,60,24,24,38,38,0,6,24,33,49,16,0.0028591851322373124,0.005650294427992784,50,57,7,3,4,4,4,1,73,90,41
621,0,0,1,1,0,0,0,1,1,0,0,0,1,1,0,0.0,0.0,1,1,0,-1,-1,-1,5,0,45,99,84
622,128,128,77,77,0,214,214,83,83,0,128,128,77,77,0,0.006909697402906838,0.006909697402906838,56,56,0,-1,2,2,11,5,5,47,92
623,74,280,68,97,29,48,48,59,59,0,48,48,63,63,0,0.011777119711358454,0.017597603730555838,77,83,6,3,3,3,3,9,75,27,44
624,6,108,33,84,51,12,12,35,35,0,6,8,33,38,5,0.0004765308553728854,0.0007828721195411688,37,37,0,4,4,4,2,1,86,49,63
625,100,100,58,58,0,100,100,35,35,0,100,100,59,59,0,0.0424112461281868,0.05323530412879948,97,98,1,1,1,1,17,29,20,0,17
626,523,729,100,100,0,216,216,99,99,0,216,216,99,99,0,0.054528745021954456,0.05650294427992784,97,98,1,3,2,2,6,36,48,2,90
627,104,310,75,93,18,80,80,59,59,0,80,80,63,63,0,0.009190237925048503,0.01929949964260186,66,82,16,3,3,3,5,9,61,31,19
628,135,341,81,98,17,220,220,84,84,0,135,147,81,86,5,0.008407365805507334,0.009973110044589673,63,66,3,3,2,2,12,8,14,57,75
629,74,176,66,92,26,72,72,80,80,0,72,72,80,80,0,0.007760645358929848,0.008747744987916539,61,64,3,4,2,2,3,5,87,47,83
630,0,206,1,94,93,0,10,1,31,30,0,10,1,38,37,0.0,0.005105687736138058,1,58,57,3,-1,4,3,0,81,79,24
631,166,782,84,100,16,124,124,88,88,0,124,124,89,89,0,0.017393376221110316,0.02811532046700024,79,88,9,2,2,2,6,8,41,8,39
632,126,226,85,95,10,48,48,72,72,0,48,48,74,74,0,0.018312400013615168,0.01861874127778345,85,85,0,4,3,3,3,17,60,6,42
633,6,622,30,100,70,36,56,36,47,11,6,56,30,56,26,0.0006807583648184077,0.016406276592123625,36,79,43,2,4,3,6,1,65,49,19
634,1,1,26,26,0,3,3,26,26,0,1,1,26,26,0,3.4037918240920386e-05,3.4037918240920386e-05,28,28,0,-1,6,6,3,1,64,78,45
635,0,206,1,95,94,0,8,1,32,31,0,8,1,37,36,0.0,0.0020763130126961434,1,44,43,3,-1,4,2,0,89,98,70
636,58,264,68,99,31,32,32,69,69,0,32,32,69,69,0,0.012832295176826986,0.017393376221110316,72,81,9,3,3,3,2,8,93,20,26
637,56,56,59,59,0,60,60,55,55,0,60,60,60,60,0,0.00527587732734266,0.00527587732734266,57,57,0,-1,3,3,5,6,70,13,86
638,32,648,51,100,49,64,88,41,50,9,32,88,51,64,13,0.002586881786309949,0.017427414139351238,47,80,33,2,3,3,8,2,57,83,18
639,0,616,1,100,99,0,36,1,39,38,0,36,1,50,49,0.0,0.007352190340038803,1,64,63,2,-1,3,5,0,37,98,21
640,0,102,1,86,85,0,4,1,29,28,0,4,1,32,31,0.0,0.004050512270669526,1,50,49,4,-1,5,2,0,97,76,38
641,67,267,72,98,26,46,46,82,82,0,46,46,83,83,0,0.012866333095067906,0.015283025290173252,79,80,1,3,2,2,2,8,98,57,22
642,0,0,1,1,0,0,0,1,1,0,0,0,1,1,0,0.0,0.0,1,1,0,-1,-1,-1,10,0,11,91,66
643,40,246,51,93,42,150,150,68,68,0,40,47,51,54,3,0.002825147213996392,0.0033016780693692774,48,50,2,3,2,2,11,1,19,53,56
644,124,740,80,100,20,160,160,93,93,0,124,160,82,93,11,0.013955546478777357,0.03141699853636951,75,90,15,2,2,2,7,6,62,77,37
645,314,914,94,100,6,230,230,95,95,0,230,230,95,95,0,0.025358249089485686,0.04397699036726914,86,96,10,2,2,2,9,19,31,15,9
646,128,744,77,100,23,188,198,80,82,2,128,172,77,86,9,0.007284114503556962,0.01334286395044079,59,75,16,2,2,2,10,6,0,28,62
647,79,695,66,100,34,78,78,73,73,0,78,78,73,73,0,0.007794683277170768,0.023418087749753225,64,86,22,2,2,2,4,6,79,28,15
648,0,0,1,1,0,0,0,1,1,0,0,0,1,1,0,0.0,0.0,1,1,0,-1,-1,-1,7,0,46,84,86
649,60,676,68,100,32,32,32,71,71,0,32,32,71,71,0,0.00888389666088022,0.017529527894074,67,80,13,2,3,3,2,6,99,26,44
650,49,255,54,94,40,62,62,46,46,0,49,61,54,58,4,0.003914360597705844,0.006637394056979475,50,60,10,3,3,3,7,4,62,22,29
651,54,260,59,96,37,38,38,53,53,0,38,38,55,55,0,0.006875659484665918,0.018278362095374246,62,84,22,3,3,3,3,7,64,62,30
652,0,102,1,74,73,0,11,1,27,26,0,2,1,25,24,0.0,0.0002382654276864427,1,32,31,4,-1,5,8,0,10,59,88
653,176,176,87,87,0,182,182,88,88,0,176,176,91,91,0,0.01507879778072773,0.01507879778072773,75,75,0,-1,2,2,9,9,29,27,81
654,32,238,48,93,45,56,56,45,45,0,32,39,48,50,2,0.0030974505599237552,0.003437829742332959,48,48,0,3,3,3,6,2,48,75,63
655,39,245,54,93,39,38,38,51,51,0,38,38,54,54,0,0.004493005207801491,0.005377991082065421,55,57,2,3,3,3,3,4,82,22,42
656,100,100,79,79,0,100,100,96,96,0,100,100,96,96,0,0.058613295210864905,0.058647333129105826,99,99,0,5,1,1,3,7,85,62,60
657,182,1822,89,100,11,126,150,80,89,9,126,150,83,90,7,0.019367575479083698,0.046359644644133564,80,98,18,1,2,2,7,18,62,30,5
658,78,1718,63,100,37,56,90,49,69,20,56,90,58,71,13,0.010619830491167161,0.029544913033118896,69,91,22,1,3,2,6,8,69,8,64
659,22,124,49,88,39,22,22,49,49,0,22,22,53,53,0,0.0020763130126961434,0.002825147213996392,45,49,4,4,3,3,2,2,90,52,71
660,100,100,59,59,0,100,100,39,39,0,100,100,59,59,0,0.029817216379046257,0.029817216379046257,90,90,0,-1,1,1,14,16,16,12,84
661,322,528,96,99,3,216,216,96,96,0,216,216,96,96,0,0.0313829606181286,0.032063718982947,91,91,0,3,2,2,9,22,29,9,74
662,0,616,1,100,99,0,48,1,37,36,0,30,1,44,43,0.0,0.006297014874570271,1,55,54,2,-1,3,7,0,46,36,62
663,40,246,45,94,49,174,174,67,67,0,40,52,45,48,3,0.0048674223084516155,0.0063650907110521125,52,57,5,3,2,2,15,1,7,90,83
664,0,101,1,78,77,0,6,1,25,24,0,1,1,25,24,0.0,0.0,1,1,0,5,-1,6,6,0,32,79,68
665,6,622,29,100,71,31,50,31,36,5,6,23,29,42,13,0.0002042275094455223,0.0021784267674189047,31,43,12,2,4,3,10,1,12,4,61
666,100,100,57,57,0,100,100,38,38,0,100,100,57,57,0,0.019639878825011062,0.019639878825011062,81,81,0,-1,1,1,16,13,4,24,81
667,76,692,63,100,37,34,44,39,43,4,34,44,46,49,3,0.009734844616903231,0.014432077334150244,64,76,12,2,3,3,4,13,67,24,42
668,12,114,37,84,47,12,12,32,32,0,12,12,37,37,0,0.0009870996289866913,0.002382654276864427,38,46,8,4,4,4,2,2,91,74,83
669,16,222,32,90,58,43,74,33,35,2,16,28,32,42,10,0.0002042275094455223,0.0032336022328874367,29,48,19,3,3,3,14,1,17,95,29
670,6,1646,30,100,70,24,80,34,60,26,6,80,30,63,33,0.000442492937131965,0.03771401341093979,36,95,59,1,4,2,6,1,74,49,11
671,170,786,88,100,12,86,86,56,56,0,86,86,66,66,0,0.017121072875182955,0.023179822322066782,82,87,5,2,3,3,6,16,59,12,44
672,2,618,27,100,73,6,28,29,45,16,2,28,27,53,26,0.00010211375472276115,0.015214949453691413,30,80,50,2,5,3,3,1,87,60,12
673,224,840,88,100,12,238,238,82,82,0,224,238,88,89,1,0.023486163586235065,0.028557813404132205,85,90,5,2,2,2,14,20,25,23,34
674,147,763,93,100,7,46,46,83,83,0,46,46,83,83,0,0.02648150039143606,0.043568535348378096,91,97,6,2,2,2,2,15,99,16,9
675,0,206,1,91,90,0,12,1,27,26,0,6,1,26,25,0.0,0.00176997174852786,1,38,37,3,-1,4,4,0,67,79,46
676,80,696,78,100,22,32,32,67,67,0,32,32,68,68,0,0.012662105585622384,0.026821879573845263,75,90,15,2,3,3,2,14,97,14,32
677,6,212,31,92,61,22,26,34,35,1,6,15,31,37,6,0.0004765308553728854,0.0018380475850097008,35,44,9,3,4,4,5,2,37,42,43
678,18,18,40,40,0,86,86,35,35,0,18,18,40,40,0,0.0007147962830593281,0.0007147962830593281,35,35,0,-1,3,3,14,2,16,56,81
679,0,616,1,100,99,0,68,1,42,41,0,68,1,62,61,0.0,0.011334626774226489,1,72,71,2,-1,3,8,0,57,96,33
680,44,660,57,100,43,48,48,60,60,0,48,48,63,63,0,0.0068075836481840775,0.011300588855985567,61,68,7,2,3,3,3,7,58,62,94
681,176,278,88,94,6,176,176,87,87,0,176,176,89,89,0,0.01681473161101467,0.017052997038701112,81,81,0,4,2,2,8,13,57,33,56
682,0,206,1,93,92,0,18,1,34,33,0,18,1,45,44,0.0,0.00789679703189353,1,63,62,3,-1,4,3,0,58,93,33
683,0,616,1,100,99,0,28,1,43,42,0,28,1,53,52,0.0,0.010994247591817285,1,73,72,2,-1,3,3,0,76,89,8
684,16,118,36,79,43,88,88,42,42,0,16,16,36,36,0,0.0012253650566731338,0.0013274788113958951,38,38,0,4,3,3,11,1,38,71,60
685,16,632,40,100,60,28,36,38,40,2,16,36,40,50,10,0.0007828721195411688,0.008713707069675619,37,67,30,2,3,3,5,1,88,4,17
686,7,213,37,95,58,8,8,32,32,0,7,8,37,37,0,0.00034037918240920387,0.0030634126416828346,33,49,16,3,4,4,2,2,95,56,73
687,223,823,97,100,3,56,56,88,88,0,56,56,88,88,0,0.038428809693999116,0.05367779706593145,96,98,2,2,2,2,2,29,93,1,5
688,100,100,78,78,0,100,100,88,88,0,100,100,88,88,0,0.04738078219136117,0.07842336362708056,96,100,4,1,1,1,4,8,78,44,57
689,0,102,1,75,74,0,13,1,26,25,0,2,1,24,23,0.0,0.00017018959120460194,1,28,27,4,-1,5,10,0,36,81,4
690,0,206,1,90,89,0,26,1,34,33,0,20,1,44,43,0.0,0.00527587732734266,1,57,56,3,-1,4,5,0,80,82,25
691,130,330,85,100,15,72,72,85,85,0,72,72,85,85,0,0.021035433472888797,0.027672827529868275,84,91,7,3,2,2,3,12,94,37,17
692,68,274,65,98,33,56,56,80,80,0,56,56,81,81,0,0.011198475101262807,0.017325300384628477,72,82,10,3,2,2,2,4,91,72,34
693,136,342,82,98,16,186,186,70,70,0,136,144,82,85,3,0.01330882603219987,0.013717281051090916,75,75,0,3,2,2,12,8,14,20,63
694,0,206,1,94,93,0,8,1,32,31,0,8,1,37,36,0.0,0.00442492937131965,1,53,52,3,-1,4,2,0,90,99,38
695,2,2,25,25,0,6,6,25,25,0,2,2,25,25,0,0.0,0.0,1,1,0,-1,5,5,5,2,50,58,87
696,0,616,1,100,99,0,22,1,51,50,0,22,1,53,52,0.0,0.015146873617209572,1,79,78,2,-1,3,2,0,98,96,39
697,0,616,1,99,98,0,112,1,59,58,0,112,1,74,73,0.0,0.016508390346846386,1,78,77,2,-1,3,12,0,6,67,23
698,6,6,30,30,0,8,8,31,31,0,6,6,30,30,0,0.00013615167296368154,0.00013615167296368154,29,29,0,-1,4,4,2,1,91,88,98
699,0,101,1,75,74,0,6,1,25,24,0,1,1,25,24,0.0,3.4037918240920386e-05,1,27,26,5,-1,6,6,0,34,59,78
700,6,6,31,31,0,15,15,31,31,0,6,6,31,31,0,6.807583648184077e-05,6.807583648184077e-05,29,29,0,-1,4,4,6,1,32,65,76
701,0,616,1,100,99,0,40,1,38,37,0,40,1,52,51,0.0,0.009530617107457708,1,69,68,2,-1,3,5,0,63,81,27
702,2,2,28,28,0,5,5,29,29,0,2,2,28,28,0,6.807583648184077e-05,6.807583648184077e-05,29,29,0,-1,5,5,3,1,55,65,69
703,62,1702,66,100,34,38,72,51,84,33,38,72,54,84,30,0.008713707069675619,0.05047823275128493,65,97,32,1,3,2,3,9,94,31,34
704,168,269,86,93,7,110,110,86,86,0,110,110,86,86,0,0.0195377650702883,0.0195377650702883,80,80,0,6,2,2,6,18,69,30,78
705,57,57,65,65,0,28,28,45,45,0,28,28,49,49,0,0.007488342013002485,0.007488342013002485,63,63,0,-1,3,3,3,8,60,44,82
706,57,159,60,91,31,52,52,75,75,0,52,52,76,76,0,0.010109261717553355,0.010619830491167161,70,72,2,4,2,2,3,6,87,35,74
707,64,680,61,100,39,54,54,53,53,0,64,54,64,57,-7,0.00707988699411144,0.022328874366043774,62,85,23,2,3,3,4,4,79,72,15
708,0,0,1,1,0,0,0,1,1,0,0,0,1,1,0,0.0,0.0,1,1,0,-1,-1,-1,4,0,53,86,97
709,2,2,28,28,0,10,10,29,29,0,2,2,28,28,0,0.0002382654276864427,0.0002382654276864427,32,32,0,-1,5,5,6,1,32,55,81
710,0,616,1,100,99,0,64,1,45,44,0,52,1,55,54,0.0,0.008713707069675619,1,65,64,2,-1,3,8,0,21,79,77
711,2,1642,27,100,73,23,188,29,72,43,2,188,27,85,58,0.0002042275094455223,0.03179141563701964,29,92,63,1,5,2,14,1,17,55,11
712,6,622,31,100,69,19,68,31,42,11,6,68,31,62,31,0.0002382654276864427,0.011300588855985567,33,72,39,2,4,3,8,1,57,60,33
713,2,618,26,100,74,11,80,26,40,14,2,80,26,56,30,3.4037918240920386e-05,0.010994247591817285,27,70,43,2,5,3,10,1,18,78,14
714,0,0,1,1,0,0,0,1,1,0,0,0,1,1,0,0.0,0.0,1,1,0,-1,-1,-1,6,0,48,76,97
715,184,184,95,95,0,96,96,94,94,0,96,96,94,94,0,0.028932230504782327,0.028932230504782327,92,92,0,-1,2,2,3,16,94,18,67
716,6,6,29,29,0,42,42,31,31,0,6,6,29,29,0,0.00013615167296368154,0.00013615167296368154,30,30,0,-1,4,4,14,1,16,60,91
717,16,222,40,92,52,46,46,46,46,0,16,46,40,51,11,0.0035059055788147996,0.007182000748834201,49,59,10,3,3,3,5,1,88,90,13
718,2,2,26,26,0,6,6,26,26,0,2,2,26,26,0,3.4037918240920386e-05,3.4037918240920386e-05,26,26,0,-1,5,5,5,1,61,68,89
719,108,108,79,79,0,76,76,60,60,0,76,76,65,65,0,0.013410939786922631,0.013410939786922631,73,73,0,-1,3,3,6,13,69,33,67
720,0,206,1,90,89,0,20,1,33,32,0,20,1,45,44,0.0,0.00789679703189353,1,65,64,3,-1,4,4,0,79,98,27
721,34,234,56,96,40,22,22,49,49,0,22,22,53,53,0,0.006535280302256714,0.014295925661186561,63,79,16,3,3,3,2,7,90,62,19
722,16,632,36,100,64,88,88,47,47,0,16,38,36,48,12,0.003948398515946765,0.007862759113652609,51,66,15,2,3,3,8,1,39,90,29
723,52,668,55,100,45,88,112,47,69,22,52,112,55,77,22,0.003165526396405596,0.018754892950747133,50,79,29,2,2,2,8,3,10,43,32
724,410,410,99,99,0,254,254,100,100,0,254,254,100,100,0,0.03744171006501242,0.03744171006501242,95,95,0,-1,2,2,9,29,23,0,69
725,0,206,1,95,94,0,12,1,36,35,0,12,1,40,39,0.0,0.025358249089485686,1,87,86,3,-1,4,2,0,89,96,2
726,16,632,35,100,65,110,120,61,64,3,16,50,35,52,17,0.003710133088260322,0.009258313761530345,51,69,18,2,3,3,10,1,1,90,38
727,0,102,1,83,82,0,3,1,27,26,0,3,1,32,31,0.0,0.0009530617107457708,1,38,37,4,-1,5,2,1,89,45,51
728,53,1693,54,100,46,70,94,56,69,13,70,94,63,71,8,0.005037611899656217,0.05548180673270023,53,98,45,1,3,2,5,6,37,35,2
729,0,616,1,100,99,0,31,1,36,35,0,18,1,42,41,0.0,0.00353994349705572,1,48,47,2,-1,3,7,0,62,96,75
730,88,190,73,92,19,48,48,64,64,0,48,48,66,66,0,0.012287688484972258,0.013955546478777357,73,76,3,4,3,3,3,8,85,17,70
731,70,172,59,89,30,104,104,81,81,0,70,104,60,83,23,0.005786446100956465,0.005854521937438306,56,56,0,4,2,2,5,6,61,28,60
732,90,90,68,68,0,104,104,86,86,0,104,104,87,87,0,0.011743081793117532,0.011743081793117532,70,70,0,-1,2,2,5,6,49,77,76
733,64,680,59,100,41,80,80,65,65,0,64,80,61,68,7,0.007420266176520644,0.02484768031587188,63,87,24,2,3,3,5,4,37,38,23
734,34,1674,43,100,57,124,188,58,69,11,34,188,43,90,47,0.0011913271384322134,0.034990979951666154,39,93,54,1,3,2,14,4,8,64,11
735,104,720,76,100,24,110,110,79,79,0,104,110,79,80,1,0.008407365805507334,0.012832295176826986,66,74,8,2,2,2,6,5,34,47,73
736,0,0,1,1,0,0,0,1,1,0,0,0,1,1,0,0.0,0.0,1,1,0,-1,-1,-1,11,0,5,81,69
737,0,616,1,100,99,0,52,1,38,37,0,52,1,54,53,0.0,0.007386228258279724,1,62,61,2,-1,3,7,0,43,79,27
738,0,616,1,100,99,0,30,1,41,40,0,23,1,49,48,0.0,0.002927260968719153,1,48,47,2,-1,3,4,0,83,99,54
739,134,340,87,96,9,86,86,62,62,0,86,86,68,68,0,0.016236087000919025,0.022839443139657578,80,86,6,3,3,3,6,18,32,30,8
740,50,152,58,89,31,38,38,56,56,0,38,38,57,57,0,0.006705469893461316,0.007250076585316042,59,61,2,4,3,3,3,6,60,26,63
741,222,222,92,92,0,172,172,86,86,0,172,172,90,90,0,0.02209060893835733,0.02209060893835733,84,84,0,-1,2,2,9,17,29,6,59
742,295,911,98,100,2,88,88,71,71,0,88,88,71,71,0,0.03284659110248817,0.04455563497736478,95,96,1,2,2,2,4,29,53,11,12
743,56,672,52,100,48,80,90,61,66,5,56,90,52,68,16,0.005650294427992784,0.017495489975833077,54,80,26,2,2,2,6,3,56,29,5
744,0,0,1,1,0,0,0,1,1,0,0,0,1,1,0,0.0,0.0,1,1,0,-1,-1,-1,4,0,67,93,99
745,375,991,98,100,2,104,104,82,82,0,104,104,82,82,0,0.0425814357193914,0.04615541713468804,94,96,2,2,2,2,5,40,80,3,94
746,34,136,53,86,33,54,54,55,55,0,34,54,53,59,6,0.007488342013002485,0.009734844616903231,62,66,4,4,3,3,4,7,84,62,73
747,0,1640,1,100,99,0,120,1,62,61,0,93,1,61,60,0.0,0.019061234214915415,1,81,80,1,-1,2,11,0,38,80,39
748,150,356,83,96,13,80,80,53,53,0,80,80,60,60,0,0.00980292045338507,0.011947309302563056,68,74,6,3,3,3,5,13,52,24,46
749,63,679,57,100,43,132,142,70,70,0,63,142,57,81,24,0.005548180673270023,0.012696143503863304,57,73,16,2,2,2,8,4,15,22,77
750,430,430,99,99,0,232,232,100,100,0,232,232,100,100,0,0.039313795568263046,0.039313795568263046,95,95,0,-1,2,2,7,27,24,10,82
751,76,76,63,63,0,70,70,63,63,0,70,70,66,66,0,0.006399128629293032,0.006399128629293032,61,61,0,-1,3,3,5,6,49,13,36
752,1,617,26,100,74,6,56,26,45,19,1,56,26,57,31,3.4037918240920386e-05,0.019776030497974745,26,82,56,2,6,3,6,2,74,58,23
753,92,92,62,62,0,80,80,53,53,0,80,80,60,60,0,0.00891793457912114,0.00891793457912114,64,64,0,-1,3,3,5,7,52,48,50
754,101,307,71,94,23,126,126,69,69,0,101,126,71,77,6,0.008713707069675619,0.009939072126348753,63,69,6,3,2,2,7,8,24,57,61
755,0,1640,1,100,99,0,108,1,62,61,0,108,1,80,79,0.0,0.027094182919772627,1,87,86,1,-1,2,9,0,31,99,23
756,6,6,28,28,0,26,26,33,33,0,6,6,28,28,0,0.0006467204465774873,0.0006467204465774873,35,35,0,-1,4,4,5,1,50,49,69
757,200,816,89,100,11,254,254,90,90,0,200,254,89,92,3,0.01606589740971442,0.020626978453997753,76,82,6,2,2,2,12,13,14,33,26
758,560,662,100,100,0,272,272,100,100,0,272,272,100,100,0,0.0489124885122026,0.049218829776370876,97,97,0,4,2,2,8,40,30,3,55
759,2,104,26,80,54,10,11,26,27,1,2,4,26,27,1,3.4037918240920386e-05,0.00010211375472276115,26,28,2,4,5,5,9,1,31,78,95
760,0,0,1,1,0,0,0,1,1,0,0,0,1,1,0,0.0,0.0,1,1,0,-1,-1,-1,5,1,88,69,76
761,24,230,51,94,43,34,34,44,44,0,24,30,51,54,3,0.0030634126416828346,0.003812246842983083,50,52,2,3,3,3,4,6,72,70,49
762,8,624,35,100,65,26,50,37,49,12,8,50,35,54,19,0.0010892133837094523,0.02501786990707648,39,85,46,2,4,3,5,2,70,74,10
763,331,433,99,100,1,96,96,93,93,0,96,96,93,93,0,0.04571292419755608,0.046529834235338165,96,96,0,4,2,2,3,40,66,3,74
764,100,100,69,69,0,100,100,69,69,0,100,100,71,71,0,0.042989890738282445,0.057013513053541645,96,97,1,2,1,1,6,9,34,39,18
765,32,648,43,100,57,136,136,64,64,0,32,48,43,51,8,0.005105687736138058,0.0088498587426393,54,66,12,2,3,3,11,3,33,29,90
766,223,1823,91,100,9,176,176,85,85,0,176,176,89,89,0,0.025085945743558324,0.04516831750570135,87,97,10,1,2,2,8,20,42,23,19
767,0,0,1,1,0,0,0,1,1,0,0,0,1,1,0,0.0,0.0,1,1,0,-1,-1,-1,8,0,30,98,99
768,92,194,68,89,21,80,80,68,68,0,80,80,69,69,0,0.014806494434800367,0.01494264610776405,76,76,0,4,3,3,5,12,80,37,4
769,112,318,78,95,17,166,166,88,88,0,112,166,78,90,12,0.011300588855985567,0.015589366554341537,71,77,6,3,2,2,8,4,21,38,13
770,2,208,29,94,65,3,8,29,32,3,2,8,29,37,8,3.4037918240920386e-05,0.0016338200755641784,27,42,15,3,5,4,2,1,90,95,53
771,0,616,1,100,99,0,32,1,34,33,0,25,1,45,44,0.0,0.004220701861874128,1,50,49,2,-1,3,5,0,50,85,22
772,0,206,1,93,92,0,42,1,35,34,0,24,1,44,43,0.0,0.004629156880765172,1,53,52,3,-1,4,9,0,23,89,72
773,110,710,79,100,21,88,88,76,76,0,88,88,79,79,0,0.010619830491167161,0.020933319718166036,71,86,15,2,2,2,4,7,47,21,8
774,16,16,42,42,0,22,22,42,42,0,16,16,42,42,0,0.00353994349705572,0.00353994349705572,52,52,0,-1,3,3,2,1,68,90,36
775,16,117,36,78,42,40,40,42,42,0,16,17,36,42,6,0.002110350930937064,0.002144388849177984,46,47,1,5,3,3,5,1,61,53,58
776,56,672,53,100,47,132,142,73,75,2,56,142,53,83,30,0.00527587732734266,0.02314578440382586,55,86,31,2,2,2,8,3,30,29,9
777,46,148,57,90,33,62,62,80,80,0,46,62,71,80,9,0.008373327887266415,0.01058579257292624,64,69,5,4,2,2,3,3,94,29,22
778,16,632,42,100,58,22,22,42,42,0,16,22,42,45,3,0.002484768031587188,0.008951972497362062,49,65,16,2,3,3,2,3,68,46,26
779,40,656,48,100,52,116,116,74,74,0,40,82,48,58,10,0.0032336022328874367,0.008066986623098132,48,61,13,2,2,2,7,1,46,53,13
780,22,22,45,45,0,40,40,43,43,0,22,22,45,45,0,0.0030293747234419145,0.0030293747234419145,49,49,0,-1,3,3,5,2,49,83,97
781,84,84,58,58,0,206,206,75,75,0,84,84,58,58,0,0.009939072126348753,0.009939072126348753,67,67,0,-1,2,2,12,5,14,25,98
782,297,503,99,100,1,72,72,84,84,0,72,72,84,84,0,0.044623710813846626,0.046904251335988294,96,96,0,3,2,2,3,40,85,3,29
783,150,150,80,80,0,278,278,86,86,0,150,150,80,80,0,0.00966676878042139,0.00966676878042139,63,63,0,-1,2,2,15,7,7,48,96
784,506,2106,98,100,2,440,440,100,100,0,440,440,100,100,0,0.037679975492698865,0.06167670785254774,96,100,4,1,2,2,14,22,16,9,0
785,0,616,1,100,99,0,132,1,61,60,0,122,1,77,76,0.0,0.014602266925354846,1,75,74,2,-1,3,16,0,9,59,16
786,6,6,30,30,0,24,24,34,34,0,6,6,30,30,0,0.0008169100377820892,0.0008169100377820892,36,36,0,-1,4,4,6,2,34,42,86
787,91,1731,63,100,37,144,168,65,75,10,91,140,63,80,17,0.007318152421797883,0.01960584090677014,61,82,21,1,2,2,10,6,18,35,41
788,6,6,28,28,0,44,44,33,33,0,6,6,28,28,0,0.00017018959120460194,0.00017018959120460194,30,30,0,-1,4,4,16,1,9,4,40
789,8,8,38,38,0,12,12,34,34,0,8,8,38,38,0,0.0002042275094455223,0.0002042275094455223,32,32,0,-1,4,4,4,2,72,56,93
790,0,102,1,77,76,0,15,1,28,27,0,4,1,30,29,0.0,0.0004084550188910446,1,34,33,4,-1,5,8,0,57,84,51
791,100,100,58,58,0,100,100,38,38,0,100,100,58,58,0,0.05905578814799687,0.05939616733040607,100,100,0,3,1,1,16,36,9,2,71
792,6,212,29,93,64,26,30,30,32,2,6,14,29,35,6,0.0002382654276864427,0.0005446066918547262,32,35,3,3,4,4,9,1,23,4,63
793,0,206,1,93,92,0,9,1,31,30,0,8,1,34,33,0.0,0.0012594029749140542,1,40,39,3,-1,4,3,0,55,59,43
794,18,224,44,92,48,46,46,40,40,0,18,46,44,56,12,0.0005786446100956465,0.007011811157629599,35,61,26,3,3,3,6,2,44,56,32
795,0,206,1,96,95,0,14,1,32,31,0,14,1,40,39,0.0,0.005990673610401988,1,57,56,3,-1,4,3,0,75,87,24
796,0,206,1,92,91,0,18,1,35,34,0,18,1,44,43,0.0,0.014840532353041287,1,79,78,3,-1,4,3,0,82,85,15
797,62,62,75,75,0,32,32,67,67,0,32,32,68,68,0,0.010619830491167161,0.010619830491167161,72,72,0,-1,3,3,2,6,97,77,45
798,16,117,39,82,43,24,24,39,39,0,16,17,39,44,5,0.0007828721195411688,0.0007828721195411688,37,37,0,5,3,3,3,1,82,88,68
799,54,156,58,89,31,86,86,62,62,0,54,56,58,59,1,0.006569318220497634,0.006569318220497634,59,59,0,4,3,3,6,4,32,38,4
800,478,1094,100,100,0,304,304,100,100,0,304,304,100,100,0,0.03492290411518432,0.04006262976956329,91,95,4,2,2,2,10,27,0,10,31
801,32,648,46,100,54,46,66,37,43,6,32,66,46,55,9,0.0028932230504782326,0.010517716736444398,46,70,24,2,3,3,6,2,40,75,25
802,0,206,1,96,95,0,12,1,38,37,0,12,1,44,43,0.0,0.020763130126961436,1,86,85,3,-1,4,2,0,93,82,11
803,24,24,48,48,0,42,42,41,41,0,24,24,48,48,0,0.0012253650566731338,0.0012253650566731338,41,41,0,-1,3,3,6,4,32,64,96
804,16,16,39,39,0,28,28,40,40,0,16,16,39,39,0,0.0014636304843595766,0.0014636304843595766,41,41,0,-1,3,3,3,1,82,71,67
805,0,101,1,76,75,0,6,1,25,24,0,1,1,25,24,0.0,3.4037918240920386e-05,1,25,24,6,-1,7,6,0,71,79,78
806,94,94,67,67,0,158,158,83,83,0,94,94,68,68,0,0.012117498893767658,0.012117498893767658,71,71,0,-1,2,2,9,5,26,25,40
807,236,337,92,95,3,174,174,93,93,0,174,174,94,94,0,0.017155110793423873,0.017121072875182955,80,80,0,5,2,2,7,14,24,32,78
808,0,1640,1,100,99,0,108,1,60,59,0,108,1,73,72,0.0,0.031314884781646755,1,93,92,1,-1,2,9,0,28,91,11
809,100,100,62,62,0,100,100,48,48,0,100,100,62,62,0,0.03230198441063344,0.032370060247115286,89,89,0,5,1,1,10,15,11,19,78
810,44,660,51,100,49,74,84,42,47,5,44,54,51,55,4,0.0036760951700194017,0.006058749446883829,51,59,8,2,3,3,9,6,31,73,71
811,100,100,58,58,0,100,100,38,38,0,100,100,58,58,0,0.01940161339732462,0.029749140542564417,84,91,7,2,1,1,16,7,9,21,39
812,38,244,49,95,46,84,84,47,47,0,38,53,49,54,5,0.0029612988869600733,0.005650294427992784,49,54,5,3,3,3,9,6,35,70,22
813,0,0,1,1,0,0,0,1,1,0,0,0,1,1,0,0.0,0.0,1,1,0,-1,-1,-1,6,0,69,84,89
814,0,1640,1,100,99,0,52,1,74,73,0,52,1,76,75,0.0,0.04414717995847374,1,96,95,1,-1,2,3,0,82,81,30
815,128,128,81,81,0,150,150,85,85,0,128,128,86,86,0,0.00796487286837537,0.00796487286837537,61,61,0,-1,2,2,7,5,46,47,69
816,0,0,1,1,0,0,0,1,1,0,0,0,1,1,0,0.0,0.0,1,1,0,-1,-1,-1,12,0,2,93,76
817,126,326,78,96,18,168,168,85,85,0,126,132,79,81,2,0.015283025290173252,0.016168011164437182,76,77,1,3,2,2,9,8,29,20,61
818,78,78,62,62,0,76,76,54,54,0,76,76,61,61,0,0.00789679703189353,0.00789679703189353,62,62,0,-1,3,3,6,7,44,48,93
819,83,289,71,98,27,64,64,68,68,0,64,64,70,70,0,0.01507879778072773,0.017801831240001363,79,80,1,3,3,3,4,9,78,39,28
820,100,100,58,58,0,100,100,35,35,0,100,100,59,59,0,0.03192756730998332,0.04098165356206814,91,96,5,1,1,1,17,16,20,18,35
821,164,164,86,86,0,110,110,82,82,0,110,110,83,83,0,0.020558902617515914,0.020558902617515914,85,85,0,-1,2,2,6,16,56,18,69
822,359,359,97,97,0,136,136,98,98,0,136,136,98,98,0,0.03720344463732598,0.03720344463732598,93,93,0,-1,2,2,4,30,79,7,91
823,118,734,78,100,22,198,198,85,85,0,118,198,78,87,9,0.012934408931549747,0.02042275094455223,72,84,12,2,2,2,10,5,22,25,17
824,0,206,1,91,90,0,60,1,31,30,0,12,1,31,30,0.0,0.0017359338302869397,1,41,40,3,-1,4,16,0,4,93,52
825,22,228,48,91,43,36,40,38,41,3,22,40,48,52,4,0.0013274788113958951,0.004016474352428605,40,53,13,3,3,3,5,3,61,51,41
826,12,218,37,92,55,22,26,34,34,0,12,26,37,46,9,0.0006807583648184077,0.006399128629293032,36,56,20,3,4,4,5,2,88,56,62
827,2,618,29,100,71,7,44,29,47,18,2,44,29,57,28,0.00013615167296368154,0.012185574730249497,32,76,44,2,5,3,4,1,47,65,33
828,8,624,37,100,63,20,44,34,48,14,8,44,37,54,17,0.0023486163586235067,0.02927260968719153,46,89,43,2,4,3,4,2,79,83,3
829,168,768,89,100,11,88,88,81,81,0,88,88,81,81,0,0.024439225296980838,0.04013070560604513,86,95,9,2,2,2,4,18,73,30,18
830,0,0,1,1,0,0,0,1,1,0,0,0,1,1,0,0.0,0.0,1,1,0,-1,-1,-1,17,0,20,89,76
831,6,622,32,100,68,34,72,33,44,11,6,72,32,55,23,0.0007828721195411688,0.022124646856598252,37,88,51,2,4,3,7,1,46,71,1
832,22,22,41,41,0,42,42,36,36,0,22,22,41,41,0,0.0015317063208414173,0.0015317063208414173,38,38,0,-1,3,3,6,3,56,51,87
833,0,0,1,1,0,0,0,1,1,0,0,0,1,1,0,0.0,0.0,1,1,0,-1,-1,-1,11,0,33,81,40
834,6,622,32,100,68,14,28,34,44,10,6,28,32,48,16,0.0007488342013002485,0.020729092208720514,36,85,49,2,4,3,3,2,60,42,9
835,32,648,45,100,55,74,74,41,41,0,32,78,45,61,16,0.002757071377514551,0.008407365805507334,48,67,19,2,3,3,9,2,54,83,21
836,28,644,46,100,54,90,130,44,62,18,28,130,46,80,34,0.0015657442390823377,0.022294836447802852,42,84,42,2,3,3,10,4,18,64,10
837,0,1640,1,100,99,0,126,1,60,59,0,114,1,81,80,0.0,0.016202049082678104,1,78,77,1,-1,2,13,0,13,80,31
838,0,102,1,69,68,0,13,1,27,26,0,2,1,25,24,0.0,0.00013615167296368154,1,31,30,4,-1,5,10,0,0,96,55
839,6,212,29,93,64,14,14,32,32,0,6,14,29,38,9,0.000442492937131965,0.00353994349705572,34,51,17,3,4,4,3,1,82,49,22
840,100,100,66,66,0,100,100,66,66,0,100,100,69,69,0,0.05742196807243269,0.07083290785935532,99,100,1,2,1,1,7,27,62,10,6
841,0,616,1,100,99,0,22,1,46,45,0,22,1,51,50,0.0,0.011402702610708328,1,71,70,2,-1,3,2,0,89,81,17
842,8,110,38,86,48,8,8,33,33,0,8,8,38,38,0,0.002314578440382586,0.0026209197045508697,44,46,2,4,4,4,2,2,99,75,63
843,0,206,1,90,89,0,52,1,34,33,0,26,1,45,44,0.0,0.00445896728956057,1,55,54,3,-1,4,10,0,1,86,26
844,0,616,1,99,98,0,102,1,55,54,0,102,1,75,74,0.0,0.014398039415909322,1,76,75,2,-1,3,12,0,14,86,18
845,0,616,1,100,99,0,38,1,54,53,0,38,1,57,56,0.0,0.03315293236665646,1,90,89,2,-1,3,3,0,76,96,2
846,241,447,96,100,4,72,72,85,85,0,72,72,85,85,0,0.0392457197317812,0.049593246877021,94,97,3,3,2,2,3,29,60,11,12
847,0,206,1,91,90,0,20,1,29,28,0,20,1,40,39,0.0,0.003437829742332959,1,46,45,3,-1,4,4,0,67,84,28
848,0,0,1,1,0,0,0,1,1,0,0,0,1,1,0,0.0,0.0,1,1,0,-1,-1,-1,10,0,36,87,89
849,40,40,56,56,0,56,56,80,80,0,40,40,79,79,0,0.006467204465774873,0.006467204465774873,57,57,0,-1,2,2,2,1,91,53,81
850,258,874,94,100,6,176,176,85,85,0,176,176,89,89,0,0.019810068416215663,0.02464345280642636,84,86,2,2,2,2,8,16,42,12,38
851,0,206,1,93,92,0,30,1,40,39,0,20,1,44,43,0.0,0.005173763572619898,1,53,52,3,-1,4,5,0,45,66,72
852,15,15,44,44,0,18,18,38,38,0,18,18,47,47,0,0.003880322679464924,0.003880322679464924,52,52,0,-1,4,4,3,6,85,73,96
853,0,206,1,88,87,0,32,1,33,32,0,23,1,45,44,0.0,0.002995336805200994,1,48,47,3,-1,4,8,0,15,91,35
854,0,206,1,89,88,0,14,1,31,30,0,8,1,35,34,0.0,0.0011232513019503727,1,39,38,3,-1,4,5,0,61,87,52
855,174,790,87,100,13,224,224,87,87,0,174,224,87,93,6,0.019878144252697506,0.0352292453793526,80,92,12,2,2,2,11,12,19,37,16
856,0,616,1,100,99,0,32,1,40,39,0,29,1,48,47,0.0,0.005207801490860819,1,52,51,2,-1,3,5,0,45,91,22
857,88,294,60,96,36,164,164,76,76,0,88,95,60,61,1,0.008101024541339052,0.008509479560230097,63,63,0,3,2,2,10,4,11,38,56
858,0,616,1,100,99,0,32,1,37,36,0,32,1,51,50,0.0,0.009190237925048503,1,66,65,2,-1,3,5,0,61,86,14
859,0,616,1,100,99,0,56,1,45,44,0,56,1,57,56,0.0,0.015487252799618776,1,79,78,2,-1,3,6,1,74,69,37
860,100,100,66,66,0,100,100,66,66,0,100,100,69,69,0,0.021818305592429966,0.021818305592429966,83,83,0,-1,1,1,7,2,62,74,85
861,2,2,27,27,0,22,22,29,29,0,2,2,27,27,0,0.00013615167296368154,0.00013615167296368154,30,30,0,-1,5,5,11,1,19,60,87
862,24,124,47,87,40,38,38,46,46,0,24,38,48,50,2,0.002757071377514551,0.003437829742332959,48,49,1,4,3,3,3,3,96,54,51
863,111,727,79,100,21,120,120,80,80,0,120,120,81,81,0,0.010415602981721638,0.01678069369277375,70,79,9,2,2,2,6,8,34,44,48
864,0,616,1,99,98,0,98,1,42,41,0,98,1,64,63,0.0,0.010245413390517035,1,70,69,2,-1,3,11,0,33,40,14
865,0,616,1,100,99,0,28,1,43,42,0,28,1,50,49,0.0,0.018788930868988054,1,83,82,2,-1,3,3,0,92,86,9
866,54,670,59,100,41,60,60,51,51,0,54,60,59,61,2,0.006977773239388679,0.016270124919159943,61,79,18,2,3,3,5,4,80,38,20
867,54,155,60,91,31,38,38,51,51,0,38,38,54,54,0,0.007352190340038803,0.007760645358929848,62,62,0,5,3,3,3,4,94,38,42
868,16,632,32,100,68,88,134,37,61,24,16,139,32,84,52,0.0008509479560230097,0.016406276592123625,37,76,39,2,3,3,14,2,8,42,6
869,250,250,96,96,0,96,96,93,93,0,96,96,93,93,0,0.0390755301405766,0.0390755301405766,94,94,0,-1,2,2,3,27,58,10,84
870,92,92,64,64,0,114,114,67,67,0,92,92,64,64,0,0.00789679703189353,0.00789679703189353,63,63,0,-1,3,3,9,7,35,48,99
871,0,616,1,100,99,0,40,1,42,41,0,40,1,51,50,0.0,0.010075223799312433,1,71,70,2,-1,3,5,0,45,99,33
872,0,0,1,1,0,0,0,1,1,0,0,0,1,1,0,0.0,0.0,1,1,0,-1,-1,-1,12,1,3,69,80
873,28,644,49,100,51,72,82,49,55,6,28,82,49,64,15,0.0012253650566731338,0.02219272269308009,40,84,44,2,3,3,7,4,62,64,7
874,0,0,1,1,0,0,0,1,1,0,0,0,1,1,0,0.0,0.0,1,1,0,-1,-1,-1,8,0,15,86,69
875,32,32,46,46,0,114,114,64,64,0,32,32,46,46,0,0.004799346471969774,0.004799346471969774,56,56,0,-1,3,3,9,3,31,29,81
876,66,1706,64,100,36,64,88,60,72,12,64,88,63,73,10,0.008611593314952858,0.03791824092038531,67,93,26,1,3,2,4,6,83,77,25
877,42,658,52,100,48,94,104,51,66,15,40,104,51,76,25,0.003642057251778481,0.016372238673882704,51,78,27,2,3,3,9,6,23,41,37
878,38,654,49,100,51,90,130,45,64,19,38,130,49,83,34,0.0024507301133462676,0.019469689233806462,47,80,33,2,3,3,10,3,22,54,15
879,0,206,1,91,90,0,16,1,31,30,0,10,1,35,34,0.0,0.002484768031587188,1,47,46,3,-1,4,6,0,44,99,73
880,258,258,94,94,0,168,168,93,93,0,168,168,94,94,0,0.026787841655604345,0.026787841655604345,88,88,0,-1,2,2,6,15,44,16,82
881,24,24,46,46,0,52,52,40,40,0,24,24,46,46,0,0.0010211375472276116,0.0010211375472276116,39,39,0,-1,3,3,7,4,24,64,40
882,0,616,1,100,99,0,60,1,38,37,0,43,1,51,50,0.0,0.006092787365124749,1,59,58,2,-1,3,9,0,23,59,31
883,0,1640,1,100,99,0,140,1,62,61,0,111,1,79,78,0.0,0.018176248340651485,1,78,77,1,-1,2,14,0,17,82,37
884,58,159,59,91,32,28,28,48,48,0,28,28,54,54,0,0.007760645358929848,0.007760645358929848,60,60,0,6,3,3,3,7,55,48,68
885,0,0,1,1,0,0,0,1,1,0,0,0,1,1,0,0.0,0.0,1,1,0,-1,-1,-1,8,0,21,96,98
886,0,206,1,93,92,0,22,1,32,31,0,20,1,44,43,0.0,0.004731270635487933,1,51,50,3,-1,4,5,0,45,99,62
887,124,226,80,93,13,160,160,93,93,0,124,160,82,93,11,0.013955546478777357,0.01504475986248681,75,76,1,4,2,2,7,6,62,77,51
888,40,246,59,98,39,22,22,49,49,0,22,22,50,50,0,0.004969536063174376,0.011606930120153852,55,71,16,3,3,3,2,5,93,47,77
889,22,228,40,92,52,52,56,36,37,1,22,38,40,47,7,0.0007488342013002485,0.0028932230504782326,38,45,7,3,3,3,9,2,31,63,41
890,91,297,63,95,32,144,144,65,65,0,91,99,63,63,0,0.007318152421797883,0.007692569522448007,61,61,0,3,2,2,10,6,18,35,63
891,6,212,28,92,64,19,28,31,33,2,6,15,28,35,7,0.0002042275094455223,0.0015317063208414173,29,37,8,3,4,4,6,1,56,65,64
892,49,49,62,62,0,18,18,47,47,0,18,18,49,49,0,0.004969536063174376,0.004969536063174376,54,54,0,-1,3,3,2,4,99,22,93
893,0,0,1,1,0,0,0,1,1,0,0,0,1,1,0,0.0,0.0,1,1,0,-1,-1,-1,12,0,2,66,84
894,158,260,81,92,11,278,278,80,80,0,158,160,81,81,0,0.010347527145239796,0.010517716736444398,60,60,0,4,2,2,16,6,9,34,60
895,22,124,47,84,37,38,38,57,57,0,22,24,48,50,2,0.004561081044283332,0.004629156880765172,55,55,0,4,3,3,3,3,55,29,4
896,212,828,88,100,12,232,232,77,77,0,212,232,88,90,2,0.012525953912658701,0.02491575615235372,71,87,16,2,2,2,14,14,16,32,37
897,100,100,67,67,0,100,100,54,54,0,100,100,67,67,0,0.030463936825623743,0.04782327512849314,90,97,7,2,1,1,9,14,35,32,6
898,100,100,78,78,0,100,100,97,97,0,100,100,97,97,0,0.08642227441369686,0.08642227441369686,99,99,0,-1,1,1,3,27,96,10,87
899,124,1764,78,100,22,284,318,81,90,9,124,318,78,99,21,0.011879233466081215,0.0405731985431771,66,94,28,1,2,2,16,6,9,77,1
900,152,358,83,97,14,222,222,92,92,0,152,158,84,84,0,0.008543517478471017,0.009258313761530345,64,66,2,3,2,2,10,5,0,47,71
901,6,212,31,94,63,18,18,36,36,0,6,18,31,44,13,0.0012253650566731338,0.005173763572619898,40,56,16,3,4,4,3,1,66,71,47
902,66,682,57,100,43,66,76,49,53,4,66,76,57,59,2,0.007250076585316042,0.016406276592123625,60,78,18,2,3,3,6,6,41,34,77
903,324,940,97,100,3,176,176,90,90,0,176,176,91,91,0,0.03315293236665646,0.04094761564382722,92,96,4,2,2,2,8,27,21,10,77
904,0,206,1,90,89,0,36,1,35,34,0,36,1,49,48,0.0,0.007284114503556962,1,63,62,3,-1,4,6,0,48,84,27
905,0,616,1,99,98,0,66,1,36,35,0,33,1,48,47,0.0,0.002757071377514551,1,46,45,2,-1,3,11,0,19,85,70
906,16,632,35,100,65,50,110,34,58,24,16,110,35,75,40,0.00037441710065012424,0.014023622315259198,34,75,41,2,3,3,10,1,18,4,5
907,24,24,44,44,0,66,66,42,42,0,24,24,44,44,0,0.0014295925661186562,0.0014295925661186562,41,41,0,-1,3,3,9,3,35,43,85
908,0,0,1,1,0,0,0,1,1,0,0,0,1,1,0,0.0,0.0,1,1,0,-1,-1,-1,6,1,56,50,84
909,0,0,1,1,0,0,0,1,1,0,0,0,1,1,0,0.0,0.0,1,1,0,-1,-1,-1,4,0,79,97,76
910,37,37,56,56,0,28,28,44,44,0,28,28,54,54,0,0.005582218591510943,0.005582218591510943,61,61,0,-1,3,3,3,6,76,35,69
911,100,100,65,65,0,104,104,81,81,0,104,104,84,84,0,0.00803294870485721,0.00803294870485721,64,64,0,-1,2,2,5,6,61,13,69
912,266,266,94,94,0,110,110,78,78,0,110,110,82,82,0,0.023350011913271386,0.023350011913271386,85,85,0,-1,2,2,6,19,51,15,66
913,44,146,66,93,27,32,32,67,67,0,32,32,68,68,0,0.009224275843289425,0.01245787807617686,68,75,7,4,3,3,2,6,97,34,13
914,94,94,73,73,0,48,48,60,60,0,48,48,63,63,0,0.012185574730249497,0.012185574730249497,71,71,0,-1,3,3,3,8,58,8,59
915,150,150,83,83,0,144,144,88,88,0,144,144,89,89,0,0.014806494434800367,0.014806494434800367,75,75,0,-1,2,2,6,8,34,17,98
916,100,100,69,69,0,100,100,55,55,0,100,100,69,69,0,0.037509785901494265,0.05177167364443991,94,98,4,1,1,1,9,18,26,30,47
917,0,0,1,1,0,0,0,1,1,0,0,0,1,1,0,0.0,0.0,1,1,0,-1,-1,-1,6,1,41,45,89
918,290,392,96,100,4,96,96,87,87,0,96,96,87,87,0,0.03553558664352088,0.03611423125361653,92,93,1,4,2,2,3,29,87,11,49
919,0,616,1,100,99,0,42,1,39,38,0,42,1,52,51,0.0,0.00976888253514415,1,67,66,2,-1,3,6,0,74,93,17
920,122,738,86,100,14,56,56,76,76,0,56,56,77,77,0,0.018006058749446885,0.026243234963749616,84,89,5,2,2,2,2,14,68,14,24
921,0,206,1,92,91,0,24,1,32,31,0,14,1,36,35,0.0,0.001940161339732462,1,44,43,3,-1,4,8,0,21,80,54
922,100,100,72,72,0,100,100,77,77,0,100,100,77,77,0,0.06576125804145819,0.07205827291602845,100,100,0,2,1,1,6,40,69,3,83
923,22,22,44,44,0,46,46,43,43,0,22,22,44,44,0,0.003437829742332959,0.003437829742332959,49,49,0,-1,3,3,6,3,69,29,87
924,100,100,78,78,0,100,100,96,96,0,100,100,96,96,0,0.0691310119473093,0.0691310119473093,99,99,0,-1,1,1,3,9,81,39,85
925,263,469,95,100,5,64,64,70,70,0,64,64,70,70,0,0.030702202253310187,0.03703325504612138,89,93,4,3,3,3,4,29,84,1,77
926,8,110,36,85,49,14,14,35,35,0,8,14,36,42,6,0.0004765308553728854,0.008203138296061813,35,68,33,4,4,4,3,2,92,63,32
927,210,312,97,100,3,22,22,54,54,0,22,22,54,54,0,0.02828551005820484,0.02917049593246877,92,93,1,4,3,3,2,29,99,1,74
928,108,724,84,100,16,32,32,70,70,0,32,32,70,70,0,0.015453214881377854,0.03686306545491678,78,95,17,2,3,3,2,14,95,14,1
929,0,0,1,1,0,0,0,1,1,0,0,0,1,1,0,0.0,0.0,1,1,0,-1,-1,-1,3,0,60,67,59
930,122,122,85,85,0,88,88,81,81,0,88,88,81,81,0,0.01657646618332823,0.01657646618332823,81,81,0,-1,2,2,4,13,73,33,50
931,112,112,79,79,0,182,182,87,87,0,112,112,79,79,0,0.009870996289866912,0.009870996289866912,69,69,0,-1,2,2,9,7,23,62,99
932,362,362,98,98,0,158,158,97,97,0,158,158,97,97,0,0.03897341638585384,0.03897341638585384,96,96,0,-1,2,2,6,29,71,0,86
933,22,638,45,100,55,36,50,41,47,6,22,50,45,56,11,0.0020082371762143027,0.011334626774226489,45,69,24,2,3,3,5,2,49,75,17
934,12,218,37,93,56,20,24,32,35,3,12,28,37,47,10,0.00034037918240920387,0.0053439531638245,33,51,18,3,4,4,6,2,69,56,38
935,0,1640,1,100,99,0,110,1,56,55,0,53,1,51,50,0.0,0.008509479560230097,1,59,58,1,-1,2,16,1,9,50,22
936,144,760,81,100,19,214,224,83,84,1,144,224,81,88,7,0.007556417849484326,0.014772456516559448,59,74,15,2,2,2,11,6,5,13,31
937,50,666,57,100,43,70,80,59,67,8,50,80,57,68,11,0.005446066918547262,0.014568229007113924,58,78,20,2,3,3,5,6,80,26,17
938,56,158,55,86,31,84,84,66,66,0,56,58,55,55,0,0.0068075836481840775,0.006943735321147759,59,60,1,4,2,2,5,3,61,29,65
939,40,656,51,100,49,102,112,61,62,1,40,74,51,59,8,0.0038462847612240037,0.009360427516253106,52,65,13,2,2,2,8,3,15,46,62
940,173,1773,90,100,10,112,112,95,95,0,112,112,95,95,0,0.02644746247319514,0.06542087885904899,89,98,9,1,2,2,4,16,73,18,0
941,36,1676,51,100,49,50,84,45,73,28,35,84,51,74,23,0.0035739814152966403,0.02808128254875932,51,89,38,1,3,2,5,6,45,41,73
942,44,146,54,84,30,50,50,49,49,0,44,46,54,54,0,0.007147962830593281,0.007352190340038803,61,61,0,4,3,3,5,4,61,38,49
943,16,632,33,100,67,66,90,36,44,8,16,72,33,53,20,0.0006126825283365669,0.009054086252084823,36,65,29,2,3,3,10,1,0,49,77
944,0,206,1,93,92,0,12,1,35,34,0,12,1,36,35,0.0,0.011096361346540046,1,73,72,3,-1,4,2,0,68,80,6
945,256,462,94,100,6,104,104,88,88,0,104,104,88,88,0,0.03066816433506927,0.03495694203342523,88,92,4,3,2,2,5,22,88,9,38
946,16,632,34,100,66,78,130,34,61,27,16,100,34,58,24,0.00037441710065012424,0.009734844616903231,34,68,34,2,3,3,14,1,16,88,27
947,0,0,1,1,0,0,0,1,1,0,0,0,1,1,0,0.0,0.0,1,1,0,-1,-1,-1,10,0,11,99,79
948,166,782,87,100,13,104,104,82,82,0,104,104,83,83,0,0.017223186629905716,0.028693965077095884,80,90,10,2,2,2,5,13,50,33,30
949,0,616,1,100,99,0,114,1,63,62,0,114,1,80,79,0.0,0.03087239184451479,1,88,87,2,-1,3,9,1,31,45,3
950,150,766,85,100,15,172,172,87,87,0,150,172,87,88,1,0.015657442390823378,0.026004969536063176,76,90,14,2,2,2,9,8,26,20,14
951,100,100,69,69,0,100,100,55,55,0,100,100,69,69,0,0.04806154055617958,0.05919193982096055,96,99,3,2,1,1,8,27,30,10,39
952,100,100,69,69,0,100,100,76,76,0,100,100,76,76,0,0.055413730896218386,0.05830695394669662,100,100,0,3,1,1,5,20,80,23,29
953,548,1148,100,100,0,288,288,100,100,0,288,288,100,100,0,0.046393682562374486,0.05068246026073046,97,97,0,2,2,2,9,40,31,3,62
954,70,1710,60,100,40,86,110,63,81,18,70,110,63,81,18,0.005990673610401988,0.027162258756254467,56,89,33,1,3,2,6,6,56,26,31
955,0,1640,1,100,99,0,104,1,61,60,0,104,1,72,71,0.0,0.019469689233806462,1,84,83,1,-1,2,9,0,29,86,32
956,161,361,94,100,6,32,32,67,67,0,32,32,68,68,0,0.028728002995336805,0.03553558664352088,90,95,5,3,3,3,2,29,97,1,19
957,6,622,33,100,67,16,34,33,45,12,6,34,33,51,18,0.0004084550188910446,0.016202049082678104,34,80,46,2,4,3,4,1,73,49,30
958,80,80,64,64,0,152,152,84,84,0,80,80,64,64,0,0.010824058000612683,0.010824058000612683,72,72,0,-1,2,2,8,5,57,25,85
959,2,618,26,100,74,6,40,26,39,13,2,32,26,47,21,0.0,0.005956635692161067,1,55,54,2,5,3,5,1,52,78,38
960,1,617,26,100,74,4,34,26,38,12,1,34,26,50,24,3.4037918240920386e-05,0.02032063718982947,27,86,59,2,6,3,4,2,53,58,11
961,0,0,1,1,0,0,0,1,1,0,0,0,1,1,0,0.0,0.0,1,1,0,-1,-1,-1,10,0,22,99,45
962,291,497,99,100,1,96,96,94,94,0,96,96,94,94,0,0.044453521222642026,0.05030804316008033,94,97,3,3,2,2,3,29,92,11,27
963,377,1977,97,100,3,230,230,95,95,0,230,230,95,95,0,0.03553558664352088,0.06279995915449811,91,100,9,1,2,2,9,29,31,11,1
964,124,1764,79,100,21,178,232,80,91,11,124,232,79,93,14,0.01143674052894925,0.05013785356887573,70,98,28,1,2,2,10,6,11,34,3
965,0,616,1,100,99,0,38,1,50,49,0,38,1,53,52,0.0,0.023690391095680587,1,87,86,2,-1,3,3,0,82,40,7
966,206,412,93,100,7,96,96,90,90,0,96,96,90,90,0,0.026889955410327106,0.02920453385070969,89,90,1,3,2,2,3,18,82,5,90
967,0,0,1,1,0,0,0,1,1,0,0,0,1,1,0,0.0,0.0,1,1,0,-1,-1,-1,14,0,17,84,59
968,298,298,95,95,0,300,300,91,91,0,300,300,94,94,0,0.020252561353347628,0.020252561353347628,82,82,0,-1,2,2,14,18,17,5,69
969,216,318,87,93,6,176,176,88,88,0,176,176,88,88,0,0.024064808196330712,0.024507301133462677,85,86,1,4,2,2,8,18,27,30,42
970,0,616,1,100,99,0,46,1,38,37,0,40,1,53,52,0.0,0.006875659484665918,1,60,59,2,-1,3,8,0,57,89,48
971,100,100,62,62,0,100,100,45,45,0,100,100,62,62,0,0.04200279110929576,0.04200279110929576,95,95,0,-1,1,1,12,15,3,16,80
972,0,1640,1,100,99,0,53,1,38,37,0,40,1,52,51,0.0,0.013751318969331836,1,76,75,1,-1,2,8,0,57,93,42
973,22,1662,45,100,55,46,70,40,53,13,22,75,45,60,15,0.002382654276864427,0.021239660982334322,47,84,37,1,3,2,6,2,44,75,22
974,0,616,1,100,99,0,74,1,41,40,0,59,1,55,54,0.0,0.010721944245889922,1,71,70,2,-1,3,9,0,31,67,39
975,120,120,76,76,0,174,174,72,72,0,120,120,76,76,0,0.006943735321147759,0.006943735321147759,58,58,0,-1,2,2,10,6,0,13,59
976,236,442,98,100,2,56,56,88,88,0,56,56,88,88,0,0.037509785901494265,0.04152626025392287,94,96,2,3,2,2,2,30,93,7,62
977,16,16,32,32,0,40,40,30,30,0,16,16,32,32,0,0.00030634126416828345,0.00030634126416828345,32,32,0,-1,3,3,14,1,17,65,93
978,18,18,40,40,0,100,100,47,47,0,18,18,40,40,0,0.002110350930937064,0.002110350930937064,43,43,0,-1,3,3,10,2,22,61,59
979,2,2,27,27,0,4,4,29,29,0,2,2,27,27,0,0.00030634126416828345,0.00030634126416828345,31,31,0,-1,5,5,2,1,99,60,66
980,126,126,78,78,0,152,152,76,76,0,126,126,78,78,0,0.010143299635794275,0.010143299635794275,66,66,0,-1,2,2,8,7,15,48,86
981,2,104,26,75,49,10,10,28,28,0,2,4,26,29,3,0.0002382654276864427,0.00030634126416828345,31,33,2,4,5,5,5,1,80,65,95
982,0,206,1,88,87,0,40,1,31,30,0,8,1,31,30,0.0,0.0015657442390823377,1,40,39,3,-1,4,17,0,20,93,83
983,32,648,46,100,54,86,156,42,66,24,32,156,46,83,37,0.002586881786309949,0.032914666938970015,47,92,45,2,3,3,11,2,5,75,3
984,300,402,95,98,3,112,112,92,92,0,112,112,92,92,0,0.03192756730998332,0.032029681064706085,90,90,0,4,2,2,4,22,83,9,65
985,16,222,44,92,48,48,48,54,54,0,16,48,43,55,12,0.0020763130126961434,0.0036760951700194017,46,53,7,3,3,3,3,1,87,53,64
986,16,632,34,100,66,92,102,41,54,13,16,34,34,45,11,0.0026889955410327104,0.00439089145307873,48,54,6,2,3,3,12,2,2,94,74
987,32,238,49,95,46,24,24,42,42,0,32,24,55,48,-7,0.003710133088260322,0.005241839409101739,50,53,3,3,3,3,3,2,60,75,52
988,0,206,1,97,96,0,8,1,34,33,0,8,1,40,39,0.0,0.004595118962524252,1,53,52,3,-1,4,2,0,97,93,44
989,172,172,95,95,0,22,22,54,54,0,22,22,54,54,0,0.02644746247319514,0.02644746247319514,90,90,0,-1,3,3,2,29,99,0,40
990,2,2,27,27,0,5,5,28,28,0,2,2,27,27,0,3.4037918240920386e-05,3.4037918240920386e-05,26,26,0,-1,5,5,3,1,66,95,96
991,190,190,91,91,0,64,64,67,67,0,64,64,68,68,0,0.02117158514585248,0.02117158514585248,85,85,0,-1,3,3,4,17,67,6,82
992,0,616,1,100,99,0,40,1,48,47,0,40,1,55,54,0.0,0.01674665577453283,1,81,80,2,-1,3,4,0,73,91,23
993,0,616,1,100,99,0,46,1,38,37,0,46,1,52,51,0.0,0.00878178290615746,1,67,66,2,-1,3,6,0,41,76,20
994,0,616,1,100,99,0,22,1,48,47,0,22,1,49,48,0.0,0.020661016372238675,1,87,86,2,-1,3,2,0,93,89,16
995,8,624,38,100,62,12,30,34,42,8,8,30,38,54,16,0.0002042275094455223,0.006773545729943157,32,63,31,2,4,3,4,2,72,56,73
996,0,0,1,1,0,0,0,1,1,0,0,0,1,1,0,0.0,0.0,1,1,0,-1,-1,-1,5,0,37,93,84
997,0,206,1,92,91,0,15,1,29,28,0,6,1,29,28,0.0,0.0008169100377820892,1,36,35,3,-1,4,6,0,65,97,71
998,0,1640,1,100,99,0,126,1,62,61,0,126,1,79,78,0.0,0.021920419347152727,1,84,83,1,-1,2,12,1,6,50,16
999,0,0,1,1,0,0,0,1,1,0,0,0,1,1,0,0.0,0.0,1,1,0,-1,-1,-1,6,0,48,59,99
