,FreeNet_pre_score,FreeNet_post_score,FreeNet_pre_rank,FreeNet_post_rank,FreeNet_delta_ranks,Reversed_pre_score,Reversed_post_score,Reversed_pre_rank,Reversed_post_rank,Reversed_delta_ranks,Random_pre_score,Random_post_score,Random_pre_rank,Random_post_rank,Random_delta_ranks,dist_victim_relayer,dist_victim_vilain_pre,dist_victim_vilain_post,out_deg_victim,in_deg_villain,victim,villain,relayer
0,6,212,397,958,561,16,25,392,454,62,0.0,0.00010211375472276115,1,482,481,3,4,4,9,2,276,374,551
1,6,108,416,906,490,13,19,389,440,51,0.0,0.00013615167296368154,1,508,507,4,4,4,8,4,302,595,667
2,6,108,388,887,499,32,33,396,397,1,0.0,0.0,1,1,0,4,4,4,17,1,24,265,152
3,1,102,333,924,591,4,4,333,333,0,0.0,3.4037918240920386e-05,1,401,400,5,6,6,4,1,578,640,607
4,98,304,929,986,57,48,48,947,947,0,0.002825147213996392,0.0035059055788147996,923,939,16,3,3,3,3,17,568,96,207
5,0,102,1,958,957,0,3,1,387,386,0.0,0.0002382654276864427,1,583,582,4,-1,5,2,0,982,436,653
6,0,101,1,956,955,0,3,1,331,330,0.0,0.0,1,1,0,5,-1,6,3,0,922,228,485
7,0,0,1,1,0,0,0,1,1,0,0.0,0.0,1,1,0,-1,-1,-1,7,0,404,886,901
8,0,0,1,1,0,0,0,1,1,0,0.0,0.0,1,1,0,-1,-1,-1,2,1,990,641,847
9,94,300,907,983,76,60,60,861,861,0,0.002382654276864427,0.0032336022328874367,908,932,24,3,3,3,5,20,294,87,114
10,0,0,1,1,0,0,0,1,1,0,0.0,0.0,1,1,0,-1,-1,-1,8,0,317,975,478
11,0,0,1,1,0,0,0,1,1,0,0.0,0.0,1,1,0,-1,-1,-1,10,0,149,876,946
12,18,18,675,675,0,36,36,741,741,0,0.00017018959120460194,0.00017018959120460194,541,541,0,-1,3,3,5,3,452,300,751
13,2,2,360,360,0,11,11,390,390,0,0.0,0.0,1,1,0,-1,5,5,7,1,658,771,936
14,0,102,1,926,925,0,8,1,449,448,0.0,0.00030634126416828345,1,633,632,4,-1,5,4,0,682,707,236
15,25,127,652,894,242,76,76,617,617,0,0.0004765308553728854,0.0006126825283365669,685,727,42,4,4,4,14,6,172,232,556
16,0,0,1,1,0,0,0,1,1,0,0.0,0.0,1,1,0,-1,-1,-1,12,0,62,737,920
17,0,206,1,974,973,0,14,1,511,510,0.0,0.00037441710065012424,1,658,657,3,-1,4,5,0,727,548,288
18,0,0,1,1,0,0,0,1,1,0,0.0,0.0,1,1,0,-1,-1,-1,7,0,299,906,423
19,39,245,811,978,167,34,34,817,817,0,0.0012253650566731338,0.0013955546478777359,827,845,18,3,3,3,4,9,550,294,741
20,0,206,1,958,957,0,19,1,424,423,0.0,0.00017018959120460194,1,543,542,3,-1,4,9,0,168,933,162
21,6,622,468,999,531,4,22,427,795,368,0.00013615167296368154,0.007352190340038803,527,973,446,2,5,3,2,4,705,230,24
22,2,618,362,997,635,7,24,376,628,252,0.0,0.0007147962830593281,1,748,747,2,5,3,5,3,667,748,655
23,9,9,621,621,0,9,9,567,567,0,0.00010211375472276115,0.00010211375472276115,486,486,0,-1,4,4,3,5,786,710,955
24,168,784,925,996,71,254,264,965,969,4,0.002144388849177984,0.004493005207801491,889,945,56,2,2,2,16,12,53,179,304
25,0,101,1,893,892,0,9,1,332,331,0.0,0.0,1,1,0,5,-1,6,9,0,315,817,679
26,9,9,527,527,0,26,26,530,530,0,6.807583648184077e-05,6.807583648184077e-05,451,451,0,-1,4,4,7,5,698,722,330
27,2,103,362,919,557,5,5,362,362,0,0.0,6.807583648184077e-05,1,441,440,5,5,5,4,1,832,763,481
28,1,1,333,333,0,9,9,333,333,0,0.0,0.0,1,1,0,-1,6,6,9,1,101,640,934
29,2,208,360,968,608,11,19,409,479,70,0.0,0.00034037918240920387,1,652,651,3,5,4,6,1,266,837,329
30,24,230,680,970,290,40,40,714,714,0,0.0008169100377820892,0.0020082371762143027,775,881,106,3,3,3,5,4,546,230,174
31,96,198,920,971,51,52,52,971,971,0,0.003914360597705844,0.0040845501889104465,939,943,4,4,2,2,3,17,912,213,307
32,33,649,742,995,253,28,38,570,686,116,0.0005786446100956465,0.0020763130126961434,726,886,160,2,4,3,6,9,536,294,117
33,0,616,1,995,994,0,40,1,669,668,0.0,0.002825147213996392,1,923,922,2,-1,3,7,0,400,426,69
34,229,229,966,966,0,82,82,861,861,0,0.005684332346233704,0.005684332346233704,966,966,0,-1,3,3,7,36,320,48,511
35,128,128,951,951,0,28,28,801,801,0,0.00445896728956057,0.00445896728956057,951,951,0,-1,3,3,3,31,568,34,908
36,2,208,364,973,609,7,16,364,492,128,3.4037918240920386e-05,0.00088498587426393,398,798,400,3,5,4,6,3,594,708,189
37,22,124,654,916,262,82,82,866,866,0,0.0009530617107457708,0.0011232513019503727,801,821,20,4,3,3,7,5,299,412,307
38,49,255,774,960,186,88,88,745,745,0,0.0005105687736138058,0.0007828721195411688,705,771,66,3,3,3,11,5,66,510,482
39,38,244,688,954,266,214,214,920,920,0,0.00176997174852786,0.0022465026039007454,867,898,31,3,3,3,18,4,86,281,169
40,0,206,1,978,977,0,12,1,581,580,0.0,0.001599782157323258,1,866,865,3,-1,4,2,0,643,950,85
41,0,102,1,923,922,0,7,1,395,394,0.0,0.00030634126416828345,1,635,634,4,-1,5,4,0,559,372,381
42,0,101,1,919,918,0,5,1,332,331,0.0,6.807583648184077e-05,1,450,449,5,-1,6,5,0,294,773,332
43,281,487,977,992,15,134,134,994,994,0,0.006637394056979475,0.006841621566424997,964,966,2,3,2,2,6,44,587,27,280
44,0,0,1,1,0,0,0,1,1,0,0.0,0.0,1,1,0,-1,-1,-1,7,0,299,429,877
45,2,104,366,926,560,5,5,380,380,0,3.4037918240920386e-05,0.0002382654276864427,396,585,189,4,5,5,3,1,592,879,636
46,0,0,1,1,0,0,0,1,1,0,0.0,0.0,1,1,0,-1,-1,-1,20,3,88,478,554
47,0,206,1,968,967,0,15,1,449,448,0.0,0.00034037918240920387,1,650,649,3,-1,4,6,0,275,847,727
48,0,101,1,911,910,0,6,1,332,331,0.0,0.0,1,1,0,6,-1,7,6,0,465,511,893
49,60,161,864,963,99,26,26,687,687,0,0.0018040096667687805,0.0018040096667687805,881,881,0,5,4,4,5,20,574,49,694
50,0,102,1,960,959,0,4,1,464,463,0.0,0.0004765308553728854,1,719,718,4,-1,5,2,0,950,905,159
51,6,6,480,480,0,8,8,503,503,0,0.00017018959120460194,0.00017018959120460194,563,563,0,-1,4,4,2,1,747,797,938
52,16,16,522,522,0,78,78,566,566,0,0.0005786446100956465,0.0005786446100956465,717,717,0,-1,3,3,18,1,34,500,517
53,10,10,569,569,0,22,22,579,579,0,0.0002042275094455223,0.0002042275094455223,584,584,0,-1,4,4,5,4,314,557,898
54,6,108,454,926,472,11,12,461,470,9,3.4037918240920386e-05,0.0005786446100956465,397,721,324,4,4,4,4,1,815,337,170
55,40,246,714,958,244,94,98,709,725,16,0.0007488342013002485,0.0008509479560230097,756,766,10,3,2,2,14,1,181,904,274
56,16,16,620,620,0,48,48,820,820,0,0.0005105687736138058,0.0005105687736138058,708,708,0,-1,3,3,6,1,465,891,959
57,16,117,603,926,323,20,20,501,501,0,0.0002382654276864427,0.0002723033459273631,582,605,23,5,4,4,6,6,275,459,360
58,0,102,1,920,919,0,8,1,422,421,0.0,0.000442492937131965,1,673,672,4,-1,5,4,0,741,751,333
59,18,120,590,900,310,84,84,695,695,0,0.0002723033459273631,0.00037441710065012424,610,662,52,4,3,3,12,2,226,323,247
60,170,376,978,997,19,32,32,951,951,0,0.007216038667075122,0.008645631233193778,973,980,7,3,3,3,2,49,751,16,84
61,25,25,724,724,0,32,32,694,694,0,0.0002042275094455223,0.0002042275094455223,575,575,0,-1,3,3,5,4,677,557,675
62,6,108,395,889,494,26,26,449,449,0,3.4037918240920386e-05,0.00017018959120460194,395,536,141,4,4,4,9,1,351,807,176
63,0,206,1,964,963,0,40,1,610,609,0.0,0.0038462847612240037,1,944,943,3,-1,4,8,0,137,686,21
64,11,11,585,585,0,24,24,666,666,0,0.0004765308553728854,0.0004765308553728854,709,709,0,-1,4,4,4,4,649,312,433
65,0,0,1,1,0,0,0,1,1,0,0.0,0.0,1,1,0,-1,-1,-1,6,0,518,744,520
66,7,108,522,936,414,10,10,461,461,0,6.807583648184077e-05,0.00010211375472276115,451,492,41,5,4,4,3,2,801,724,714
67,28,28,748,748,0,34,34,751,751,0,0.0007147962830593281,0.0007147962830593281,769,769,0,-1,3,3,4,5,694,283,657
68,16,16,526,526,0,72,72,585,585,0,0.0002382654276864427,0.0002382654276864427,589,589,0,-1,3,3,15,2,68,652,819
69,5,106,474,942,468,8,8,461,461,0,0.00013615167296368154,0.0002042275094455223,523,563,40,5,5,5,4,4,553,319,383
70,64,270,842,973,131,76,76,882,882,0,0.0015657442390823377,0.0018720855032506212,862,884,22,3,2,2,6,6,255,494,329
71,0,102,1,873,872,0,20,1,356,355,0.0,0.00013615167296368154,1,506,505,4,-1,5,18,0,86,804,398
72,0,206,1,952,951,0,64,1,613,612,0.0,0.003778208924742163,1,943,942,3,-1,4,12,1,212,428,25
73,16,117,636,931,295,30,30,730,730,0,0.0002382654276864427,0.0002382654276864427,599,599,0,5,3,3,4,1,969,904,449
74,14,220,667,977,310,10,18,509,668,159,0.00017018959120460194,0.0026549576227917903,546,922,376,3,4,4,3,4,835,315,105
75,56,672,767,991,224,154,164,780,792,12,0.0005446066918547262,0.0027911092957554717,716,919,203,2,3,3,19,6,31,461,35
76,16,632,505,987,482,94,116,542,628,86,3.4037918240920386e-05,0.0013955546478777359,393,846,453,2,3,3,22,2,22,719,393
77,0,616,1,988,987,0,66,1,396,395,0.0,0.0002723033459273631,1,593,592,2,-1,3,33,0,9,943,406
78,32,134,708,918,210,110,110,875,875,0,0.0009870996289866913,0.0009870996289866913,797,797,0,4,3,3,10,4,256,440,527
79,6,108,433,919,486,21,21,498,498,0,3.4037918240920386e-05,0.00017018959120460194,402,537,135,4,4,4,7,2,482,719,700
80,1,1,333,333,0,4,4,333,333,0,0.0,0.0,1,1,0,-1,7,7,4,1,717,469,971
81,6,212,403,958,555,36,40,507,525,18,0.00010211375472276115,0.0002382654276864427,484,590,106,3,4,4,10,2,99,492,241
82,61,162,875,966,91,14,14,566,566,0,0.0017359338302869397,0.0017359338302869397,879,879,0,6,4,4,3,18,901,147,615
83,0,206,1,978,977,0,10,1,538,537,0.0,0.0007488342013002485,1,777,776,3,-1,4,3,0,535,766,377
84,2,2,357,357,0,5,5,357,357,0,3.4037918240920386e-05,3.4037918240920386e-05,394,394,0,-1,5,5,4,1,509,543,472
85,0,206,1,968,967,0,26,1,594,593,0.0,0.001055175465468532,1,816,815,3,-1,4,5,0,294,922,226
86,21,122,685,930,245,18,18,643,643,0,0.0007828721195411688,0.0007828721195411688,789,789,0,5,4,4,3,6,471,114,679
87,0,0,1,1,0,0,0,1,1,0,0.0,0.0,1,1,0,-1,-1,-1,15,0,107,569,850
88,0,0,1,1,0,0,0,1,1,0,0.0,0.0,1,1,0,-1,-1,-1,3,0,716,945,976
89,58,159,871,965,94,28,28,797,797,0,0.0015317063208414173,0.0016338200755641784,861,869,8,5,3,3,3,13,901,255,687
90,43,43,858,858,0,12,12,633,633,0,0.0010211375472276116,0.0010211375472276116,821,821,0,-1,4,4,2,15,469,53,835
91,0,102,1,944,943,0,4,1,411,410,0.0,0.00037441710065012424,1,683,682,4,-1,5,2,0,983,970,294
92,0,102,1,928,927,0,6,1,412,411,0.0,0.0002042275094455223,1,575,574,4,-1,5,3,0,935,957,339
93,0,0,1,1,0,0,0,1,1,0,0.0,0.0,1,1,0,-1,-1,-1,12,0,62,855,348
94,0,206,1,973,972,0,22,1,600,599,0.0,0.001157289220191293,1,833,832,3,-1,4,5,0,435,991,94
95,35,651,731,992,261,74,74,748,748,0,0.0011232513019503727,0.0018720855032506212,819,878,59,2,3,3,9,4,164,125,215
96,0,0,1,1,0,0,0,1,1,0,0.0,0.0,1,1,0,-1,-1,-1,3,0,654,818,830
97,0,616,1,999,998,0,18,1,808,807,0.0,0.005071649817897137,1,963,962,2,-1,3,2,0,283,707,20
98,156,258,939,970,31,126,126,963,963,0,0.0030974505599237552,0.0030974505599237552,930,930,0,4,2,2,7,17,321,45,430
99,18,18,619,619,0,26,26,547,547,0,0.0002042275094455223,0.0002042275094455223,556,556,0,-1,3,3,6,3,514,321,356
100,54,260,796,970,174,86,86,791,791,0,0.0015657442390823377,0.001940161339732462,852,871,19,3,2,2,10,6,109,424,308
101,40,40,745,745,0,110,110,880,880,0,0.0014636304843595766,0.0014636304843595766,840,840,0,-1,2,2,10,2,211,482,991
102,58,674,821,995,174,136,136,933,933,0,0.0026209197045508697,0.009156200006807584,908,976,68,2,3,3,11,6,379,73,24
103,77,179,884,965,81,54,54,916,916,0,0.0020082371762143027,0.0023486163586235067,890,903,13,4,3,3,4,13,344,261,473
104,0,0,1,1,0,0,0,1,1,0,0.0,0.0,1,1,0,-1,-1,-1,7,0,214,651,812
105,4,4,449,449,0,5,5,396,396,0,0.00017018959120460194,0.00017018959120460194,546,546,0,-1,5,5,3,3,583,646,643
106,0,102,1,939,938,0,4,1,374,373,0.0,0.0,1,1,0,4,-1,5,3,0,628,887,598
107,0,102,1,921,920,0,8,1,434,433,0.0,0.0002042275094455223,1,588,587,4,-1,5,4,0,885,846,86
108,4,106,470,945,475,4,4,424,424,0,0.00010211375472276115,0.00010211375472276115,490,490,0,4,5,5,2,2,817,576,323
109,0,0,1,1,0,0,0,1,1,0,0.0,0.0,1,1,0,-1,-1,-1,2,3,963,882,823
110,0,101,1,908,907,0,5,1,332,331,0.0,3.4037918240920386e-05,1,392,391,5,-1,6,5,0,506,205,231
111,0,206,1,968,967,0,14,1,540,539,0.0,0.002586881786309949,1,913,912,3,-1,4,3,0,703,520,88
112,6,6,457,457,0,20,20,553,553,0,6.807583648184077e-05,6.807583648184077e-05,443,443,0,-1,4,4,6,1,661,609,433
113,84,290,843,968,125,162,162,913,913,0,0.0018720855032506212,0.0030634126416828346,875,925,50,3,2,2,13,8,120,174,45
114,12,12,579,579,0,20,20,575,575,0,0.0002723033459273631,0.0002723033459273631,616,616,0,-1,4,4,4,3,758,197,768
115,12,12,502,502,0,64,64,634,634,0,0.0002723033459273631,0.0002723033459273631,603,603,0,-1,4,4,12,4,184,149,657
116,0,0,1,1,0,0,0,1,1,0,0.0,0.0,1,1,0,-1,-1,-1,19,0,11,565,620
117,25,25,703,703,0,36,36,627,627,0,0.00017018959120460194,0.00017018959120460194,551,551,0,-1,3,3,7,6,335,459,792
118,0,0,1,1,0,0,0,1,1,0,0.0,0.0,1,1,0,-1,-1,-1,5,0,531,695,767
119,0,206,1,968,967,0,22,1,580,579,0.0,0.0021784267674189047,1,893,892,3,-1,4,5,0,692,823,98
120,18,18,682,682,0,12,12,586,586,0,0.0002723033459273631,0.0002723033459273631,631,631,0,-1,4,4,2,6,763,229,793
121,0,102,1,959,958,0,5,1,438,437,0.0,0.0012934408931549745,1,845,844,4,-1,5,3,0,852,999,128
122,92,298,844,970,126,142,142,825,825,0,0.001055175465468532,0.0012934408931549745,797,821,24,3,2,2,16,7,145,422,221
123,2,618,351,991,640,11,58,351,677,326,0.0,0.003812246842983083,1,939,938,2,5,3,10,2,241,331,57
124,75,75,849,849,0,88,88,836,836,0,0.0006807583648184077,0.0006807583648184077,751,751,0,-1,3,3,8,11,434,52,936
125,30,132,705,913,208,76,76,751,751,0,0.0005105687736138058,0.0007147962830593281,703,755,52,4,3,3,11,6,379,381,198
126,24,126,776,959,183,12,12,653,653,0,0.0008509479560230097,0.0013615167296368155,796,852,56,4,4,4,2,8,841,161,92
127,7,213,537,977,440,11,16,497,574,77,6.807583648184077e-05,0.0011913271384322134,452,828,376,3,4,4,4,2,553,566,352
128,0,206,1,969,968,0,14,1,468,467,0.0,0.00037441710065012424,1,665,664,3,-1,4,5,0,290,880,553
129,0,206,1,952,951,0,31,1,423,422,0.0,0.0002382654276864427,1,580,579,3,-1,4,15,0,138,608,389
130,0,206,1,964,963,0,16,1,477,476,0.0,0.0005786446100956465,1,723,722,3,-1,4,6,0,606,635,387
131,11,113,676,967,291,8,8,599,599,0,0.0009530617107457708,0.0034718676605738795,814,941,127,4,4,4,2,4,981,125,28
132,46,147,825,944,119,46,46,796,796,0,0.0010892133837094523,0.0010892133837094523,815,815,0,5,3,3,6,12,399,155,563
133,235,235,977,977,0,70,70,933,933,0,0.005548180673270023,0.005548180673270023,960,960,0,-1,3,3,5,49,688,51,981
134,383,383,982,982,0,148,148,951,951,0,0.006943735321147759,0.006943735321147759,973,973,0,-1,2,2,9,49,159,31,815
135,2,2,353,353,0,12,12,380,380,0,0.0,0.0,1,1,0,-1,5,5,8,1,468,639,966
136,0,616,1,998,997,0,34,1,866,865,0.0,0.012594029749140543,1,990,989,2,-1,3,3,0,901,839,2
137,49,151,874,974,100,34,34,885,885,0,0.0018040096667687805,0.0019741992579733825,885,896,11,4,3,3,4,17,860,213,241
138,2,104,350,881,531,11,12,350,361,11,3.4037918240920386e-05,6.807583648184077e-05,395,437,42,4,5,5,10,1,298,543,430
139,0,101,1,890,889,0,10,1,332,331,0.0,0.0,1,1,0,6,-1,7,10,0,427,844,181
140,62,164,880,967,87,28,28,815,815,0,0.0013274788113958951,0.0014295925661186562,854,859,5,4,3,3,3,18,530,147,409
141,14,220,670,977,307,12,12,609,609,0,0.0006126825283365669,0.0013955546478777359,746,857,111,3,4,4,2,4,976,407,204
142,0,102,1,908,907,0,10,1,414,413,0.0,0.0002042275094455223,1,578,577,4,-1,5,5,1,479,641,381
143,32,32,714,714,0,46,46,569,569,0,0.00030634126416828345,0.00030634126416828345,625,625,0,-1,3,3,10,5,82,314,713
144,0,616,1,995,994,0,23,1,560,559,0.0,0.001497668402600497,1,853,852,2,-1,3,5,0,347,672,477
145,0,102,1,956,955,0,3,1,382,381,0.0,0.0,1,1,0,4,-1,5,2,0,742,672,596
146,0,101,1,907,906,0,7,1,330,329,0.0,6.807583648184077e-05,1,451,450,5,-1,6,7,0,336,906,518
147,137,343,931,981,50,102,102,951,951,0,0.003267640151128357,0.0040845501889104465,925,939,14,3,2,2,8,23,309,122,147
148,10,10,573,573,0,10,10,461,461,0,3.4037918240920386e-05,3.4037918240920386e-05,409,409,0,-1,4,4,3,3,819,485,548
149,0,206,1,959,958,0,30,1,502,501,0.0,0.0006807583648184077,1,746,745,3,-1,4,9,1,119,650,336
150,0,0,1,1,0,0,0,1,1,0,0.0,0.0,1,1,0,-1,-1,-1,9,0,202,201,730
151,1,207,333,959,626,7,18,333,436,103,0.0,6.807583648184077e-05,1,449,448,3,6,4,7,2,221,357,86
152,79,180,885,967,82,60,60,911,911,0,0.001940161339732462,0.001940161339732462,879,879,0,5,3,3,5,15,421,151,531
153,21,123,740,950,210,12,12,671,671,0,0.000442492937131965,0.0005786446100956465,694,730,36,4,4,4,2,8,739,417,409
154,2,208,361,972,611,8,12,427,483,56,0.00034037918240920387,0.0009190237925048504,640,797,157,3,5,4,4,2,945,785,805
155,0,0,1,1,0,0,0,1,1,0,0.0,0.0,1,1,0,-1,-1,-1,8,0,434,968,910
156,0,102,1,870,869,0,18,1,348,347,0.0,0.0,1,1,0,4,-1,5,17,0,10,892,506
157,30,236,773,976,203,36,40,782,821,39,0.0008169100377820892,0.0015657442390823377,787,868,81,3,3,3,5,5,574,338,198
158,16,117,633,936,303,54,54,884,884,0,0.001055175465468532,0.001055175465468532,830,830,0,6,3,3,4,1,542,612,640
159,35,136,748,925,177,50,50,687,687,0,0.00030634126416828345,0.00034037918240920387,625,636,11,5,3,3,8,6,325,4,449
160,177,793,982,1000,18,32,32,969,969,0,0.010109261717553355,0.01501072194424589,983,990,7,2,3,3,2,54,987,19,92
161,8,110,567,949,382,8,8,502,502,0,0.000442492937131965,0.0005105687736138058,693,709,16,4,4,4,2,3,980,496,570
162,61,61,848,848,0,24,24,612,612,0,0.0013274788113958951,0.0013274788113958951,842,842,0,-1,4,4,4,17,235,269,699
163,0,102,1,907,906,0,12,1,398,397,0.0,0.0002382654276864427,1,587,586,4,-1,5,7,1,336,895,354
164,89,295,842,967,125,160,164,818,821,3,0.0014295925661186562,0.002144388849177984,838,889,51,3,3,3,18,8,34,284,172
165,14,116,636,940,304,12,12,567,567,0,0.00037441710065012424,0.000442492937131965,675,703,28,4,4,4,2,4,828,479,290
166,0,0,1,1,0,0,0,1,1,0,0.0,0.0,1,1,0,-1,-1,-1,5,0,773,702,735
167,64,64,897,897,0,46,46,977,977,0,0.00789679703189353,0.00789679703189353,976,976,0,-1,2,2,2,11,960,118,472
168,20,226,743,980,237,8,12,534,714,180,0.0004084550188910446,0.0017018959120460194,696,886,190,3,4,4,2,7,684,115,131
169,50,256,805,974,169,52,52,708,708,0,0.0009190237925048504,0.001599782157323258,789,861,72,3,3,3,7,8,372,204,155
170,149,250,974,990,16,54,54,966,966,0,0.007011811157629599,0.007113924912352361,969,970,1,5,3,3,4,49,860,51,625
171,2,2,352,352,0,20,20,405,405,0,0.0,0.0,1,1,0,-1,5,5,11,1,333,878,686
172,2,2,367,367,0,3,3,370,370,0,0.0,0.0,1,1,0,-1,5,5,2,3,596,460,426
173,235,235,972,972,0,64,64,915,915,0,0.0038462847612240037,0.0038462847612240037,940,940,0,-1,3,3,4,44,300,27,888
174,6,108,447,926,479,11,12,458,478,20,0.0,6.807583648184077e-05,1,442,441,4,4,4,4,1,313,394,771
175,0,102,1,889,888,0,11,1,363,362,0.0,6.807583648184077e-05,1,444,443,4,-1,5,9,1,123,554,575
176,36,36,830,830,0,28,28,849,849,0,0.0009530617107457708,0.0009530617107457708,815,815,0,-1,3,3,3,8,523,345,462
177,2,208,348,940,592,23,42,377,465,88,3.4037918240920386e-05,0.0006467204465774873,396,734,338,3,5,4,15,1,124,530,163
178,0,0,1,1,0,0,0,1,1,0,0.0,0.0,1,1,0,-1,-1,-1,5,0,347,712,943
179,4,106,504,967,463,4,4,471,471,0,0.00030634126416828345,0.0004084550188910446,657,697,40,4,5,5,2,4,873,270,549
180,60,60,792,792,0,158,158,802,802,0,0.0010892133837094523,0.0010892133837094523,808,808,0,-1,2,2,18,6,64,192,712
181,101,203,938,974,36,22,22,795,795,0,0.002314578440382586,0.0025188059498281084,908,917,9,4,3,3,2,20,747,43,541
182,24,126,749,947,198,22,22,777,777,0,0.001055175465468532,0.001157289220191293,825,839,14,4,3,3,2,3,926,507,451
183,0,616,1,996,995,0,26,1,571,570,0.0,0.0012253650566731338,1,828,827,2,-1,3,6,0,266,872,439
184,7,7,523,523,0,12,12,455,455,0,3.4037918240920386e-05,3.4037918240920386e-05,394,394,0,-1,4,4,4,2,445,627,818
185,137,137,925,925,0,106,106,947,947,0,0.0026889955410327104,0.0026889955410327104,923,923,0,-1,2,2,7,19,591,91,573
186,0,206,1,937,936,0,40,1,394,393,0.0,0.00013615167296368154,1,495,494,3,-1,4,21,0,54,937,93
187,2,618,372,998,626,4,28,372,775,403,0.0,0.006943735321147759,1,968,967,2,5,3,3,1,935,896,30
188,0,206,1,958,957,0,24,1,487,486,0.0,0.0007147962830593281,1,757,756,3,-1,4,8,1,365,428,143
189,6,212,436,972,536,12,12,559,559,0,0.0002382654276864427,0.0023486163586235067,590,906,316,3,4,4,2,1,893,474,133
190,0,0,1,1,0,0,0,1,1,0,0.0,0.0,1,1,0,-1,-1,-1,4,0,822,978,997
191,2,104,355,895,540,8,12,356,392,36,0.0,6.807583648184077e-05,1,455,454,4,5,5,7,1,714,621,785
192,0,206,1,966,965,0,13,1,459,458,0.0,0.0007488342013002485,1,770,769,3,-1,4,5,3,284,753,658
193,2,2,379,379,0,4,4,411,411,0,0.0,0.0,1,1,0,-1,5,5,2,1,928,592,987
194,11,11,549,549,0,26,26,516,516,0,0.00010211375472276115,0.00010211375472276115,480,480,0,-1,4,4,7,4,398,380,569
195,59,675,868,998,130,34,44,802,884,82,0.0019061234214915416,0.003914360597705844,881,940,59,2,3,3,4,15,673,151,415
196,399,501,983,991,8,144,144,987,987,0,0.006569318220497634,0.006705469893461316,971,971,0,4,2,2,6,61,425,14,443
197,13,219,610,976,366,18,22,526,594,68,6.807583648184077e-05,0.0038462847612240037,453,944,491,3,4,4,5,8,421,477,34
198,0,0,1,1,0,0,0,1,1,0,0.0,0.0,1,1,0,-1,-1,-1,2,0,846,372,587
199,6,212,401,957,556,20,25,413,454,41,0.00013615167296368154,0.0007828721195411688,502,774,272,3,4,4,9,1,274,537,245
200,56,262,908,990,82,18,18,800,800,0,0.002212464685659825,0.003437829742332959,910,940,30,3,4,4,3,18,852,141,73
201,14,116,562,907,345,32,32,539,539,0,0.0002042275094455223,0.00034037918240920387,563,636,73,4,4,4,8,4,415,315,309
202,22,124,671,927,256,30,30,701,701,0,0.00037441710065012424,0.0010211375472276116,661,812,151,4,3,3,4,2,391,827,242
203,16,222,533,951,418,68,76,562,591,29,0.0002723033459273631,0.0009190237925048504,609,779,170,3,3,3,15,1,107,420,610
204,0,0,1,1,0,0,0,1,1,0,0.0,0.0,1,1,0,-1,-1,-1,2,1,429,573,669
205,18,224,581,952,371,92,96,629,642,13,0.0002723033459273631,0.0011232513019503727,612,810,198,3,3,3,16,2,26,363,99
206,16,117,639,939,300,44,44,858,858,0,0.00088498587426393,0.00088498587426393,798,798,0,5,3,3,4,1,475,759,885
207,2,104,367,926,559,7,8,399,435,36,0.0,0.00034037918240920387,1,654,653,4,5,5,4,1,740,402,475
208,79,79,873,873,0,44,44,805,805,0,0.0013274788113958951,0.0013274788113958951,841,841,0,-1,3,3,4,14,540,175,790
209,20,620,630,992,362,36,36,543,543,0,0.00017018959120460194,0.0007828721195411688,547,759,212,2,3,3,10,3,527,353,336
210,32,134,679,903,224,100,100,634,634,0,0.0002382654276864427,0.000442492937131965,589,684,95,4,3,3,17,4,24,239,805
211,14,220,509,950,441,46,50,454,472,18,6.807583648184077e-05,0.0007828721195411688,451,758,307,3,4,4,17,3,10,485,99
212,25,25,725,725,0,46,46,786,786,0,0.0011913271384322134,0.0011913271384322134,820,820,0,-1,3,3,6,4,664,207,818
213,6,108,394,884,490,26,26,429,429,0,6.807583648184077e-05,6.807583648184077e-05,435,435,0,4,4,4,12,1,183,555,593
214,1,207,333,950,617,15,30,333,404,71,0.0,0.0002382654276864427,1,582,581,3,7,4,15,2,0,448,795
215,32,32,753,753,0,56,56,822,822,0,0.0014636304843595766,0.0014636304843595766,854,854,0,-1,3,3,6,6,451,114,538
216,98,698,920,998,78,32,32,875,875,0,0.0030974505599237552,0.01065386840940808,930,984,54,2,3,3,2,21,971,123,70
217,1,103,333,919,586,5,10,333,429,96,3.4037918240920386e-05,0.0002042275094455223,408,570,162,4,6,5,5,2,616,721,199
218,58,58,847,847,0,68,68,948,948,0,0.0011232513019503727,0.0011232513019503727,824,824,0,-1,2,2,6,8,486,132,871
219,4,4,440,440,0,4,4,393,393,0,6.807583648184077e-05,6.807583648184077e-05,438,438,0,-1,5,5,2,2,828,298,731
220,16,16,578,578,0,34,34,564,564,0,0.00010211375472276115,0.00010211375472276115,477,477,0,-1,3,3,8,2,302,384,515
221,0,101,1,949,948,0,2,1,328,327,0.0,0.00013615167296368154,1,522,521,5,-1,6,2,0,851,664,22
222,238,854,955,996,41,204,204,897,897,0,0.0024507301133462676,0.003982436434187685,908,946,38,2,2,2,15,23,77,66,227
223,8,8,478,478,0,23,23,379,379,0,0.0,0.0,1,1,0,-1,4,4,14,2,332,694,498
224,74,175,897,970,73,22,22,779,779,0,0.0020763130126961434,0.002110350930937064,897,901,4,5,3,3,2,13,886,261,484
225,16,222,529,952,423,55,60,494,507,13,6.807583648184077e-05,0.0002042275094455223,437,555,118,3,3,3,16,1,59,537,210
226,32,32,682,682,0,82,82,614,614,0,0.0002723033459273631,0.0002723033459273631,609,609,0,-1,4,4,15,8,107,286,738
227,16,222,656,976,320,10,10,516,516,0,0.00037441710065012424,0.0007828721195411688,665,785,120,3,4,4,3,8,710,417,461
228,1,103,333,889,556,9,10,333,350,17,0.0,6.807583648184077e-05,1,443,442,4,7,5,9,2,191,448,648
229,0,102,1,922,921,0,6,1,372,371,0.0,0.00017018959120460194,1,558,557,4,-1,5,4,0,532,888,452
230,16,222,582,966,384,44,48,592,619,27,0.00034037918240920387,0.00088498587426393,649,784,135,3,3,3,9,2,180,691,221
231,56,56,832,832,0,66,66,864,864,0,0.0010211375472276116,0.0010211375472276116,813,813,0,-1,3,3,6,10,267,227,921
232,0,616,1,989,988,0,70,1,591,590,0.0,0.0013274788113958951,1,838,837,2,-1,3,14,2,198,633,207
233,20,122,726,950,224,12,12,640,640,0,0.0005446066918547262,0.0006126825283365669,728,744,16,4,4,4,2,8,816,250,365
234,0,101,1,932,931,0,4,1,331,330,0.0,0.0,1,1,0,6,-1,7,4,0,728,760,736
235,0,206,1,947,946,0,23,1,381,380,0.0,0.00017018959120460194,1,525,524,3,-1,4,15,0,45,871,347
236,0,206,1,961,960,0,17,1,450,449,0.0,0.0004084550188910446,1,672,671,3,-1,4,7,0,364,859,195
237,8,214,546,973,427,16,16,560,560,0,0.00017018959120460194,0.0009190237925048504,536,796,260,3,4,4,4,2,945,383,559
238,0,102,1,935,934,0,4,1,394,393,0.0,0.00030634126416828345,1,643,642,4,-1,5,2,0,586,929,516
239,169,375,956,985,29,92,92,940,940,0,0.004152626025392287,0.004356853534837809,945,946,1,3,3,3,7,25,439,105,741
240,17,119,714,951,237,24,24,800,800,0,0.0002382654276864427,0.0002382654276864427,597,597,0,4,3,3,3,2,835,724,652
241,70,70,788,788,0,200,200,812,812,0,0.0004084550188910446,0.0004084550188910446,673,673,0,-1,3,3,23,6,4,192,900
242,0,0,1,1,0,0,0,1,1,0,0.0,0.0,1,1,0,-1,-1,-1,3,1,576,730,952
243,0,102,1,938,937,0,3,1,376,375,0.0,0.0005446066918547262,1,725,724,4,-1,5,2,0,906,925,273
244,2,2,363,363,0,8,8,428,428,0,0.00010211375472276115,0.00010211375472276115,483,483,0,-1,5,5,4,1,401,797,863
245,80,286,811,966,155,190,190,743,743,0,0.0009870996289866913,0.0011913271384322134,795,817,22,3,3,3,25,8,17,204,256
246,6,108,455,926,471,10,10,460,460,0,0.00034037918240920387,0.0005105687736138058,643,710,67,4,4,4,3,2,577,805,93
247,16,222,557,955,398,78,78,705,705,0,0.0002382654276864427,0.002144388849177984,587,885,298,3,3,3,11,1,220,741,38
248,0,102,1,938,937,0,3,1,370,369,0.0,0.00013615167296368154,1,533,532,4,-1,5,2,1,283,660,406
249,21,21,746,746,0,24,24,809,809,0,0.0006126825283365669,0.0006126825283365669,736,736,0,-1,3,3,3,7,785,427,445
250,0,0,1,1,0,0,0,1,1,0,0.0,0.0,1,1,0,-1,-1,-1,12,1,222,780,712
251,14,14,623,623,0,16,16,545,545,0,0.0002042275094455223,0.0002042275094455223,579,579,0,-1,4,4,4,4,344,637,954
252,2,104,366,941,575,6,6,418,418,0,6.807583648184077e-05,0.00017018959120460194,456,548,92,4,5,5,3,4,699,512,566
253,0,102,1,957,956,0,6,1,478,477,0.0,0.0009190237925048504,1,810,809,4,-1,5,3,0,883,990,148
254,1,1,333,333,0,3,3,333,333,0,0.0,0.0,1,1,0,-1,6,6,3,3,627,748,927
255,68,68,886,886,0,22,22,784,784,0,0.0016338200755641784,0.0016338200755641784,871,871,0,-1,3,3,2,15,596,53,922
256,8,109,523,923,400,8,8,446,446,0,6.807583648184077e-05,0.00010211375472276115,447,484,37,5,4,4,2,3,859,598,398
257,1,102,332,957,625,3,3,332,332,0,3.4037918240920386e-05,3.4037918240920386e-05,418,418,0,7,6,6,3,1,850,543,703
258,0,101,1,949,948,0,2,1,332,331,0.0,0.0002723033459273631,1,625,624,5,-1,6,2,0,625,565,134
259,2,208,374,978,604,4,8,416,511,95,6.807583648184077e-05,0.001157289220191293,448,834,386,3,5,4,2,1,910,840,190
260,22,22,597,597,0,98,98,602,602,0,0.0002042275094455223,0.0002042275094455223,559,559,0,-1,3,3,19,2,48,697,538
261,6,6,398,398,0,30,30,411,411,0,0.0,0.0,1,1,0,-1,4,4,14,2,144,597,802
262,0,0,1,1,0,0,0,1,1,0,0.0,0.0,1,1,0,-1,-1,-1,14,1,127,913,930
263,0,102,1,904,903,0,7,1,360,359,0.0,0.0,1,1,0,4,-1,5,6,0,345,728,506
264,46,46,851,851,0,24,24,779,779,0,0.0010892133837094523,0.0010892133837094523,819,819,0,-1,3,3,3,12,639,99,651
265,19,121,626,909,283,42,42,642,642,0,0.0002042275094455223,0.0002382654276864427,563,589,26,4,3,3,6,3,157,508,512
266,8,110,498,895,397,56,56,572,572,0,0.00017018959120460194,0.0002042275094455223,538,563,25,4,4,4,12,6,106,406,873
267,0,0,1,1,0,0,0,1,1,0,0.0,0.0,1,1,0,-1,-1,-1,4,0,493,715,583
268,0,206,1,976,975,0,8,1,501,500,0.0,0.001157289220191293,1,835,834,3,-1,4,2,0,739,600,99
269,1,1,333,333,0,14,14,333,333,0,0.0,0.0,1,1,0,-1,6,6,14,4,127,595,920
270,0,206,1,957,956,0,16,1,437,436,0.0,0.00034037918240920387,1,642,641,3,-1,4,6,0,560,866,507
271,6,6,382,382,0,33,33,380,380,0,3.4037918240920386e-05,3.4037918240920386e-05,400,400,0,-1,4,4,21,1,13,763,784
272,0,102,1,926,925,0,3,1,366,365,0.0,0.0009870996289866913,1,822,821,4,-1,5,2,0,932,737,84
273,2,103,362,913,551,7,7,375,375,0,6.807583648184077e-05,6.807583648184077e-05,447,447,0,6,5,5,5,1,407,931,448
274,10,216,625,979,354,8,8,519,519,0,0.00017018959120460194,0.0017018959120460194,562,877,315,3,4,4,2,3,992,378,95
275,24,126,766,953,187,14,14,579,579,0,0.00037441710065012424,0.00088498587426393,681,809,128,4,4,4,3,11,826,316,467
276,2,2,369,369,0,6,6,466,466,0,0.0002382654276864427,0.0002382654276864427,606,606,0,-1,5,5,3,2,899,785,600
277,0,206,1,966,965,0,17,1,447,446,0.0,0.00013615167296368154,1,501,500,3,-1,4,7,0,416,988,541
278,0,102,1,886,885,0,18,1,388,387,0.0,0.00017018959120460194,1,532,531,4,-1,5,11,3,215,854,173
279,30,30,739,739,0,20,20,546,546,0,0.0005105687736138058,0.0005105687736138058,716,716,0,-1,4,4,4,9,500,240,798
280,26,232,741,977,236,20,20,610,610,0,0.0004765308553728854,0.0016678579938050988,691,860,169,3,4,4,4,9,659,391,277
281,6,107,404,898,494,19,19,418,418,0,0.0,3.4037918240920386e-05,1,406,405,5,4,4,8,2,357,342,364
282,8,8,511,511,0,12,12,436,436,0,6.807583648184077e-05,6.807583648184077e-05,443,443,0,-1,4,4,4,2,385,576,548
283,52,52,811,811,0,62,62,843,843,0,0.0016678579938050988,0.0016678579938050988,864,864,0,-1,3,3,6,6,536,397,657
284,1,103,332,923,591,4,6,332,382,50,3.4037918240920386e-05,0.0002042275094455223,396,558,162,4,6,5,4,1,767,640,262
285,0,0,1,1,0,0,0,1,1,0,0.0,0.0,1,1,0,-1,-1,-1,3,0,879,672,909
286,22,22,780,780,0,23,23,869,869,0,0.0010892133837094523,0.0010892133837094523,832,832,0,-1,3,3,3,3,877,525,983
287,165,165,973,973,0,28,28,843,843,0,0.004833384390210695,0.004833384390210695,952,952,0,-1,3,3,3,57,718,50,831
288,66,168,848,949,101,68,68,794,794,0,0.001940161339732462,0.0021784267674189047,878,888,10,4,3,3,8,11,286,166,653
289,0,101,1,956,955,0,2,1,331,330,0.0,0.00017018959120460194,1,566,565,5,-1,6,2,1,974,779,645
290,16,16,755,755,0,10,10,641,641,0,0.00037441710065012424,0.00037441710065012424,679,679,0,-1,4,4,3,6,812,199,737
291,12,218,610,973,363,26,30,653,720,67,0.0007147962830593281,0.00803294870485721,763,971,208,3,4,4,5,4,376,333,10
292,10,112,589,938,349,16,16,569,569,0,3.4037918240920386e-05,0.000442492937131965,404,706,302,4,4,4,4,4,673,567,154
293,36,242,713,961,248,48,57,533,593,60,0.00037441710065012424,0.0010892133837094523,663,805,142,3,3,3,12,5,62,314,366
294,48,48,699,699,0,212,212,683,683,0,0.000442492937131965,0.000442492937131965,660,660,0,-1,3,3,36,3,16,519,965
295,0,102,1,910,909,0,7,1,354,353,0.0,0.0,1,1,0,4,-1,5,6,1,295,693,572
296,126,126,932,932,0,38,38,806,806,0,0.0022465026039007454,0.0022465026039007454,895,895,0,-1,3,3,3,34,634,89,735
297,16,118,590,920,330,36,36,696,696,0,0.0002042275094455223,0.0002382654276864427,567,590,23,4,3,3,5,1,537,553,576
298,0,102,1,913,912,0,8,1,390,389,0.0,6.807583648184077e-05,1,452,451,4,-1,5,5,0,476,740,107
299,14,116,563,899,336,26,26,489,489,0,0.0,0.00017018959120460194,1,536,535,4,4,4,9,3,319,248,115
300,22,22,718,718,0,44,44,872,872,0,0.0014295925661186562,0.0014295925661186562,848,848,0,-1,3,3,4,5,611,412,778
301,1,102,332,921,589,4,4,332,332,0,0.0,0.00010211375472276115,1,476,475,5,6,6,4,4,787,595,550
302,18,18,618,618,0,72,72,811,811,0,0.0009190237925048504,0.0009190237925048504,791,791,0,-1,3,3,7,3,246,559,426
303,0,206,1,952,951,0,30,1,469,468,0.0,0.0006126825283365669,1,741,740,3,-1,4,11,0,229,324,440
304,0,102,1,917,916,0,8,1,387,386,0.0,0.00013615167296368154,1,521,520,4,-1,5,5,0,616,808,188
305,8,8,510,510,0,20,20,491,491,0,3.4037918240920386e-05,3.4037918240920386e-05,404,404,0,-1,4,4,6,2,549,749,820
306,0,101,1,924,923,0,4,1,331,330,0.0,0.0,1,1,0,6,-1,7,4,0,706,825,734
307,0,102,1,944,943,0,3,1,375,374,0.0,6.807583648184077e-05,1,448,447,4,-1,5,2,0,983,911,363
308,0,102,1,874,873,0,16,1,355,354,0.0,6.807583648184077e-05,1,434,433,4,-1,5,14,0,85,845,580
309,214,420,966,988,22,108,108,959,959,0,0.004731270635487933,0.006433166547533953,952,969,17,3,3,3,8,27,309,25,157
310,4,620,441,998,557,9,23,422,675,253,0.0,0.0015317063208414173,1,860,859,2,5,3,5,2,685,602,762
311,0,102,1,962,961,0,3,1,403,402,0.0,0.0002382654276864427,1,616,615,4,-1,5,2,0,788,858,90
312,14,116,567,905,338,30,30,543,543,0,0.0002382654276864427,0.0006467204465774873,583,737,154,4,4,4,7,5,340,722,232
313,36,652,794,997,203,64,64,948,948,0,0.00176997174852786,0.004663194799006093,879,953,74,2,3,3,4,8,885,174,48
314,7,109,560,953,393,14,14,625,625,0,6.807583648184077e-05,0.0006467204465774873,454,760,306,4,4,4,3,3,654,263,99
315,134,340,901,978,77,160,160,863,863,0,0.0018720855032506212,0.0026889955410327104,875,912,37,3,3,3,15,17,107,96,179
316,100,100,883,883,0,100,100,896,896,0,0.035705776234725484,0.035875965825930084,1000,1000,0,3,1,1,8,127,186,11,840
317,38,654,782,995,213,52,62,790,852,62,0.0006807583648184077,0.004118588107151367,761,947,186,2,3,3,6,4,402,407,26
318,2,618,347,993,646,23,86,356,544,188,0.0,0.0017018959120460194,1,866,865,2,5,3,20,1,61,893,89
319,45,251,817,979,162,46,46,843,843,0,0.0005105687736138058,0.0008509479560230097,714,778,64,3,3,3,5,5,421,310,480
320,93,195,933,978,45,22,22,834,834,0,0.001599782157323258,0.0016338200755641784,875,879,4,4,3,3,2,23,895,117,305
321,2,208,386,983,597,3,8,390,550,160,6.807583648184077e-05,0.0014636304843595766,472,871,399,3,5,4,2,1,914,743,96
322,14,115,600,921,321,12,12,543,543,0,0.00017018959120460194,0.00017018959120460194,556,556,0,6,4,4,2,3,769,536,140
323,0,206,1,979,978,0,10,1,515,514,0.0,0.0005105687736138058,1,718,717,3,-1,4,4,1,480,830,162
324,12,114,610,945,335,20,20,670,670,0,0.0004765308553728854,0.0005105687736138058,707,717,10,4,4,4,4,4,553,470,223
325,129,129,934,934,0,62,62,825,825,0,0.002927260968719153,0.002927260968719153,916,916,0,-1,3,3,7,27,722,69,801
326,0,0,1,1,0,0,0,1,1,0,0.0,0.0,1,1,0,-1,-1,-1,2,3,820,478,884
327,0,0,1,1,0,0,0,1,1,0,0.0,0.0,1,1,0,-1,-1,-1,9,0,140,802,882
328,0,616,1,998,997,0,34,1,772,771,0.0,0.006331052792811192,1,966,965,2,-1,3,4,0,495,843,9
329,55,155,894,976,82,22,22,874,874,0,0.001940161339732462,0.0029612988869600733,885,928,43,4,3,3,2,17,666,45,117
330,6,212,409,957,548,21,25,434,463,29,3.4037918240920386e-05,0.00010211375472276115,398,480,82,3,4,4,9,1,263,463,477
331,6,107,426,905,479,34,34,544,544,0,0.00037441710065012424,0.00037441710065012424,661,661,0,8,4,4,9,4,388,409,647
332,88,88,936,936,0,18,18,812,812,0,0.0018040096667687805,0.0018040096667687805,889,889,0,-1,3,3,2,23,684,66,701
333,22,124,612,900,288,70,70,603,603,0,0.0002042275094455223,0.0002382654276864427,568,592,24,4,3,3,14,4,130,239,666
334,0,206,1,964,963,0,21,1,478,477,0.0,0.0005446066918547262,1,722,721,3,-1,4,8,0,541,872,114
335,36,36,807,807,0,18,18,705,705,0,0.0010211375472276116,0.0010211375472276116,816,816,0,-1,4,4,3,14,710,175,968
336,14,14,562,562,0,37,37,510,510,0,0.00017018959120460194,0.00017018959120460194,532,532,0,-1,4,4,11,4,174,332,860
337,24,126,659,910,251,92,92,735,735,0,0.0005446066918547262,0.0006467204465774873,708,735,27,4,3,3,13,4,185,622,809
338,19,225,699,974,275,18,18,633,633,0,0.0002042275094455223,0.0018040096667687805,566,885,319,3,4,4,3,9,801,341,122
339,24,24,768,768,0,22,22,796,796,0,0.0006467204465774873,0.0006467204465774873,746,746,0,-1,3,3,2,4,779,637,600
340,8,8,582,582,0,10,10,561,561,0,0.00010211375472276115,0.00010211375472276115,495,495,0,-1,4,4,3,3,796,508,672
341,89,89,898,898,0,68,68,948,948,0,0.002144388849177984,0.002144388849177984,892,892,0,-1,2,2,4,14,444,243,985
342,34,136,679,905,226,74,74,556,556,0,0.00010211375472276115,0.00034037918240920387,477,641,164,4,3,3,18,3,86,93,869
343,16,222,632,973,341,12,12,490,490,0,0.00030634126416828345,0.0005446066918547262,616,722,106,3,4,4,4,5,562,124,29
344,0,0,1,1,0,0,0,1,1,0,0.0,0.0,1,1,0,-1,-1,-1,9,0,803,657,844
345,6,622,418,994,576,20,42,454,647,193,6.807583648184077e-05,0.001940161339732462,440,872,432,2,4,3,8,1,325,322,60
346,0,0,1,1,0,0,0,1,1,0,0.0,0.0,1,1,0,-1,-1,-1,9,0,395,754,950
347,0,0,1,1,0,0,0,1,1,0,0.0,0.0,1,1,0,-1,-1,-1,2,2,666,462,539
348,33,135,728,913,185,38,38,577,577,0,0.00017018959120460194,0.00034037918240920387,539,643,104,4,3,3,8,6,411,229,476
349,0,0,1,1,0,0,0,1,1,0,0.0,0.0,1,1,0,-1,-1,-1,5,0,396,533,641
350,223,839,954,997,43,200,210,974,979,5,0.006501242384015794,0.010619830491167161,964,978,14,2,2,2,12,19,184,91,16
351,191,191,967,967,0,84,84,966,966,0,0.006297014874570271,0.006297014874570271,965,965,0,-1,2,2,5,24,452,13,773
352,0,206,1,957,956,0,31,1,536,535,0.0,0.0005105687736138058,1,716,715,3,-1,4,8,1,301,787,187
353,9,111,580,940,360,20,20,644,644,0,0.00030634126416828345,0.00037441710065012424,643,678,35,4,4,4,4,4,728,339,566
354,54,54,798,798,0,126,126,855,855,0,0.0007828721195411688,0.0007828721195411688,774,774,0,-1,3,3,11,8,227,264,798
355,0,102,1,958,957,0,4,1,435,434,0.0,0.0008509479560230097,1,798,797,4,-1,5,2,0,751,888,281
356,24,125,659,910,251,92,92,735,735,0,0.0005446066918547262,0.0005446066918547262,708,708,0,6,3,3,13,4,185,622,448
357,12,114,604,940,336,24,24,683,683,0,0.0004765308553728854,0.0009190237925048504,706,801,95,4,4,4,4,4,633,305,396
358,1,103,332,926,594,5,9,332,411,79,0.0,0.0,1,1,0,4,7,5,5,1,533,469,222
359,0,102,1,936,935,0,4,1,371,370,0.0,3.4037918240920386e-05,1,394,393,4,-1,5,3,1,961,792,363
360,18,634,571,991,420,78,110,585,722,137,0.00017018959120460194,0.0020082371762143027,536,881,345,2,3,3,16,2,151,724,47
361,0,102,1,945,944,0,4,1,380,379,0.0,0.00017018959120460194,1,561,560,4,-1,5,3,2,654,462,315
362,0,102,1,934,933,0,4,1,376,375,0.0,3.4037918240920386e-05,1,408,407,4,-1,5,3,0,716,910,427
363,0,0,1,1,0,0,0,1,1,0,0.0,0.0,1,1,0,-1,-1,-1,5,0,691,772,800
364,0,206,1,974,973,0,9,1,472,471,0.0,0.00034037918240920387,1,640,639,3,-1,4,3,0,829,999,230
365,2,2,367,367,0,4,4,396,396,0,0.00017018959120460194,0.00017018959120460194,535,535,0,-1,5,5,2,1,966,756,706
366,35,241,717,959,242,96,96,769,769,0,0.0006126825283365669,0.0007488342013002485,735,765,30,3,3,3,11,5,227,216,682
367,1,102,332,935,603,2,2,332,332,0,0.0,0.0,1,1,0,7,6,6,2,1,733,437,765
368,1,1,333,333,0,6,6,333,333,0,0.0,0.0,1,1,0,-1,6,6,6,3,402,626,429
369,31,133,741,939,198,34,34,662,662,0,0.0005446066918547262,0.0006126825283365669,702,723,21,4,3,3,6,6,556,368,810
370,100,100,885,885,0,78,78,847,847,0,0.0023486163586235067,0.0023486163586235067,899,899,0,-1,3,3,8,19,488,72,699
371,8,110,574,964,390,5,5,445,445,0,0.0002382654276864427,0.0030974505599237552,599,926,327,4,5,5,3,7,877,237,28
372,13,115,608,933,325,18,18,662,662,0,0.0009530617107457708,0.0020082371762143027,807,883,76,4,4,4,3,3,620,438,87
373,0,0,1,1,0,0,0,1,1,0,0.0,0.0,1,1,0,-1,-1,-1,4,0,542,455,811
374,80,1720,820,1000,180,162,212,806,884,78,0.0011232513019503727,0.010075223799312433,813,980,167,1,2,2,19,7,36,303,16
375,1,103,333,912,579,4,5,333,365,32,0.0,0.00017018959120460194,1,542,541,4,7,5,4,1,717,469,309
376,46,46,833,833,0,60,60,904,904,0,0.002144388849177984,0.002144388849177984,888,888,0,-1,3,3,5,11,456,193,644
377,195,296,952,976,24,92,92,881,881,0,0.004186663943633207,0.004220701861874128,950,950,0,5,3,3,7,29,179,142,601
378,312,414,981,988,7,70,70,941,941,0,0.008577555396711936,0.008747744987916539,976,976,0,4,3,3,5,54,476,19,121
379,10,10,592,592,0,8,8,473,473,0,6.807583648184077e-05,6.807583648184077e-05,461,461,0,-1,4,4,2,4,643,220,546
380,0,616,1,993,992,0,140,1,714,713,0.0,0.005071649817897137,1,953,952,2,-1,3,20,0,61,488,70
381,6,6,407,407,0,38,38,544,544,0,0.00017018959120460194,0.00017018959120460194,544,544,0,-1,4,4,9,4,245,409,738
382,0,102,1,964,963,0,5,1,416,415,0.0,0.000442492937131965,1,689,688,4,-1,5,3,0,786,943,387
383,0,616,1,992,991,0,42,1,583,582,0.0,0.001599782157323258,1,856,855,2,-1,3,10,1,243,472,294
384,10,216,579,972,393,12,12,496,496,0,0.00034037918240920387,0.0005105687736138058,660,718,58,3,4,4,4,5,543,688,878
385,14,220,611,974,363,16,16,525,525,0,0.000442492937131965,0.0016338200755641784,684,863,179,3,4,4,4,3,690,301,60
386,0,0,1,1,0,0,0,1,1,0,0.0,0.0,1,1,0,-1,-1,-1,16,0,26,611,868
387,0,102,1,934,933,0,4,1,365,364,0.0,0.00010211375472276115,1,479,478,4,-1,5,3,0,748,871,512
388,0,1640,1,1000,999,0,42,1,987,986,0.0,0.05156744613499439,1,998,997,1,-1,2,2,0,865,672,345
389,30,236,662,955,293,68,72,530,542,12,0.0004765308553728854,0.0007147962830593281,689,740,51,3,3,3,17,6,71,613,381
390,6,622,394,992,598,30,49,438,530,92,0.0,0.0007147962830593281,1,745,744,2,4,3,12,2,348,575,360
391,52,52,857,857,0,28,28,798,798,0,0.0014636304843595766,0.0014636304843595766,852,852,0,-1,3,3,3,12,903,67,455
392,16,632,639,997,358,32,56,733,907,174,0.0002042275094455223,0.0061949011198475104,579,966,387,2,3,3,5,1,765,667,6
393,0,0,1,1,0,0,0,1,1,0,0.0,0.0,1,1,0,-1,-1,-1,3,0,554,644,372
394,243,345,980,987,7,64,64,936,936,0,0.004833384390210695,0.005037611899656217,957,961,4,4,3,3,4,57,397,50,636
395,32,648,792,998,206,18,28,647,795,148,0.0006126825283365669,0.0035739814152966403,747,938,191,2,4,3,3,7,842,169,36
396,0,0,1,1,0,0,0,1,1,0,0.0,0.0,1,1,0,-1,-1,-1,3,0,883,923,914
397,0,101,1,920,919,0,3,1,331,330,0.0,0.0,1,1,0,8,-1,9,3,0,819,883,647
398,6,6,494,494,0,12,12,632,632,0,0.0002042275094455223,0.0002042275094455223,584,584,0,-1,4,4,2,1,919,601,921
399,22,638,634,991,357,33,64,549,734,185,0.00034037918240920387,0.00353994349705572,643,938,295,2,3,3,8,4,411,315,88
400,26,232,725,971,246,40,44,800,810,10,0.00034037918240920387,0.002723033459273631,654,911,257,3,3,3,4,6,759,107,111
401,1,207,332,971,639,3,9,332,452,120,0.0,0.000442492937131965,1,701,700,3,6,4,3,1,620,861,424
402,7,7,483,483,0,13,13,400,400,0,0.0,0.0,1,1,0,-1,4,4,7,2,182,694,918
403,139,139,945,945,0,60,60,891,891,0,0.002757071377514551,0.002757071377514551,918,918,0,-1,3,3,5,26,538,112,888
404,24,126,623,900,277,92,92,616,616,0,0.00030634126416828345,0.00037441710065012424,616,650,34,4,3,3,17,7,56,451,627
405,355,561,980,992,12,172,172,955,955,0,0.005173763572619898,0.005377991082065421,961,961,0,3,3,3,12,54,194,28,353
406,0,0,1,1,0,0,0,1,1,0,0.0,0.0,1,1,0,-1,-1,-1,2,0,586,816,808
407,0,0,1,1,0,0,0,1,1,0,0.0,0.0,1,1,0,-1,-1,-1,3,1,613,787,942
408,0,0,1,1,0,0,0,1,1,0,0.0,0.0,1,1,0,-1,-1,-1,2,0,979,760,984
409,14,220,542,956,414,78,78,686,686,0,0.00034037918240920387,0.0007147962830593281,643,747,104,3,4,4,13,3,113,280,453
410,35,137,694,912,218,88,88,592,592,0,0.0002723033459273631,0.00034037918240920387,602,638,36,4,3,3,17,7,71,188,652
411,0,101,1,918,917,0,4,1,331,330,0.0,3.4037918240920386e-05,1,411,410,5,-1,6,4,2,649,752,576
412,8,624,513,997,484,14,28,501,689,188,0.00013615167296368154,0.002212464685659825,520,897,377,2,4,3,3,3,634,441,15
413,26,26,773,773,0,20,20,794,794,0,0.000442492937131965,0.000442492937131965,692,692,0,-1,3,3,3,6,785,381,695
414,42,248,814,975,161,18,18,609,609,0,0.0010892133837094523,0.0025188059498281084,811,915,104,3,4,4,3,15,778,138,128
415,1,1,333,333,0,8,8,333,333,0,0.0,0.0,1,1,0,-1,7,7,8,2,418,448,908
416,3,209,450,981,531,3,8,377,521,144,0.0,0.0005786446100956465,1,746,745,3,5,4,2,5,957,225,306
417,5,5,427,427,0,7,7,376,376,0,0.0,0.0,1,1,0,-1,5,5,5,3,561,572,533
418,28,129,706,924,218,70,70,770,770,0,0.0005105687736138058,0.0005105687736138058,703,703,0,5,3,3,9,4,388,545,518
419,17,17,600,600,0,78,78,795,795,0,0.0011232513019503727,0.0011232513019503727,822,822,0,-1,3,3,8,3,411,299,786
420,0,101,1,906,905,0,5,1,332,331,0.0,3.4037918240920386e-05,1,404,403,5,-1,6,5,0,392,564,623
421,88,190,907,968,61,38,38,876,876,0,0.0015657442390823377,0.002212464685659825,870,901,31,4,3,3,3,17,801,79,78
422,89,89,863,863,0,156,156,947,947,0,0.0016678579938050988,0.0016678579938050988,857,857,0,-1,2,2,12,13,219,255,436
423,206,308,962,977,15,132,132,965,965,0,0.00616086320160659,0.0061949011198475104,968,969,1,4,2,2,8,31,646,34,373
424,16,222,650,975,325,22,22,633,633,0,0.00017018959120460194,0.000442492937131965,535,686,151,3,4,4,5,4,557,365,785
425,3,209,410,965,555,13,19,397,446,49,0.0,0.00037441710065012424,1,658,657,3,5,4,8,3,323,761,46
426,134,236,936,970,34,44,44,789,789,0,0.0019741992579733825,0.002212464685659825,880,894,14,4,3,3,4,20,567,95,124
427,0,0,1,1,0,0,0,1,1,0,0.0,0.0,1,1,0,-1,-1,-1,9,1,249,792,940
428,132,234,949,978,29,48,48,914,914,0,0.0033016780693692774,0.003437829742332959,938,940,2,4,3,3,3,27,484,69,584
429,0,206,1,957,956,0,19,1,433,432,0.0,0.0009530617107457708,1,789,788,3,-1,4,8,0,142,843,397
430,8,8,474,474,0,59,59,539,539,0,0.00013615167296368154,0.00013615167296368154,513,513,0,-1,4,4,14,4,108,270,348
431,0,102,1,912,911,0,6,1,389,388,0.0,0.0004084550188910446,1,674,673,4,-1,5,3,2,459,462,333
432,48,48,788,788,0,126,126,872,872,0,0.0006467204465774873,0.0006467204465774873,735,735,0,-1,2,2,12,5,106,619,517
433,916,1017,999,1000,1,168,168,997,997,0,0.022022533101875488,0.02219272269308009,994,994,0,5,2,2,6,130,387,3,484
434,2,2,357,357,0,6,6,358,358,0,0.0,0.0,1,1,0,-1,5,5,5,2,452,292,975
435,6,212,468,976,508,4,12,427,657,230,0.0002042275094455223,0.002757071377514551,575,923,348,3,5,4,2,3,705,93,105
436,2,2,364,364,0,6,6,449,449,0,3.4037918240920386e-05,3.4037918240920386e-05,400,400,0,-1,5,5,3,1,826,607,201
437,30,30,784,784,0,28,28,805,805,0,0.0009530617107457708,0.0009530617107457708,807,807,0,-1,3,3,3,8,844,264,767
438,0,0,1,1,0,0,0,1,1,0,0.0,0.0,1,1,0,-1,-1,-1,2,0,926,976,635
439,52,153,808,934,126,98,98,879,879,0,0.0006126825283365669,0.0006126825283365669,744,744,0,5,2,2,8,4,428,545,509
440,16,222,572,964,392,66,66,761,761,0,0.0006467204465774873,0.0018380475850097008,750,874,124,3,3,3,9,1,422,759,137
441,6,107,431,916,485,19,19,496,496,0,0.00013615167296368154,0.00017018959120460194,517,542,25,5,4,4,6,2,587,550,592
442,12,12,495,495,0,33,33,463,463,0,3.4037918240920386e-05,3.4037918240920386e-05,407,407,0,-1,4,4,11,3,66,829,685
443,9,111,542,917,375,18,20,486,496,10,0.00010211375472276115,0.00030634126416828345,493,640,147,4,4,4,6,3,402,526,510
444,6,622,421,995,574,23,60,468,735,267,3.4037918240920386e-05,0.0046972327172470135,401,955,554,2,4,3,8,2,428,560,20
445,58,58,851,851,0,30,30,704,704,0,0.0008169100377820892,0.0008169100377820892,791,791,0,-1,3,3,4,13,694,217,445
446,18,119,655,930,275,32,32,636,636,0,0.00037441710065012424,0.00037441710065012424,666,666,0,5,4,4,6,4,465,233,325
447,10,10,581,581,0,10,10,473,473,0,0.00013615167296368154,0.00013615167296368154,522,522,0,-1,4,4,3,3,585,596,271
448,18,120,676,946,270,20,20,663,663,0,0.0002042275094455223,0.0004084550188910446,575,684,109,4,4,4,4,6,610,494,613
449,0,0,1,1,0,0,0,1,1,0,0.0,0.0,1,1,0,-1,-1,-1,3,0,554,786,423
450,4,620,400,991,591,20,52,384,536,152,6.807583648184077e-05,0.0011913271384322134,446,821,375,2,5,3,13,3,90,411,139
451,0,101,1,955,954,0,3,1,331,330,0.0,0.0,1,1,0,5,-1,6,3,0,883,766,662
452,2,208,349,950,601,14,47,355,535,180,0.0,0.0009870996289866913,1,793,792,3,5,4,12,3,194,484,79
453,0,206,1,945,944,0,22,1,423,422,0.0,0.000442492937131965,1,674,673,3,-1,4,9,0,101,940,143
454,1,1,333,333,0,18,18,333,333,0,0.0,0.0,1,1,0,-1,6,6,18,2,34,582,732
455,0,0,1,1,0,0,0,1,1,0,0.0,0.0,1,1,0,-1,-1,-1,5,0,502,894,806
456,71,277,852,975,123,58,58,778,778,0,0.0012594029749140542,0.002552843868069029,830,910,80,3,3,3,7,11,505,97,89
457,57,159,853,965,112,40,40,832,832,0,0.0011232513019503727,0.0012934408931549745,826,841,15,4,3,3,5,11,744,97,720
458,43,43,713,713,0,116,116,634,634,0,0.0008169100377820892,0.0008169100377820892,748,748,0,-1,4,4,22,8,55,284,546
459,58,58,836,836,0,52,52,932,932,0,0.001940161339732462,0.001940161339732462,882,882,0,-1,2,2,3,4,837,333,877
460,63,269,808,963,155,144,144,852,852,0,0.0009870996289866913,0.0013615167296368155,792,833,41,3,3,3,14,9,121,415,386
461,48,254,829,977,148,30,34,704,750,46,0.0012934408931549745,0.004152626025392287,845,945,100,3,3,3,4,10,694,413,25
462,143,244,948,974,26,54,54,910,910,0,0.003437829742332959,0.003437829742332959,931,931,0,8,3,3,4,28,740,98,448
463,0,616,1,994,993,0,26,1,541,540,0.0,0.0008169100377820892,1,774,773,2,-1,3,6,0,432,863,700
464,0,206,1,971,970,0,18,1,527,526,0.0,0.002382654276864427,1,904,903,3,-1,4,5,0,533,751,111
465,0,206,1,953,952,0,30,1,452,451,0.0,0.0002382654276864427,1,592,591,3,-1,4,11,3,227,854,249
466,0,102,1,877,876,0,30,1,389,388,0.0,0.00013615167296368154,1,506,505,4,-1,5,17,1,80,513,317
467,6,622,431,998,567,19,38,496,694,198,3.4037918240920386e-05,0.0036760951700194017,404,937,533,2,4,3,6,2,587,575,142
468,6,212,491,978,487,12,24,522,744,222,0.00010211375472276115,0.0046972327172470135,490,954,464,3,4,4,4,1,789,720,70
469,122,122,913,913,0,124,124,941,941,0,0.002314578440382586,0.002314578440382586,904,904,0,-1,3,3,9,15,147,153,881
470,18,224,586,953,367,88,88,687,687,0,0.00017018959120460194,0.0006126825283365669,535,737,202,3,3,3,12,2,239,323,284
471,16,117,557,897,340,106,106,822,822,0,0.0006467204465774873,0.0006807583648184077,733,738,5,5,3,3,11,2,220,482,594
472,0,616,1,992,991,0,45,1,538,537,0.0,0.001055175465468532,1,806,805,2,-1,3,12,0,222,915,273
473,40,246,829,981,152,38,38,929,929,0,0.0012594029749140542,0.002825147213996392,842,913,71,3,3,3,3,6,856,490,81
474,88,189,886,959,73,70,70,912,912,0,0.002110350930937064,0.002110350930937064,896,896,0,5,3,3,5,15,338,151,721
475,46,46,855,855,0,18,18,800,800,0,0.0017359338302869397,0.0017359338302869397,886,886,0,-1,3,3,2,12,896,100,903
476,0,102,1,935,934,0,6,1,437,436,0.0,0.0006807583648184077,1,771,770,4,-1,5,3,0,530,984,138
477,14,14,590,590,0,15,15,440,440,0,6.807583648184077e-05,6.807583648184077e-05,447,447,0,-1,4,4,6,4,328,581,856
478,96,302,907,979,72,58,58,930,930,0,0.0027911092957554717,0.00442492937131965,915,948,33,3,2,2,4,20,736,87,36
479,2,208,359,960,601,7,14,359,438,79,0.0,0.0002382654276864427,1,592,591,3,5,4,6,3,419,181,634
480,10,111,618,947,329,12,12,649,649,0,0.00037441710065012424,0.0004084550188910446,654,670,16,5,4,4,2,7,838,451,585
481,16,117,542,895,353,92,92,673,673,0,0.00034037918240920387,0.00034037918240920387,638,638,0,6,3,3,14,1,332,689,582
482,6,6,437,437,0,18,18,605,605,0,0.00013615167296368154,0.00013615167296368154,516,516,0,-1,4,4,3,1,927,556,513
483,44,146,824,952,128,30,30,687,687,0,0.0009870996289866913,0.0010211375472276116,805,812,7,4,4,4,5,12,720,99,188
484,366,566,980,990,10,112,112,955,955,0,0.008713707069675619,0.009156200006807584,978,978,0,3,3,3,7,62,340,70,83
485,18,120,614,910,296,44,44,601,601,0,0.00013615167296368154,0.00034037918240920387,511,651,140,4,3,3,9,2,136,724,230
486,32,133,791,945,154,28,28,779,779,0,0.0007828721195411688,0.0007828721195411688,767,767,0,5,3,3,3,6,923,494,837
487,0,0,1,1,0,0,0,1,1,0,0.0,0.0,1,1,0,-1,-1,-1,17,0,39,801,753
488,0,206,1,945,944,0,32,1,420,419,0.0,0.00017018959120460194,1,533,532,3,-1,4,14,0,332,498,710
489,24,230,626,953,327,59,67,539,570,31,0.0006126825283365669,0.0009870996289866913,725,794,69,3,4,4,14,6,108,275,160
490,0,101,1,879,878,0,13,1,331,330,0.0,3.4037918240920386e-05,1,405,404,5,-1,6,13,0,228,757,739
491,0,101,1,887,886,0,9,1,330,329,0.0,0.0,1,1,0,5,-1,6,9,0,200,372,734
492,0,0,1,1,0,0,0,1,1,0,0.0,0.0,1,1,0,-1,-1,-1,6,0,267,898,431
493,0,0,1,1,0,0,0,1,1,0,0.0,0.0,1,1,0,-1,-1,-1,7,0,362,985,644
494,14,14,680,680,0,14,14,748,748,0,0.0004084550188910446,0.0004084550188910446,680,680,0,-1,4,4,3,5,877,221,843
495,49,665,870,1000,130,18,38,708,920,212,0.0020422750944552232,0.00878178290615746,894,978,84,2,4,3,3,17,485,60,112
496,0,206,1,975,974,0,10,1,500,499,0.0,0.00030634126416828345,1,644,643,3,-1,4,3,0,826,672,557
497,0,206,1,958,957,0,22,1,463,462,0.0,0.00030634126416828345,1,637,636,3,-1,4,7,0,193,902,286
498,12,12,587,587,0,20,20,588,588,0,0.0002382654276864427,0.0002382654276864427,613,613,0,-1,4,4,4,2,675,634,982
499,28,130,732,931,199,34,34,719,719,0,0.0004084550188910446,0.0005446066918547262,679,712,33,4,3,3,4,4,385,567,188
500,0,206,1,929,928,0,60,1,431,430,0.0,0.00013615167296368154,1,494,493,3,-1,4,24,0,28,922,655
501,119,220,956,981,25,22,22,828,828,0,0.004288777698355968,0.004322815616596889,951,953,2,5,3,3,2,31,874,34,152
502,81,81,866,866,0,46,46,746,746,0,0.0015657442390823377,0.0015657442390823377,854,854,0,-1,3,3,6,17,353,269,569
503,0,102,1,886,885,0,17,1,394,393,0.0,0.00017018959120460194,1,525,524,4,-1,5,9,0,262,927,681
504,2,2,417,417,0,4,4,508,508,0,0.00010211375472276115,0.00010211375472276115,496,496,0,-1,5,5,2,3,944,410,978
505,0,0,1,1,0,0,0,1,1,0,0.0,0.0,1,1,0,-1,-1,-1,5,0,326,774,632
506,27,128,777,953,176,18,18,776,776,0,0.0004084550188910446,0.0004765308553728854,682,701,19,5,3,3,2,6,609,368,646
507,0,101,1,958,957,0,3,1,330,329,0.0,0.0,1,1,0,5,-1,6,3,0,668,990,321
508,4,106,450,943,493,4,4,397,397,0,3.4037918240920386e-05,0.0002382654276864427,410,602,192,4,5,5,2,2,886,602,316
509,6,622,402,993,591,20,34,446,591,145,0.0,0.0012594029749140542,1,833,832,2,4,3,6,1,312,964,184
510,0,206,1,952,951,0,28,1,437,436,0.0,0.0002723033459273631,1,611,610,3,-1,4,10,0,285,820,827
511,0,102,1,931,930,0,8,1,443,442,0.0,0.0005105687736138058,1,707,706,4,-1,5,4,0,696,707,415
512,0,206,1,951,950,0,32,1,498,497,0.0,0.0008169100377820892,1,768,767,3,-1,4,8,0,370,988,393
513,74,176,896,970,74,28,28,797,797,0,0.0013615167296368155,0.0015317063208414173,848,860,12,4,3,3,3,17,901,96,501
514,0,102,1,899,898,0,7,1,354,353,0.0,0.0,1,1,0,4,-1,5,6,1,255,830,607
515,27,233,755,974,219,20,20,597,597,0,0.00088498587426393,0.0015657442390823377,789,856,67,3,4,4,4,8,735,204,184
516,0,616,1,998,997,0,25,1,768,767,0.0,0.004663194799006093,1,957,956,2,-1,3,4,0,491,643,411
517,26,232,653,955,302,82,82,620,620,0,0.000442492937131965,0.0007488342013002485,675,746,71,3,4,4,15,7,124,389,318
518,18,120,561,880,319,70,70,507,507,0,0.00013615167296368154,0.0002382654276864427,494,578,84,4,4,4,19,4,11,567,442
519,0,102,1,888,887,0,9,1,365,364,0.0,3.4037918240920386e-05,1,395,394,4,-1,5,7,0,182,565,579
520,0,0,1,1,0,0,0,1,1,0,0.0,0.0,1,1,0,-1,-1,-1,3,0,576,514,587
521,63,269,909,992,83,28,28,919,919,0,0.002484768031587188,0.0029612988869600733,906,922,16,3,3,3,3,23,918,122,491
522,90,192,870,953,83,60,60,724,724,0,0.002212464685659825,0.002314578440382586,891,896,5,4,3,3,9,18,395,171,416
523,2,2,384,384,0,3,3,391,391,0,0.00013615167296368154,0.00013615167296368154,532,532,0,-1,5,5,2,1,715,537,847
524,0,0,1,1,0,0,0,1,1,0,0.0,0.0,1,1,0,-1,-1,-1,5,0,463,971,768
525,24,230,732,976,244,40,40,823,823,0,0.0004084550188910446,0.0008509479560230097,675,793,118,3,3,3,5,3,663,318,658
526,0,102,1,914,913,0,3,1,354,353,0.0,0.00010211375472276115,1,496,495,4,-1,5,2,0,769,644,652
527,2,103,389,966,577,5,5,439,439,0,6.807583648184077e-05,6.807583648184077e-05,469,469,0,8,5,5,3,1,853,799,626
528,3,3,413,413,0,7,7,397,397,0,0.00010211375472276115,0.00010211375472276115,488,488,0,-1,5,5,4,3,632,761,538
529,16,222,636,971,335,22,26,654,712,58,0.0002382654276864427,0.0015317063208414173,599,861,262,3,3,3,4,1,969,837,95
530,101,101,913,913,0,46,46,759,759,0,0.0014295925661186562,0.0014295925661186562,851,851,0,-1,3,3,6,23,253,106,939
531,0,206,1,938,937,0,36,1,387,386,0.0,0.00017018959120460194,1,536,535,3,-1,4,20,0,61,522,468
532,2,104,374,934,560,4,5,375,409,34,0.0,0.0002382654276864427,1,599,598,4,5,5,3,1,856,734,487
533,6,107,435,912,477,22,22,574,574,0,6.807583648184077e-05,6.807583648184077e-05,451,451,0,6,4,4,5,1,669,661,181
534,30,132,723,924,201,42,42,694,694,0,0.0002723033459273631,0.00034037918240920387,602,646,44,4,3,3,6,4,255,557,506
535,29,29,770,770,0,40,40,794,794,0,0.0006126825283365669,0.0006126825283365669,736,736,0,-1,3,3,5,4,848,267,890
536,0,0,1,1,0,0,0,1,1,0,0.0,0.0,1,1,0,-1,-1,-1,7,1,658,650,917
537,0,0,1,1,0,0,0,1,1,0,0.0,0.0,1,1,0,-1,-1,-1,8,0,257,903,936
538,14,115,553,900,347,40,40,525,525,0,0.0002382654276864427,0.0002382654276864427,588,588,0,5,4,4,10,3,409,385,734
539,9,215,582,975,393,24,24,681,681,0,0.0002723033459273631,0.002723033459273631,606,911,305,3,4,4,4,5,617,722,13
540,6,108,429,925,496,18,18,522,522,0,0.0004084550188910446,0.0006807583648184077,673,745,72,4,4,4,5,1,561,500,722
541,0,0,1,1,0,0,0,1,1,0,0.0,0.0,1,1,0,-1,-1,-1,16,0,134,914,920
542,0,206,1,958,957,0,17,1,439,438,0.0,0.00034037918240920387,1,658,657,3,-1,4,7,0,466,802,379
543,6,622,422,996,574,17,44,442,689,247,0.0,0.0022465026039007454,1,897,896,2,4,3,7,2,359,575,213
544,0,616,1,992,991,0,122,1,668,667,0.0,0.002995336805200994,1,917,916,2,-1,3,21,0,12,839,112
545,2,208,350,958,608,15,36,370,510,140,3.4037918240920386e-05,0.0002042275094455223,399,559,160,3,5,4,11,2,176,495,541
546,87,87,909,909,0,32,32,860,860,0,0.002552843868069029,0.002552843868069029,912,912,0,-1,3,3,2,17,909,85,757
547,0,206,1,952,951,0,52,1,599,598,0.0,0.003880322679464924,1,942,941,3,-1,4,10,1,152,539,21
548,122,122,901,901,0,172,172,939,939,0,0.0018380475850097008,0.0018380475850097008,873,873,0,-1,2,2,13,13,242,261,826
549,150,356,966,991,25,46,46,971,971,0,0.00881582082439838,0.009258313761530345,980,982,2,3,2,2,2,32,849,26,351
550,8,110,516,920,404,11,11,445,445,0,3.4037918240920386e-05,0.00010211375472276115,410,485,75,4,4,4,4,3,622,585,408
551,86,86,911,911,0,38,38,894,894,0,0.0025188059498281084,0.0025188059498281084,910,910,0,-1,3,3,3,19,844,297,716
552,0,206,1,958,957,0,13,1,418,417,0.0,3.4037918240920386e-05,1,406,405,3,-1,4,6,0,425,968,714
553,9,111,550,924,374,12,12,496,496,0,0.00030634126416828345,0.0006807583648184077,623,737,114,4,4,4,4,4,520,278,46
554,16,222,633,973,340,30,30,733,733,0,0.0004084550188910446,0.0007147962830593281,695,768,73,3,3,3,4,1,542,420,306
555,30,236,791,979,188,28,28,791,791,0,0.0006807583648184077,0.002382654276864427,759,908,149,3,3,3,3,5,958,338,66
556,46,46,716,716,0,154,154,762,762,0,0.0004765308553728854,0.0004765308553728854,690,690,0,-1,2,2,19,2,11,323,811
557,44,44,814,814,0,60,60,876,876,0,0.0008509479560230097,0.0008509479560230097,782,782,0,-1,3,3,5,6,605,377,624
558,6,6,448,448,0,14,14,554,554,0,0.0,0.0,1,1,0,-1,4,4,3,2,801,419,803
559,9,111,523,906,383,22,22,465,465,0,0.00017018959120460194,0.00017018959120460194,551,551,0,4,4,4,7,3,179,385,734
560,6,108,443,928,485,12,12,472,472,0,0.0002042275094455223,0.0002042275094455223,567,567,0,4,4,4,4,1,659,537,714
561,6,6,471,471,0,12,12,671,671,0,0.0002042275094455223,0.0002042275094455223,574,574,0,-1,4,4,2,2,739,719,912
562,0,0,1,1,0,0,0,1,1,0,0.0,0.0,1,1,0,-1,-1,-1,4,1,633,747,943
563,14,630,566,996,430,44,54,621,716,95,0.00037441710065012424,0.0025188059498281084,661,909,248,2,4,3,8,3,297,507,87
564,0,101,1,932,931,0,2,1,332,331,0.0,0.00010211375472276115,1,492,491,5,-1,6,2,1,589,641,710
565,0,206,1,949,948,0,48,1,458,457,0.0,0.0005105687736138058,1,694,693,3,-1,4,17,0,23,201,172
566,10,112,578,928,350,12,12,567,567,0,0.00030634126416828345,0.0005105687736138058,626,720,94,4,4,4,2,4,905,230,239
567,0,0,1,1,0,0,0,1,1,0,0.0,0.0,1,1,0,-1,-1,-1,14,0,85,847,974
568,6,6,392,392,0,43,43,444,444,0,0.00010211375472276115,0.00010211375472276115,476,476,0,-1,4,4,17,1,71,592,906
569,35,35,689,689,0,100,100,734,734,0,0.000442492937131965,0.000442492937131965,672,672,0,-1,3,3,13,5,92,454,735
570,72,72,858,858,0,74,74,885,885,0,0.0024166921951053475,0.0024166921951053475,902,902,0,-1,2,2,7,7,264,396,801
571,27,27,781,781,0,18,18,657,657,0,0.00088498587426393,0.00088498587426393,805,805,0,-1,4,4,3,8,615,204,998
572,26,26,661,661,0,90,90,667,667,0,0.0004765308553728854,0.0004765308553728854,692,692,0,-1,3,3,14,4,144,328,959
573,24,230,626,951,325,90,90,618,618,0,0.0006467204465774873,0.0009190237925048504,730,783,53,3,3,3,16,3,117,236,486
574,10,111,562,927,365,11,11,455,455,0,6.807583648184077e-05,0.00017018959120460194,461,540,79,5,4,4,4,3,753,526,755
575,0,102,1,974,973,0,3,1,432,431,0.0,0.0006807583648184077,1,765,764,4,-1,5,2,0,973,614,414
576,0,101,1,939,938,0,2,1,331,330,0.0,0.0,1,1,0,6,-1,7,2,0,804,735,896
577,0,206,1,965,964,0,17,1,460,459,0.0,0.0011232513019503727,1,813,812,3,-1,4,7,0,482,968,49
578,2,104,362,920,558,8,8,412,412,0,0.00010211375472276115,0.00034037918240920387,474,634,160,4,5,5,4,1,832,862,316
579,22,228,611,952,341,58,62,568,589,21,0.00017018959120460194,0.0005446066918547262,539,714,175,3,4,4,13,6,91,486,519
580,57,263,844,974,130,42,46,728,770,42,0.0007147962830593281,0.002484768031587188,753,914,161,3,3,3,6,8,405,177,17
581,6,108,519,955,436,4,4,428,428,0,0.00030634126416828345,0.0005446066918547262,635,725,90,4,5,5,2,6,946,279,246
582,0,0,1,1,0,0,0,1,1,0,0.0,0.0,1,1,0,-1,-1,-1,3,0,621,733,735
583,43,249,825,976,151,24,24,739,739,0,0.0006467204465774873,0.0018040096667687805,745,874,129,3,3,3,3,11,621,52,157
584,1,207,333,974,641,4,20,333,609,276,0.0,0.0025188059498281084,1,905,904,3,6,4,4,4,659,595,76
585,0,101,1,980,979,0,2,1,329,328,0.0,0.00010211375472276115,1,508,507,5,-1,6,2,0,955,910,210
586,44,146,796,937,141,58,58,769,769,0,0.0009870996289866913,0.0012253650566731338,797,831,34,4,3,3,7,4,324,470,645
587,12,114,523,889,366,33,33,480,480,0,0.00010211375472276115,0.0002042275094455223,481,561,80,4,4,4,11,2,360,579,441
588,40,1680,720,1000,280,112,150,786,883,97,0.0007488342013002485,0.009224275843289425,752,975,223,1,2,2,14,1,268,711,179
589,0,102,1,930,929,0,5,1,371,370,0.0,0.00030634126416828345,1,643,642,4,-1,5,4,0,607,953,645
590,17,17,637,637,0,24,24,539,539,0,0.00010211375472276115,0.00010211375472276115,490,490,0,-1,4,4,6,5,267,528,533
591,6,108,452,931,479,20,20,597,597,0,0.00013615167296368154,0.00037441710065012424,511,660,149,4,4,4,4,1,735,718,353
592,0,616,1,998,997,0,32,1,763,762,0.0,0.004220701861874128,1,948,947,2,-1,3,5,0,663,732,77
593,2,104,352,892,540,11,12,352,360,8,0.0,0.0,1,1,0,4,5,5,10,1,258,861,761
594,4,106,400,898,498,14,14,406,406,0,6.807583648184077e-05,0.00010211375472276115,451,489,38,4,5,5,7,2,331,364,594
595,14,115,616,933,317,16,16,542,542,0,6.807583648184077e-05,6.807583648184077e-05,453,453,0,5,4,4,4,4,659,230,374
596,79,285,848,973,125,108,108,884,884,0,0.0016678579938050988,0.003369753905851118,865,934,69,3,2,2,9,9,159,240,89
597,724,724,995,995,0,160,160,961,961,0,0.013853432724054596,0.013853432724054596,986,986,0,-1,3,3,10,118,152,37,715
598,28,130,704,922,218,38,38,582,582,0,0.00017018959120460194,0.0002382654276864427,539,583,44,4,3,3,8,3,199,369,714
599,0,206,1,949,948,0,40,1,572,571,0.0,0.0015317063208414173,1,862,861,3,-1,4,8,0,483,686,123
600,0,616,1,988,987,0,114,1,606,605,0.0,0.0014636304843595766,1,851,850,2,-1,3,22,0,18,993,183
601,209,310,975,988,13,38,38,896,896,0,0.004220701861874128,0.004220701861874128,948,948,0,8,3,3,3,57,863,50,448
602,23,125,772,958,186,14,14,654,654,0,0.0006126825283365669,0.0009190237925048504,751,810,59,4,4,4,3,6,790,658,262
603,0,101,1,905,904,0,4,1,332,331,0.0,3.4037918240920386e-05,1,401,400,5,-1,6,4,0,500,372,601
604,303,404,989,995,6,32,32,943,943,0,0.01055175465468532,0.01055175465468532,983,983,0,5,3,3,2,78,938,9,606
605,30,132,734,929,195,48,48,702,702,0,0.0005105687736138058,0.0005786446100956465,699,721,22,4,3,3,7,9,450,341,149
606,64,680,814,994,180,168,168,903,903,0,0.0020082371762143027,0.003914360597705844,886,940,54,2,2,2,14,4,130,185,112
607,6,622,396,992,596,23,70,417,679,262,3.4037918240920386e-05,0.005071649817897137,405,958,553,2,4,3,10,3,114,755,12
608,14,116,669,957,288,12,12,657,657,0,0.0002042275094455223,0.00037441710065012424,585,663,78,4,4,4,2,5,942,221,236
609,6,6,452,452,0,9,9,469,469,0,0.0,0.0,1,1,0,-1,4,4,3,1,337,623,455
610,28,28,651,651,0,110,110,762,762,0,0.000442492937131965,0.000442492937131965,681,681,0,-1,3,3,14,4,108,336,902
611,6,212,396,950,554,30,42,422,482,60,0.0,0.00010211375472276115,1,475,474,3,4,4,13,1,67,463,541
612,195,195,946,946,0,152,152,966,966,0,0.004016474352428605,0.004016474352428605,937,937,0,-1,2,2,9,21,202,123,456
613,2,2,352,352,0,20,20,352,352,0,0.0,0.0,1,1,0,-1,5,5,19,1,38,140,778
614,200,816,940,995,55,222,222,924,924,0,0.002144388849177984,0.007726607440688927,890,966,76,2,2,2,18,27,111,61,18
615,54,156,876,968,92,22,22,795,795,0,0.0012594029749140542,0.0013955546478777359,847,862,15,4,3,3,2,14,747,139,634
616,10,216,631,982,351,12,12,720,720,0,0.0007828721195411688,0.0013955546478777359,776,855,79,3,4,4,2,4,851,312,390
617,6,6,440,440,0,11,11,452,452,0,3.4037918240920386e-05,3.4037918240920386e-05,411,411,0,-1,4,4,4,1,690,506,571
618,0,0,1,1,0,0,0,1,1,0,0.0,0.0,1,1,0,-1,-1,-1,2,0,747,890,804
619,12,113,638,945,307,18,18,669,669,0,0.00030634126416828345,0.00030634126416828345,640,640,0,6,4,4,3,6,835,107,692
620,0,206,1,954,953,0,60,1,583,582,0.0,0.003199564314646516,1,933,932,3,-1,4,12,0,226,673,50
621,16,222,519,951,432,90,98,586,619,33,0.00013615167296368154,0.0005105687736138058,512,694,182,3,3,3,18,1,64,561,283
622,8,624,514,996,482,24,34,636,730,94,0.00017018959120460194,0.0061949011198475104,543,968,425,2,4,3,4,3,759,263,70
623,46,46,751,751,0,146,146,807,807,0,0.0005105687736138058,0.0005105687736138058,694,694,0,-1,3,3,16,9,151,145,910
624,0,206,1,959,958,0,28,1,510,509,0.0,0.0012934408931549745,1,841,840,3,-1,4,8,1,260,949,180
625,6,6,417,417,0,50,50,645,645,0,0.00010211375472276115,0.00010211375472276115,492,492,0,-1,4,4,9,1,190,282,892
626,162,162,934,934,0,130,130,901,901,0,0.002723033459273631,0.002723033459273631,915,915,0,-1,3,3,10,25,285,47,698
627,5,107,466,936,470,8,8,442,442,0,3.4037918240920386e-05,0.0002723033459273631,397,622,225,4,5,5,4,3,581,214,453
628,6,212,444,973,529,7,7,451,451,0,0.00010211375472276115,0.0004765308553728854,478,705,227,3,4,4,2,1,990,601,700
629,42,42,821,821,0,34,34,802,802,0,0.0007488342013002485,0.0007488342013002485,761,761,0,-1,3,3,4,8,787,187,747
630,56,672,799,994,195,92,96,742,753,11,0.0006467204465774873,0.0033357159876101976,737,937,200,2,3,3,11,7,188,253,27
631,0,102,1,959,958,0,4,1,390,389,0.0,0.00010211375472276115,1,493,492,4,-1,5,3,0,852,845,557
632,2,2,403,403,0,4,4,496,496,0,6.807583648184077e-05,6.807583648184077e-05,455,455,0,-1,5,5,2,1,872,527,778
633,38,38,730,730,0,62,62,678,678,0,0.0005105687736138058,0.0005105687736138058,705,705,0,-1,3,3,10,7,272,237,998
634,0,101,1,935,934,0,3,1,332,331,0.0,0.0,1,1,0,5,-1,6,3,0,770,847,853
635,1,1,333,333,0,2,2,333,333,0,0.0,0.0,1,1,0,-1,6,6,2,2,807,764,728
636,0,206,1,958,957,0,32,1,487,486,0.0,0.0007828721195411688,1,765,764,3,-1,4,10,0,409,858,125
637,71,277,875,980,105,38,38,870,870,0,0.0014636304843595766,0.002382654276864427,862,907,45,3,3,3,3,15,672,62,174
638,2,208,369,972,603,10,26,428,642,214,6.807583648184077e-05,0.007147962830593281,439,971,532,3,5,4,5,1,720,531,1
639,16,118,599,928,329,34,34,684,684,0,0.00037441710065012424,0.0006807583648184077,649,751,102,4,3,3,6,2,515,652,645
640,6,108,491,950,459,12,12,668,668,0,0.00017018959120460194,0.0005446066918547262,550,711,161,4,4,4,2,1,618,667,422
641,16,16,560,560,0,54,54,590,590,0,0.0002382654276864427,0.0002382654276864427,566,566,0,-1,4,4,11,5,215,350,747
642,0,0,1,1,0,0,0,1,1,0,0.0,0.0,1,1,0,-1,-1,-1,6,1,560,235,926
643,0,102,1,885,884,0,15,1,373,372,0.0,0.0002723033459273631,1,602,601,4,-1,5,10,0,82,918,653
644,0,0,1,1,0,0,0,1,1,0,0.0,0.0,1,1,0,-1,-1,-1,2,1,469,835,934
645,8,8,523,523,0,18,18,586,586,0,0.0002723033459273631,0.0002723033459273631,612,612,0,-1,4,4,3,2,490,700,940
646,0,102,1,896,895,0,21,1,412,411,0.0,0.00013615167296368154,1,499,498,4,-1,5,11,0,271,996,101
647,1,207,333,945,612,18,47,333,456,123,0.0,0.0005786446100956465,1,718,717,3,6,4,18,1,34,671,283
648,18,18,617,617,0,40,40,626,626,0,0.00013615167296368154,0.00013615167296368154,520,520,0,-1,3,3,7,4,591,270,455
649,0,101,1,917,916,0,5,1,332,331,0.0,0.00010211375472276115,1,500,499,5,-1,6,5,0,688,938,580
650,0,102,1,934,933,0,5,1,368,367,0.0,3.4037918240920386e-05,1,388,387,4,-1,5,4,3,721,753,547
651,0,102,1,889,888,0,16,1,379,378,0.0,6.807583648184077e-05,1,446,445,4,-1,5,11,3,379,882,229
652,0,0,1,1,0,0,0,1,1,0,0.0,0.0,1,1,0,-1,-1,-1,3,0,857,886,745
653,49,49,780,780,0,72,72,703,703,0,0.0006467204465774873,0.0006467204465774873,739,739,0,-1,3,3,10,8,128,284,446
654,48,48,845,845,0,38,38,909,909,0,0.0016678579938050988,0.0016678579938050988,875,875,0,-1,3,3,3,6,882,397,905
655,66,66,873,873,0,22,22,722,722,0,0.0013274788113958951,0.0013274788113958951,851,851,0,-1,3,3,2,17,909,180,971
656,17,223,678,973,295,16,20,552,624,72,0.0005786446100956465,0.002757071377514551,734,917,183,3,4,4,4,6,635,467,123
657,0,0,1,1,0,0,0,1,1,0,0.0,0.0,1,1,0,-1,-1,-1,8,0,350,629,917
658,58,159,897,974,77,28,28,859,859,0,0.003369753905851118,0.003369753905851118,935,935,0,6,3,3,3,12,576,104,543
659,12,12,498,498,0,52,52,510,510,0,0.00013615167296368154,0.00013615167296368154,506,506,0,-1,4,4,14,2,121,491,633
660,2,208,352,948,596,24,76,382,592,210,0.0,0.0026209197045508697,1,906,905,3,5,4,16,3,78,460,56
661,0,102,1,909,908,0,7,1,349,348,0.0,0.00010211375472276115,1,477,476,4,-1,5,6,0,341,941,537
662,34,136,759,925,166,48,48,762,762,0,0.0005105687736138058,0.0007488342013002485,704,763,59,4,3,3,6,5,630,688,584
663,1,617,332,999,667,2,18,332,814,482,0.0,0.005718370264474625,1,969,968,2,7,3,2,2,841,448,46
664,0,206,1,953,952,0,26,1,454,453,0.0,0.0008509479560230097,1,772,771,3,-1,4,9,0,140,820,386
665,24,126,680,925,245,40,40,610,610,0,0.0013955546478777359,0.00176997174852786,845,872,27,4,4,4,8,8,146,264,204
666,0,0,1,1,0,0,0,1,1,0,0.0,0.0,1,1,0,-1,-1,-1,15,2,51,709,356
667,18,119,621,921,300,48,48,668,668,0,0.00030634126416828345,0.00030634126416828345,627,627,0,5,4,4,8,3,350,318,460
668,0,101,1,935,934,0,3,1,331,330,0.0,0.00010211375472276115,1,496,495,5,-1,6,3,0,564,932,550
669,107,313,935,987,52,22,22,760,760,0,0.0020763130126961434,0.003437829742332959,889,929,40,3,3,3,2,23,643,106,203
670,7,109,506,915,409,24,24,544,544,0,0.00013615167296368154,0.0002382654276864427,502,589,87,4,4,4,6,3,441,631,719
671,22,228,774,984,210,14,14,736,736,0,0.0005446066918547262,0.0017359338302869397,737,878,141,3,4,4,3,6,918,232,203
672,1,1,333,333,0,6,6,333,333,0,0.0,0.0,1,1,0,-1,8,8,6,1,295,647,472
673,8,8,458,458,0,43,43,408,408,0,0.0,0.0,1,1,0,-1,4,4,21,5,13,476,882
674,0,0,1,1,0,0,0,1,1,0,0.0,0.0,1,1,0,-1,-1,-1,2,0,978,716,947
675,100,100,886,886,0,100,100,896,896,0,0.026039007454304094,0.02729841042921815,999,999,0,3,1,1,9,81,388,32,53
676,18,224,652,972,320,24,24,542,542,0,0.0002382654276864427,0.0006807583648184077,582,754,172,3,4,4,6,3,275,677,454
677,129,129,917,917,0,108,108,911,911,0,0.0022465026039007454,0.0022465026039007454,892,892,0,-1,2,2,9,17,289,131,969
678,117,218,949,975,26,32,32,916,916,0,0.003982436434187685,0.003982436434187685,939,939,0,5,3,3,2,28,849,41,421
679,12,113,553,913,360,14,14,453,453,0,0.00017018959120460194,0.00017018959120460194,545,545,0,5,4,4,5,4,377,210,654
680,0,102,1,947,946,0,3,1,372,371,0.0,3.4037918240920386e-05,1,399,398,4,-1,5,2,0,841,740,313
681,0,102,1,921,920,0,9,1,421,420,0.0,0.00037441710065012424,1,664,663,4,-1,5,5,0,612,758,490
682,0,102,1,925,924,0,9,1,411,410,0.0,0.0005786446100956465,1,740,739,4,-1,5,5,1,533,767,386
683,24,24,805,805,0,12,12,692,692,0,0.0012594029749140542,0.0012594029749140542,851,851,0,-1,4,4,2,10,751,227,511
684,1,1,333,333,0,7,7,333,333,0,0.0,0.0,1,1,0,-1,6,6,7,2,450,692,620
685,54,54,773,773,0,164,164,831,831,0,0.0007147962830593281,0.0007147962830593281,742,742,0,-1,3,3,18,5,111,178,511
686,0,616,1,992,991,0,34,1,506,505,0.0,0.0006807583648184077,1,734,733,2,-1,3,10,0,254,731,362
687,14,14,588,588,0,28,28,526,526,0,0.00017018959120460194,0.00017018959120460194,535,535,0,-1,4,4,8,3,286,248,445
688,68,170,853,951,98,72,72,832,832,0,0.0020082371762143027,0.002212464685659825,891,897,6,4,3,3,7,12,171,100,465
689,94,196,868,951,83,82,82,738,738,0,0.00176997174852786,0.002144388849177984,874,894,20,4,3,3,11,11,224,166,145
690,0,206,1,968,967,0,14,1,501,500,0.0,0.0005105687736138058,1,708,707,3,-1,4,3,0,725,778,148
691,48,48,834,834,0,40,40,776,776,0,0.0009870996289866913,0.0009870996289866913,810,810,0,-1,3,3,5,13,551,120,769
692,2,104,362,915,553,7,11,363,420,57,0.0,0.00030634126416828345,1,636,635,4,5,5,6,3,764,460,167
693,16,16,522,522,0,84,84,655,655,0,0.0002382654276864427,0.0002382654276864427,577,577,0,-1,3,3,13,2,92,493,715
694,103,309,896,975,79,88,88,904,904,0,0.002723033459273631,0.0033357159876101976,910,926,16,3,3,3,8,15,541,36,234
695,58,58,872,872,0,34,34,824,824,0,0.002280540522141666,0.002280540522141666,900,900,0,-1,3,3,4,12,607,104,835
696,29,131,738,937,199,26,26,616,616,0,0.0005786446100956465,0.0007828721195411688,719,764,45,4,4,4,5,10,605,366,188
697,0,102,1,880,879,0,19,1,372,371,0.0,3.4037918240920386e-05,1,412,411,4,-1,5,15,0,138,812,361
698,118,118,937,937,0,44,44,869,869,0,0.002927260968719153,0.002927260968719153,923,923,0,-1,3,3,4,22,578,128,860
699,14,14,507,507,0,86,86,612,612,0,0.0005446066918547262,0.0005446066918547262,699,699,0,-1,4,4,17,3,80,507,728
700,0,206,1,967,966,0,10,1,456,455,0.0,0.0012253650566731338,1,838,837,3,-1,4,3,0,687,824,116
701,31,133,847,976,129,8,8,638,638,0,0.0009530617107457708,0.0013615167296368155,814,854,40,4,4,4,2,18,933,148,405
702,18,18,702,702,0,14,14,623,623,0,0.0005446066918547262,0.0005446066918547262,726,726,0,-1,4,4,3,6,953,46,969
703,2,208,354,948,594,20,29,374,409,35,6.807583648184077e-05,0.0002042275094455223,446,554,108,3,5,4,15,2,68,764,958
704,6,212,397,948,551,27,31,427,453,26,3.4037918240920386e-05,0.00034037918240920387,397,639,242,3,4,4,12,2,292,560,198
705,0,206,1,969,968,0,9,1,449,448,0.0,0.00037441710065012424,1,664,663,3,-1,4,3,0,490,629,309
706,9,9,573,573,0,10,10,484,484,0,0.00010211375472276115,0.00010211375472276115,485,485,0,-1,4,4,3,3,831,369,709
707,0,0,1,1,0,0,0,1,1,0,0.0,0.0,1,1,0,-1,-1,-1,2,0,817,999,933
708,189,290,988,996,8,22,22,920,920,0,0.008271214132543654,0.008271214132543654,978,978,0,6,3,3,2,70,941,18,639
709,0,206,1,958,957,0,28,1,464,463,0.0,0.00030634126416828345,1,622,621,3,-1,4,10,0,409,997,418
710,143,245,927,971,44,136,136,971,971,0,0.004118588107151367,0.004493005207801491,946,953,7,4,2,2,8,20,218,87,195
711,24,230,674,966,292,44,48,655,680,25,0.0007147962830593281,0.0009530617107457708,753,798,45,3,3,3,7,6,171,447,263
712,0,206,1,952,951,0,24,1,421,420,0.0,0.00034037918240920387,1,640,639,3,-1,4,11,0,230,938,683
713,0,101,1,869,868,0,17,1,331,330,0.0,0.0,1,1,0,5,-1,6,17,1,103,947,781
714,12,114,573,927,354,14,14,558,558,0,0.00013615167296368154,0.0006807583648184077,520,764,244,4,4,4,3,2,726,586,245
715,0,0,1,1,0,0,0,1,1,0,0.0,0.0,1,1,0,-1,-1,-1,6,0,322,815,713
716,35,35,824,824,0,18,18,803,803,0,0.0013955546478777359,0.0013955546478777359,853,853,0,-1,3,3,2,10,960,413,953
717,52,258,824,973,149,40,40,727,727,0,0.0014295925661186562,0.0016338200755641784,846,863,17,3,3,3,5,9,506,130,404
718,103,309,897,974,77,108,108,921,921,0,0.0037441710065012424,0.003914360597705844,933,935,2,3,2,2,9,9,250,277,350
719,34,136,751,927,176,34,34,679,679,0,0.0006126825283365669,0.0006807583648184077,742,757,15,4,3,3,4,5,493,338,110
720,0,616,1,987,986,0,110,1,619,618,0.0,0.002212464685659825,1,884,883,2,-1,3,22,1,55,705,158
721,6,6,380,380,0,38,38,448,448,0,3.4037918240920386e-05,3.4037918240920386e-05,397,397,0,-1,4,4,13,1,115,322,533
722,16,16,519,519,0,80,80,555,555,0,0.00030634126416828345,0.00030634126416828345,616,616,0,-1,4,4,18,4,64,365,571
723,10,10,573,573,0,16,16,477,477,0,0.0,0.0,1,1,0,-1,4,4,6,3,657,704,751
724,40,142,807,941,134,26,26,721,721,0,0.0008509479560230097,0.0009870996289866913,789,810,21,4,3,3,4,6,401,194,958
725,0,0,1,1,0,0,0,1,1,0,0.0,0.0,1,1,0,-1,-1,-1,19,0,14,445,875
726,153,359,939,980,41,108,108,936,936,0,0.002110350930937064,0.002552843868069029,888,909,21,3,3,3,8,24,142,129,700
727,6,622,395,992,597,33,48,467,555,88,0.0,0.001497668402600497,1,853,852,2,4,3,11,1,220,506,232
728,0,0,1,1,0,0,0,1,1,0,0.0,0.0,1,1,0,-1,-1,-1,4,2,491,775,498
729,0,102,1,885,884,0,10,1,349,348,0.0,3.4037918240920386e-05,1,395,394,4,-1,5,9,0,414,429,265
730,0,0,1,1,0,0,0,1,1,0,0.0,0.0,1,1,0,-1,-1,-1,3,0,590,483,668
731,51,51,830,830,0,60,60,861,861,0,0.0008509479560230097,0.0008509479560230097,795,795,0,-1,3,3,5,5,382,216,971
732,2,208,396,986,590,4,8,444,590,146,6.807583648184077e-05,0.00034037918240920387,447,656,209,3,5,4,2,2,968,532,268
733,1,617,333,998,665,3,28,333,754,421,0.0,0.007862759113652609,1,977,976,2,6,3,3,1,869,788,24
734,0,102,1,915,914,0,6,1,388,387,0.0,0.00010211375472276115,1,482,481,4,-1,5,3,0,490,915,259
735,13,219,581,966,385,20,24,498,552,54,0.0002042275094455223,0.0016678579938050988,579,870,291,3,4,4,6,4,251,278,104
736,0,102,1,907,906,0,12,1,385,384,0.0,0.00017018959120460194,1,529,528,4,-1,5,7,0,324,782,505
737,6,6,525,525,0,4,4,446,446,0,0.0002042275094455223,0.0002042275094455223,588,588,0,-1,5,5,2,3,666,677,920
738,334,540,981,993,12,182,182,992,992,0,0.007522379931243405,0.008713707069675619,971,977,6,3,2,2,9,54,422,28,193
739,39,140,870,973,103,12,12,745,745,0,0.0010892133837094523,0.0010892133837094523,829,829,0,6,4,4,2,17,950,269,590
740,0,206,1,949,948,0,71,1,546,545,0.0,0.0010211375472276116,1,800,799,3,-1,4,16,0,26,446,179
741,8,110,509,916,407,18,18,491,491,0,0.00010211375472276115,0.0004084550188910446,487,679,192,4,4,4,6,3,275,585,516
742,6,212,427,963,536,22,26,498,533,35,0.00010211375472276115,0.0010211375472276116,484,803,319,3,4,4,7,1,505,718,60
743,18,224,642,968,326,36,36,696,696,0,0.0002382654276864427,0.0004084550188910446,592,674,82,3,3,3,5,3,492,263,317
744,2,618,348,991,643,27,132,382,782,400,0.0,0.006467204465774873,1,963,962,2,5,3,16,3,27,755,6
745,16,117,588,907,319,62,62,769,769,0,0.0007147962830593281,0.0007147962830593281,756,756,0,5,3,3,7,1,321,404,181
746,28,28,756,756,0,32,32,877,877,0,0.0009190237925048504,0.0009190237925048504,801,801,0,-1,3,3,2,5,905,273,882
747,0,0,1,1,0,0,0,1,1,0,0.0,0.0,1,1,0,-1,-1,-1,2,0,816,836,817
748,0,206,1,974,973,0,11,1,499,498,0.0,0.0004765308553728854,1,707,706,3,-1,4,4,0,721,981,371
749,7,7,640,640,0,4,4,515,515,0,0.0005446066918547262,0.0005446066918547262,740,740,0,-1,5,5,2,7,956,170,665
750,0,616,1,991,990,0,54,1,588,587,0.0,0.0014295925661186562,1,844,843,2,-1,3,10,0,240,793,95
751,1,103,331,913,582,6,9,331,385,54,0.0,0.00037441710065012424,1,669,668,4,6,5,6,2,522,692,170
752,10,10,527,527,0,42,42,578,578,0,0.0002723033459273631,0.0002723033459273631,616,616,0,-1,4,4,9,5,136,395,520
753,18,18,686,686,0,21,21,664,664,0,0.000442492937131965,0.000442492937131965,692,692,0,-1,3,3,4,2,787,602,910
754,0,102,1,946,945,0,4,1,416,415,0.0,0.0005105687736138058,1,715,714,4,-1,5,2,0,979,620,545
755,6,622,424,995,571,24,34,524,644,120,0.00013615167296368154,0.002212464685659825,509,893,384,2,4,3,6,2,328,384,465
756,19,121,635,922,287,44,44,655,655,0,0.00017018959120460194,0.0004084550188910446,528,666,138,4,3,3,7,6,171,392,677
757,15,15,640,640,0,18,18,542,542,0,0.00013615167296368154,0.00013615167296368154,523,523,0,-1,4,4,5,4,612,380,686
758,0,102,1,933,932,0,5,1,366,365,0.0,0.0004084550188910446,1,682,681,4,-1,5,4,0,679,802,516
759,19,121,736,957,221,7,7,529,529,0,0.0007147962830593281,0.0008169100377820892,777,791,14,4,4,4,2,7,821,396,380
760,7,108,596,965,369,4,4,487,487,0,0.0002042275094455223,0.00034037918240920387,589,665,76,5,5,5,2,4,981,380,214
761,1,207,333,948,615,14,33,333,441,108,0.0,3.4037918240920386e-05,1,387,386,3,6,4,14,2,172,344,237
762,1,617,333,993,660,11,52,333,582,249,0.0,0.0020422750944552232,1,883,882,2,6,3,11,1,229,640,119
763,7,108,568,950,382,14,14,638,638,0,0.00034037918240920387,0.00037441710065012424,661,672,11,5,4,4,3,3,911,354,879
764,18,18,623,623,0,46,46,670,670,0,0.0004765308553728854,0.0004765308553728854,703,703,0,-1,3,3,8,2,468,700,828
765,0,206,1,981,980,0,12,1,681,680,0.0,0.005956635692161067,1,959,958,3,-1,4,2,0,715,826,6
766,0,616,1,991,990,0,59,1,572,571,0.0,0.002212464685659825,1,888,887,2,-1,3,13,0,228,794,113
767,87,87,882,882,0,80,80,920,920,0,0.0018040096667687805,0.0018040096667687805,868,868,0,-1,2,2,6,14,387,243,824
768,7,7,492,492,0,21,21,466,466,0,0.0,0.0,1,1,0,-1,4,4,7,3,374,373,731
769,10,10,510,510,0,42,42,498,498,0,0.00013615167296368154,0.00013615167296368154,506,506,0,-1,4,4,13,3,113,536,488
770,24,230,722,977,255,18,18,647,647,0,0.0009530617107457708,0.0020763130126961434,808,892,84,3,4,4,3,6,829,658,82
771,14,1654,512,1000,488,53,91,493,645,152,0.00017018959120460194,0.007522379931243405,534,970,436,1,4,2,15,4,49,332,384
772,0,102,1,909,908,0,7,1,389,388,0.0,0.00010211375472276115,1,488,487,4,-1,5,4,0,572,871,688
773,0,206,1,973,972,0,14,1,600,599,0.0,0.0015317063208414173,1,866,865,3,-1,4,3,0,683,943,15
774,20,20,656,656,0,24,24,528,528,0,0.0004084550188910446,0.0004084550188910446,667,667,0,-1,4,4,6,4,419,504,834
775,2,2,387,387,0,3,3,392,392,0,0.0,0.0,1,1,0,-1,5,5,2,2,868,842,867
776,255,855,976,999,23,66,66,876,876,0,0.004152626025392287,0.009360427516253106,945,979,34,2,3,3,6,57,253,50,32
777,100,100,885,885,0,100,100,899,899,0,0.04077742605262262,0.04077742605262262,1000,1000,0,4,1,1,8,157,428,2,503
778,106,706,881,993,112,150,150,861,861,0,0.0014295925661186562,0.002757071377514551,846,917,71,2,3,3,15,13,45,261,60
779,0,102,1,923,922,0,10,1,403,402,0.0,0.0002042275094455223,1,583,582,4,-1,5,6,1,657,456,90
780,30,30,664,664,0,82,82,599,599,0,0.0002723033459273631,0.0002723033459273631,600,600,0,-1,3,3,16,5,145,350,731
781,0,616,1,998,997,0,24,1,784,783,0.0,0.003267640151128357,1,935,934,2,-1,3,3,0,530,937,117
782,79,79,832,832,0,202,202,918,918,0,0.0009530617107457708,0.0009530617107457708,796,796,0,-1,2,2,16,5,27,165,804
783,74,176,840,936,96,114,114,856,856,0,0.001055175465468532,0.0013274788113958951,799,828,29,4,2,2,12,5,184,308,250
784,48,48,782,782,0,66,66,684,684,0,0.0005105687736138058,0.0005105687736138058,697,697,0,-1,3,3,10,9,254,154,982
785,18,18,652,652,0,26,26,639,639,0,0.00013615167296368154,0.00013615167296368154,516,516,0,-1,4,4,5,4,284,233,995
786,2,2,353,353,0,12,12,366,366,0,0.0,0.0,1,1,0,-1,5,5,9,1,269,593,472
787,7,109,526,932,406,12,13,461,468,7,3.4037918240920386e-05,0.00017018959120460194,409,556,147,4,4,4,5,5,688,225,409
788,6,108,439,917,478,16,16,515,515,0,0.00030634126416828345,0.0006126825283365669,632,737,105,4,4,4,4,1,622,741,869
789,6,212,444,970,526,14,22,466,555,89,0.0,0.0007147962830593281,1,758,757,3,4,4,5,2,724,342,642
790,0,101,1,926,925,0,5,1,332,331,0.0,0.0,1,1,0,6,-1,7,5,1,601,738,595
791,3,3,430,430,0,10,10,455,455,0,0.00013615167296368154,0.00013615167296368154,521,521,0,-1,5,5,5,3,376,631,478
792,519,725,992,997,5,160,160,988,988,0,0.01147077844719017,0.012083460975526737,985,987,2,3,2,2,7,81,417,32,154
793,0,206,1,983,982,0,9,1,560,559,0.0,0.0004765308553728854,1,717,716,3,-1,4,3,0,915,906,302
794,28,234,710,969,259,54,54,702,702,0,0.00030634126416828345,0.000442492937131965,635,691,56,3,3,3,8,3,420,318,720
795,21,21,766,766,0,12,12,666,666,0,0.00030634126416828345,0.00030634126416828345,647,647,0,-1,4,4,2,7,548,303,513
796,6,108,424,916,492,15,15,416,416,0,6.807583648184077e-05,0.00017018959120460194,445,539,94,4,5,5,8,3,158,534,505
797,56,158,804,931,127,106,106,819,819,0,0.0015317063208414173,0.0015317063208414173,850,850,0,4,3,3,11,8,163,174,342
798,44,44,798,798,0,36,36,736,736,0,0.0004084550188910446,0.0004084550188910446,680,680,0,-1,3,3,5,6,692,107,511
799,0,0,1,1,0,0,0,1,1,0,0.0,0.0,1,1,0,-1,-1,-1,10,0,161,849,790
800,0,0,1,1,0,0,0,1,1,0,0.0,0.0,1,1,0,-1,-1,-1,4,0,391,911,779
801,2,104,361,923,562,8,10,387,419,32,0.0,0.00013615167296368154,1,526,525,4,5,5,5,2,294,495,389
802,0,0,1,1,0,0,0,1,1,0,0.0,0.0,1,1,0,-1,-1,-1,30,0,7,915,802
803,0,102,1,893,892,0,10,1,378,377,0.0,6.807583648184077e-05,1,437,436,4,-1,5,6,0,514,712,468
804,74,176,849,950,101,78,78,836,836,0,0.0016678579938050988,0.0016678579938050988,867,867,0,4,3,3,8,18,282,64,314
805,24,24,759,759,0,18,18,664,664,0,0.0004765308553728854,0.0004765308553728854,700,700,0,-1,4,4,3,5,568,178,517
806,0,206,1,971,970,0,14,1,519,518,0.0,0.000442492937131965,1,698,697,3,-1,4,3,0,834,979,266
807,32,32,788,788,0,24,24,675,675,0,0.001157289220191293,0.001157289220191293,828,828,0,-1,4,4,4,14,787,190,948
808,18,18,662,662,0,24,24,631,631,0,0.0005105687736138058,0.0005105687736138058,709,709,0,-1,4,4,4,8,532,521,849
809,0,102,1,930,929,0,6,1,393,392,0.0,0.0002723033459273631,1,617,616,4,-1,5,4,0,507,511,280
810,0,0,1,1,0,0,0,1,1,0,0.0,0.0,1,1,0,-1,-1,-1,4,0,313,863,768
811,1,207,333,956,623,11,32,333,475,142,0.0,0.0005446066918547262,1,707,706,3,6,4,11,1,234,437,143
812,35,35,777,777,0,56,56,841,841,0,0.0009870996289866913,0.0009870996289866913,802,802,0,-1,3,3,6,8,455,204,925
813,0,102,1,900,899,0,10,1,409,408,0.0,0.0002723033459273631,1,615,614,4,-1,5,5,0,571,423,291
814,56,56,897,897,0,22,22,826,826,0,0.0026209197045508697,0.0026209197045508697,922,922,0,-1,3,3,2,15,851,151,849
815,9,625,564,998,434,14,28,480,700,220,0.00017018959120460194,0.003437829742332959,539,931,392,2,4,3,5,5,463,722,734
816,6,212,437,970,533,18,22,497,548,51,0.0004084550188910446,0.00088498587426393,667,785,118,3,4,4,5,1,528,869,452
817,3,3,459,459,0,4,4,419,419,0,3.4037918240920386e-05,3.4037918240920386e-05,412,412,0,-1,5,5,2,3,897,373,806
818,0,102,1,905,904,0,11,1,390,389,0.0,0.00034037918240920387,1,657,656,4,-1,5,7,0,637,750,391
819,0,102,1,885,884,0,12,1,361,360,0.0,0.00010211375472276115,1,474,473,4,-1,5,10,0,82,488,334
820,18,634,586,994,408,58,92,547,703,156,0.0002382654276864427,0.003880322679464924,593,940,347,2,3,3,14,2,130,408,20
821,0,101,1,923,922,0,5,1,332,331,0.0,0.0,1,1,0,5,-1,6,5,0,430,997,506
822,19,225,631,967,336,30,30,554,554,0,0.0004084550188910446,0.0015657442390823377,675,860,185,3,4,4,7,5,170,591,73
823,1,1,333,333,0,11,11,333,333,0,0.0,0.0,1,1,0,-1,6,6,11,2,163,448,908
824,9,111,569,934,365,12,12,487,487,0,6.807583648184077e-05,0.0002723033459273631,448,616,168,4,4,4,4,3,635,485,479
825,100,100,877,877,0,100,100,861,861,0,0.017393376221110316,0.0176997174852786,990,990,0,3,1,1,9,17,123,60,170
826,16,632,572,993,421,38,48,589,646,57,0.00010211375472276115,0.0015317063208414173,474,851,377,2,3,3,8,1,236,873,192
827,0,102,1,934,933,0,7,1,411,410,0.0,0.0002382654276864427,1,606,605,4,-1,5,4,0,728,997,610
828,2,208,362,971,609,8,12,413,457,44,0.00013615167296368154,0.0008169100377820892,520,782,262,3,5,4,4,1,709,463,415
829,0,101,1,959,958,0,3,1,329,328,0.0,0.0,1,1,0,5,-1,6,3,0,915,978,690
830,12,12,578,578,0,26,26,603,603,0,0.00030634126416828345,0.00030634126416828345,626,626,0,-1,4,4,5,2,382,770,431
831,125,125,917,917,0,72,72,815,815,0,0.0026889955410327104,0.0026889955410327104,915,915,0,-1,3,3,7,22,366,128,643
832,37,139,804,950,146,22,22,722,722,0,0.001055175465468532,0.001497668402600497,816,862,46,4,3,3,2,8,909,386,438
833,24,126,699,931,232,30,30,731,731,0,0.00017018959120460194,0.0002382654276864427,548,595,47,4,3,3,4,4,949,545,720
834,0,616,1,994,993,0,44,1,649,648,0.0,0.002484768031587188,1,905,904,2,-1,3,7,0,321,968,65
835,24,125,768,955,187,10,10,519,519,0,0.0002723033459273631,0.0004765308553728854,634,704,70,5,4,4,3,11,642,162,755
836,16,117,601,924,323,26,26,679,679,0,0.0002723033459273631,0.0002723033459273631,606,606,0,5,3,3,4,1,567,891,214
837,50,256,753,959,206,118,118,750,750,0,0.0007828721195411688,0.0008169100377820892,762,768,6,3,3,3,15,6,49,194,506
838,7,7,564,564,0,12,12,631,631,0,0.0002042275094455223,0.0002042275094455223,584,584,0,-1,4,4,2,2,625,408,777
839,22,1662,628,1000,372,68,106,632,800,168,0.00034037918240920387,0.009836958371625992,643,976,333,1,3,2,13,2,113,697,179
840,170,272,957,977,20,106,106,966,966,0,0.005480104836788182,0.005718370264474625,959,959,0,4,2,2,7,26,439,112,450
841,0,206,1,976,975,0,14,1,650,649,0.0,0.0016338200755641784,1,867,866,3,-1,4,3,0,674,965,98
842,8,110,541,926,385,12,12,491,491,0,6.807583648184077e-05,0.0002042275094455223,449,577,128,4,4,4,4,2,397,468,275
843,18,224,714,984,270,18,18,805,805,0,0.0005105687736138058,0.0023486163586235067,720,906,186,3,3,3,2,6,929,392,85
844,0,206,1,944,943,0,50,1,477,476,0.0,0.0006467204465774873,1,736,735,3,-1,4,17,0,24,808,326
845,0,0,1,1,0,0,0,1,1,0,0.0,0.0,1,1,0,-1,-1,-1,10,0,243,400,254
846,63,63,777,777,0,252,252,877,877,0,0.0013274788113958951,0.0013274788113958951,834,834,0,-1,2,2,23,4,4,125,948
847,2,208,360,969,609,8,18,402,544,142,3.4037918240920386e-05,0.0019061234214915416,405,879,474,3,5,4,5,1,765,743,98
848,0,616,1,995,994,0,26,1,566,565,0.0,0.0019061234214915416,1,873,872,2,-1,3,6,0,328,820,371
849,7,109,528,924,396,12,13,464,468,4,6.807583648184077e-05,0.00010211375472276115,452,484,32,4,4,4,5,5,570,476,545
850,31,237,677,953,276,100,100,634,634,0,0.00034037918240920387,0.0018380475850097008,640,873,233,3,3,3,17,6,24,467,128
851,16,16,619,619,0,26,26,561,561,0,0.0002042275094455223,0.0002042275094455223,574,574,0,-1,4,4,7,4,697,167,940
852,6,212,453,973,520,12,16,484,559,75,0.00013615167296368154,0.0002723033459273631,504,605,101,3,4,4,4,1,945,110,369
853,0,0,1,1,0,0,0,1,1,0,0.0,0.0,1,1,0,-1,-1,-1,2,0,747,228,478
854,4,4,476,476,0,3,3,376,376,0,0.0002723033459273631,0.0002723033459273631,626,626,0,-1,5,5,2,3,760,646,733
855,69,69,907,907,0,52,52,975,975,0,0.0053439531638245,0.0053439531638245,958,958,0,-1,2,2,3,8,485,177,777
856,6,212,468,975,507,7,12,480,611,131,0.00017018959120460194,0.0024166921951053475,539,911,372,3,4,4,2,1,849,765,13
857,6,108,427,918,491,12,12,543,543,0,0.00017018959120460194,0.0002382654276864427,556,592,36,4,4,4,2,1,769,282,724
858,0,0,1,1,0,0,0,1,1,0,0.0,0.0,1,1,0,-1,-1,-1,12,0,219,826,872
859,0,0,1,1,0,0,0,1,1,0,0.0,0.0,1,1,0,-1,-1,-1,3,0,600,423,715
860,54,260,755,955,200,104,120,616,667,51,0.0006126825283365669,0.001599782157323258,708,861,153,3,2,2,19,4,83,315,277
861,48,664,761,992,231,108,118,741,771,30,0.0006807583648184077,0.0013615167296368155,737,833,96,2,3,3,15,6,81,658,295
862,17,17,621,621,0,36,36,586,586,0,0.00030634126416828345,0.00030634126416828345,625,625,0,-1,4,4,8,8,595,302,752
863,52,258,809,968,159,78,82,826,860,34,0.0015317063208414173,0.002280540522141666,860,900,40,3,2,2,8,3,334,236,333
864,0,0,1,1,0,0,0,1,1,0,0.0,0.0,1,1,0,-1,-1,-1,17,0,10,367,868
865,0,206,1,947,946,0,35,1,427,426,0.0,0.00013615167296368154,1,507,506,3,-1,4,15,0,45,997,191
866,6,108,484,938,454,16,16,580,580,0,3.4037918240920386e-05,0.00013615167296368154,419,527,108,4,4,4,4,3,607,260,115
867,6,6,390,390,0,52,52,574,574,0,0.00037441710065012424,0.00037441710065012424,670,670,0,-1,4,4,10,1,285,500,793
868,14,115,633,937,304,12,12,487,487,0,0.0002042275094455223,0.0002042275094455223,570,570,0,5,4,4,4,6,635,447,676
869,92,194,854,941,87,116,116,838,838,0,0.0011232513019503727,0.0013955546478777359,812,843,31,4,3,3,11,17,66,226,562
870,0,101,1,938,937,0,2,1,330,329,0.0,3.4037918240920386e-05,1,398,397,5,-1,6,2,0,713,777,398
871,6,212,414,955,541,25,29,442,466,24,6.807583648184077e-05,0.00030634126416828345,447,611,164,3,4,4,11,1,271,935,477
872,36,242,781,973,192,28,28,733,733,0,0.0004084550188910446,0.001157289220191293,669,826,157,3,3,3,3,7,645,253,212
873,1,1,332,332,0,13,13,332,332,0,0.0,0.0,1,1,0,-1,7,7,13,1,228,765,729
874,0,101,1,919,918,0,4,1,332,331,0.0,0.0002042275094455223,1,553,552,5,-1,6,4,0,550,844,809
875,6,212,427,967,540,18,22,505,545,40,3.4037918240920386e-05,0.0007488342013002485,405,774,369,3,4,4,5,1,537,797,218
876,22,124,691,940,249,26,26,624,624,0,0.000442492937131965,0.0008509479560230097,683,788,105,4,4,4,5,8,326,90,375
877,32,134,778,938,160,24,24,705,705,0,0.0007488342013002485,0.0009190237925048504,777,803,26,4,3,3,3,6,726,376,628
878,0,616,1,997,996,0,39,1,572,571,0.0,0.0015657442390823377,1,847,846,2,-1,3,9,0,394,358,293
879,515,515,995,995,0,80,80,962,962,0,0.01330882603219987,0.01330882603219987,989,989,0,-1,3,3,5,118,720,37,538
880,0,206,1,971,970,0,12,1,436,435,0.0,0.00034037918240920387,1,655,654,3,-1,4,6,0,405,423,562
881,0,0,1,1,0,0,0,1,1,0,0.0,0.0,1,1,0,-1,-1,-1,6,2,157,752,816
882,80,80,876,876,0,70,70,905,905,0,0.002280540522141666,0.002280540522141666,899,899,0,-1,3,3,5,27,247,304,830
883,6,212,440,972,532,16,20,523,566,43,3.4037918240920386e-05,0.0004765308553728854,410,705,295,3,4,4,4,1,460,527,422
884,0,0,1,1,0,0,0,1,1,0,0.0,0.0,1,1,0,-1,-1,-1,5,0,421,635,675
885,0,0,1,1,0,0,0,1,1,0,0.0,0.0,1,1,0,-1,-1,-1,4,0,811,713,976
886,6,107,447,920,473,13,13,460,460,0,0.0,0.0,1,1,0,5,4,4,5,3,478,321,679
887,2,103,417,975,558,3,3,438,438,0,0.0,0.0,1,1,0,6,5,5,2,2,944,320,597
888,14,220,635,976,341,12,16,497,568,71,0.00017018959120460194,0.0006467204465774873,547,747,200,3,4,4,4,9,673,317,121
889,0,616,1,1000,999,0,17,1,811,810,0.0,0.0024507301133462676,1,912,911,2,-1,3,2,0,618,922,176
890,2,2,357,357,0,10,10,373,373,0,0.0,0.0,1,1,0,-1,5,5,7,1,416,503,949
891,6,108,436,926,490,8,8,439,439,0,0.0,6.807583648184077e-05,1,438,437,4,4,4,2,1,893,558,617
892,92,193,910,971,61,22,22,851,851,0,0.0020422750944552232,0.0020763130126961434,900,902,2,5,3,3,2,24,932,129,526
893,2,2,371,371,0,6,6,425,425,0,0.0,0.0,1,1,0,-1,5,5,3,1,861,870,831
894,16,16,630,630,0,28,28,679,679,0,0.00010211375472276115,0.00010211375472276115,482,482,0,-1,3,3,5,1,551,756,669
895,34,34,711,711,0,110,110,754,754,0,0.000442492937131965,0.000442492937131965,686,686,0,-1,3,3,15,5,95,619,856
896,29,1669,760,1000,240,40,74,792,954,162,0.0005786446100956465,0.02552843868069029,727,995,268,1,3,2,5,7,720,329,24
897,47,47,852,852,0,22,22,838,838,0,0.001157289220191293,0.001157289220191293,836,836,0,-1,3,3,2,13,988,255,909
898,18,18,555,555,0,136,136,731,731,0,0.0002382654276864427,0.0002382654276864427,584,584,0,-1,3,3,19,2,36,323,455
899,15,116,654,946,292,12,12,584,584,0,0.00037441710065012424,0.0004765308553728854,662,697,35,5,4,4,2,4,429,267,659
900,9,9,594,594,0,8,8,513,513,0,0.00034037918240920387,0.00034037918240920387,649,649,0,-1,4,4,2,3,960,280,794
901,50,50,776,776,0,82,82,716,716,0,0.0007488342013002485,0.0007488342013002485,759,759,0,-1,3,3,11,6,66,46,436
902,42,143,810,948,138,50,50,844,844,0,0.0010892133837094523,0.0011913271384322134,806,822,16,5,3,3,5,5,534,273,315
903,2,104,350,900,550,9,13,350,384,34,0.0,0.00010211375472276115,1,481,480,4,5,5,8,2,199,739,722
904,170,376,973,994,21,48,48,963,963,0,0.006058749446883829,0.006467204465774873,967,969,2,3,3,3,3,48,867,56,253
905,6,108,546,968,422,8,8,599,599,0,0.0006807583648184077,0.0015657442390823377,760,882,122,4,4,4,2,1,865,810,84
906,58,674,843,998,155,56,66,843,890,47,0.0010892133837094523,0.008271214132543654,820,976,156,2,3,3,6,9,237,242,6
907,0,102,1,961,960,0,4,1,464,463,0.0,0.00010211375472276115,1,495,494,4,-1,5,2,1,799,780,688
908,16,222,578,964,386,51,52,692,692,0,0.0004765308553728854,0.00088498587426393,693,781,88,3,3,3,8,1,334,416,387
909,2,208,368,972,604,6,12,384,495,111,6.807583648184077e-05,0.0009870996289866913,453,809,356,3,5,4,4,3,543,676,226
910,7,213,492,965,473,18,22,477,520,43,0.0,0.0004765308553728854,1,695,694,3,4,4,5,5,349,225,375
911,9,111,561,927,366,13,13,462,462,0,0.00013615167296368154,0.0002042275094455223,520,565,45,4,4,4,5,3,691,580,229
912,8,214,581,984,403,8,12,537,657,120,0.0002723033459273631,0.0005105687736138058,630,723,93,3,4,4,2,5,686,395,389
913,6,6,377,377,0,49,49,376,376,0,0.0,0.0,1,1,0,-1,4,4,35,2,20,292,839
914,20,122,632,908,276,86,86,812,812,0,0.0012253650566731338,0.0012253650566731338,826,826,0,4,3,3,10,3,259,390,337
915,71,71,851,851,0,78,78,875,875,0,0.0010211375472276116,0.0010211375472276116,812,812,0,-1,3,3,7,11,156,97,571
916,0,102,1,904,903,0,10,1,388,387,0.0,3.4037918240920386e-05,1,406,405,4,-1,5,6,0,402,851,339
917,34,135,741,915,174,64,64,713,713,0,0.0005105687736138058,0.0005105687736138058,705,705,0,5,3,3,9,4,202,40,885
918,0,102,1,951,950,0,4,1,418,417,0.0,0.00013615167296368154,1,530,529,4,-1,5,2,0,897,955,420
919,96,198,917,972,55,44,44,846,846,0,0.0029612988869600733,0.0029612988869600733,924,924,0,4,3,3,4,19,650,135,93
920,0,0,1,1,0,0,0,1,1,0,0.0,0.0,1,1,0,-1,-1,-1,7,0,416,898,974
921,20,226,662,973,311,32,36,713,735,22,0.0002042275094455223,0.0011232513019503727,572,817,245,3,3,3,5,3,692,353,60
922,1,103,331,971,640,2,4,331,466,135,0.0,0.0005786446100956465,1,749,748,4,6,5,2,1,941,853,60
923,6,6,409,409,0,19,19,417,417,0,0.00010211375472276115,0.00010211375472276115,481,481,0,-1,4,4,9,1,140,788,956
924,10,216,602,981,379,8,12,486,603,117,0.0002382654276864427,0.0021784267674189047,599,900,301,3,4,4,2,7,943,427,56
925,60,60,870,870,0,18,18,697,697,0,0.0009530617107457708,0.0009530617107457708,806,806,0,-1,4,4,3,19,433,184,835
926,0,102,1,930,929,0,6,1,374,373,0.0,0.0004765308553728854,1,698,697,4,-1,5,4,0,562,803,226
927,0,0,1,1,0,0,0,1,1,0,0.0,0.0,1,1,0,-1,-1,-1,12,0,183,699,731
928,0,206,1,982,981,0,10,1,567,566,0.0,0.002212464685659825,1,902,901,3,-1,4,3,0,875,819,47
929,71,173,871,960,89,50,50,816,816,0,0.0016678579938050988,0.003199564314646516,867,929,62,4,3,3,5,18,294,63,44
930,2,103,376,957,581,6,6,457,457,0,0.0,6.807583648184077e-05,1,457,456,5,5,5,3,2,850,342,570
931,0,0,1,1,0,0,0,1,1,0,0.0,0.0,1,1,0,-1,-1,-1,4,0,603,574,937
932,0,102,1,899,898,0,9,1,349,348,0.0,0.0,1,1,0,4,-1,5,8,0,199,737,853
933,6,108,439,912,473,24,24,532,532,0,6.807583648184077e-05,0.00034037918240920387,461,649,188,4,4,4,6,1,281,394,435
934,0,0,1,1,0,0,0,1,1,0,0.0,0.0,1,1,0,-1,-1,-1,2,0,666,488,529
935,38,38,703,703,0,132,132,768,768,0,0.00034037918240920387,0.00034037918240920387,637,637,0,-1,3,3,16,5,42,306,565
936,0,0,1,1,0,0,0,1,1,0,0.0,0.0,1,1,0,-1,-1,-1,2,0,909,205,883
937,0,0,1,1,0,0,0,1,1,0,0.0,0.0,1,1,0,-1,-1,-1,3,0,639,871,564
938,17,118,646,921,275,20,20,504,504,0,0.00017018959120460194,0.0002042275094455223,557,570,13,5,4,4,6,5,526,528,605
939,0,0,1,1,0,0,0,1,1,0,0.0,0.0,1,1,0,-1,-1,-1,3,0,642,804,983
940,3,104,477,963,486,4,4,458,458,0,0.0,0.0,1,1,0,6,5,5,2,5,749,225,495
941,11,217,568,970,402,14,18,473,501,28,0.00017018959120460194,0.0008509479560230097,555,792,237,3,4,4,5,4,294,315,163
942,8,8,491,491,0,40,40,538,538,0,0.00017018959120460194,0.00017018959120460194,544,544,0,-1,4,4,10,2,204,724,738
943,15,221,683,981,298,14,14,618,618,0,0.00037441710065012424,0.001157289220191293,667,833,166,3,4,4,3,4,485,328,172
944,0,101,1,884,883,0,6,1,332,331,0.0,3.4037918240920386e-05,1,406,405,5,-1,6,6,0,425,900,687
945,0,102,1,928,927,0,5,1,356,355,0.0,6.807583648184077e-05,1,447,446,4,-1,5,4,0,635,388,322
946,2,2,355,355,0,18,18,415,415,0,6.807583648184077e-05,6.807583648184077e-05,440,440,0,-1,5,5,9,1,367,481,768
947,10,10,569,569,0,12,12,476,476,0,0.00030634126416828345,0.00030634126416828345,623,623,0,-1,4,4,4,3,783,353,768
948,16,117,613,922,309,42,42,710,710,0,0.0002042275094455223,0.0002042275094455223,566,566,0,5,3,3,6,1,281,741,518
949,0,102,1,916,915,0,6,1,376,375,0.0,0.0,1,1,0,4,-1,5,4,0,783,986,485
950,0,101,1,954,953,0,2,1,331,330,0.0,6.807583648184077e-05,1,462,461,5,-1,6,2,1,868,641,378
951,0,206,1,948,947,0,45,1,429,428,0.0,0.0002382654276864427,1,583,582,3,-1,4,19,3,38,478,291
952,0,101,1,957,956,0,2,1,331,330,0.0,0.00017018959120460194,1,549,548,5,-1,6,2,0,985,445,29
953,6,6,442,442,0,10,10,448,448,0,3.4037918240920386e-05,3.4037918240920386e-05,402,402,0,-1,4,4,4,1,741,601,660
954,0,206,1,975,974,0,18,1,675,674,0.0,0.0030293747234419145,1,928,927,3,-1,4,3,0,337,959,41
955,4,106,386,879,493,25,25,401,401,0,0.0,3.4037918240920386e-05,1,392,391,4,5,5,13,2,41,602,710
956,8,110,530,927,397,20,20,579,579,0,0.00017018959120460194,0.0006126825283365669,547,741,194,4,4,4,4,3,504,508,219
957,138,239,943,977,34,22,22,711,711,0,0.002484768031587188,0.002484768031587188,917,918,1,6,3,3,2,28,859,44,540
958,0,102,1,940,939,0,5,1,368,367,0.0,3.4037918240920386e-05,1,399,398,4,-1,5,4,0,794,483,609
959,0,0,1,1,0,0,0,1,1,0,0.0,0.0,1,1,0,-1,-1,-1,6,0,441,723,753
960,2,104,351,883,532,13,14,351,360,9,0.0,0.0,1,1,0,4,5,5,12,1,292,590,885
961,2,1642,348,1000,652,22,119,354,682,328,0.0,0.007352190340038803,1,963,962,1,5,2,20,1,70,590,213
962,41,1681,671,1000,329,236,288,720,803,83,0.0006807583648184077,0.004220701861874128,738,939,201,1,3,2,33,7,9,329,71
963,0,101,1,876,875,0,17,1,332,331,0.0,0.0,1,1,0,5,-1,6,17,0,63,927,924
964,65,166,853,952,99,66,66,852,852,0,0.0012253650566731338,0.0012934408931549745,840,842,2,5,3,3,6,11,356,83,337
965,16,16,573,573,0,60,60,683,683,0,0.0002723033459273631,0.0002723033459273631,611,611,0,-1,3,3,9,1,217,553,445
966,6,212,421,966,545,38,38,642,642,0,0.0002042275094455223,0.0009530617107457708,580,797,217,3,4,4,7,1,362,759,277
967,271,371,985,993,8,72,72,982,982,0,0.008543517478471017,0.009326389598012186,981,982,1,4,2,2,3,61,835,14,242
968,2,2,363,363,0,10,10,428,428,0,0.00010211375472276115,0.00010211375472276115,480,480,0,-1,5,5,5,2,644,691,786
969,44,250,727,959,232,192,196,812,822,10,0.0006126825283365669,0.0008509479560230097,722,772,50,3,3,3,21,4,12,328,439
970,28,234,786,979,193,22,22,779,779,0,0.0005105687736138058,0.0026549576227917903,730,918,188,3,3,3,2,6,904,494,166
971,0,101,1,915,914,0,4,1,331,330,0.0,0.0,1,1,0,5,-1,6,4,0,453,673,885
972,65,681,881,999,118,38,38,902,902,0,0.002586881786309949,0.0042547397801150485,912,946,34,2,3,3,3,20,845,87,266
973,1,1,333,333,0,3,3,333,333,0,0.0,0.0,1,1,0,-1,6,6,3,1,718,402,917
974,0,206,1,953,952,0,30,1,457,456,0.0,0.00017018959120460194,1,532,531,3,-1,4,12,0,375,956,722
975,0,0,1,1,0,0,0,1,1,0,0.0,0.0,1,1,0,-1,-1,-1,5,0,314,515,968
976,68,169,850,947,97,62,62,809,809,0,0.0017359338302869397,0.0017359338302869397,864,864,0,6,3,3,7,14,336,68,357
977,0,206,1,970,969,0,18,1,622,621,0.0,0.005650294427992784,1,965,964,3,-1,4,3,1,645,706,18
978,8,110,539,937,398,11,11,475,475,0,0.00010211375472276115,0.0005105687736138058,506,713,207,4,4,4,4,3,573,496,461
979,6,212,484,977,493,18,18,697,697,0,0.00034037918240920387,0.0012934408931549745,643,843,200,3,4,4,3,1,433,667,245
980,9,215,532,968,436,26,30,573,638,65,0.000442492937131965,0.0013615167296368155,676,846,170,3,4,4,5,4,377,278,382
981,1,207,333,949,616,13,46,333,502,169,0.0,0.0009190237925048504,1,785,784,3,7,4,13,3,67,626,137
982,0,0,1,1,0,0,0,1,1,0,0.0,0.0,1,1,0,-1,-1,-1,5,0,765,991,876
983,12,218,546,965,419,38,38,628,628,0,0.0002723033459273631,0.0006807583648184077,607,754,147,3,4,4,7,4,156,346,312
984,30,30,752,752,0,26,26,709,709,0,0.0006807583648184077,0.0006807583648184077,752,752,0,-1,3,3,4,6,690,258,587
985,0,206,1,970,969,0,22,1,570,569,0.0,0.0021784267674189047,1,892,891,3,-1,4,5,0,656,860,14
986,19,19,714,714,0,18,18,692,692,0,0.0007828721195411688,0.0007828721195411688,780,780,0,-1,4,4,3,4,770,207,850
987,7,108,533,929,396,12,12,471,471,0,3.4037918240920386e-05,3.4037918240920386e-05,398,398,0,5,4,4,5,5,612,225,763
988,0,206,1,944,943,0,61,1,511,510,0.0,0.0007488342013002485,1,760,759,3,-1,4,17,0,24,751,83
989,0,0,1,1,0,0,0,1,1,0,0.0,0.0,1,1,0,-1,-1,-1,7,0,170,715,498
990,22,228,721,973,252,31,32,762,763,1,0.00030634126416828345,0.0015317063208414173,631,863,232,3,3,3,5,2,685,770,106
991,26,26,745,745,0,64,64,930,930,0,0.001599782157323258,0.001599782157323258,863,863,0,-1,3,3,4,5,558,412,696
992,0,0,1,1,0,0,0,1,1,0,0.0,0.0,1,1,0,-1,-1,-1,10,1,240,767,996
993,0,0,1,1,0,0,0,1,1,0,0.0,0.0,1,1,0,-1,-1,-1,10,0,437,436,400
994,2,104,349,907,558,8,9,364,370,6,3.4037918240920386e-05,0.00010211375472276115,403,478,75,4,5,5,6,2,498,495,599
995,2,104,362,941,579,3,3,365,365,0,0.0,0.00010211375472276115,1,492,491,4,5,5,2,1,705,736,797
996,31,31,752,752,0,42,42,678,678,0,0.0004765308553728854,0.0004765308553728854,701,701,0,-1,4,4,7,9,342,240,445
997,2,2,349,349,0,18,18,377,377,0,0.0,0.0,1,1,0,-1,5,5,12,1,194,503,888
998,0,101,1,935,934,0,3,1,330,329,0.0,6.807583648184077e-05,1,459,458,5,-1,6,3,0,433,821,842
999,8,8,606,606,0,10,10,624,624,0,0.00010211375472276115,0.00010211375472276115,493,493,0,-1,4,4,3,2,852,700,629
