,FreeNet_pre_score,FreeNet_post_score,FreeNet_pre_rank,FreeNet_post_rank,FreeNet_delta_ranks,Reversed_pre_score,Reversed_post_score,Reversed_pre_rank,Reversed_post_rank,Reversed_delta_ranks,Random_pre_score,Random_post_score,Random_pre_rank,Random_post_rank,Random_delta_ranks,dist_victim_relayer,dist_victim_vilain_pre,dist_victim_vilain_post,out_deg_victim,in_deg_villain,victim,villain,relayer
0,0,0,1,1,0,0,0,1,1,0,0.0,0.0,1,1,0,-1,-1,-1,6,2,494,684,773
1,0,1640,1,1000,999,0,150,1,719,718,0.0,0.007692569522448007,1,970,969,1,-1,2,23,0,30,712,33
2,100,100,868,868,0,100,100,816,816,0,0.017427414139351238,0.017427414139351238,992,992,0,-1,1,1,10,31,310,35,986
3,96,302,856,971,115,138,138,893,893,0,0.0010211375472276116,0.0015317063208414173,794,845,51,3,3,3,12,12,52,155,273
4,10,111,608,940,332,12,12,593,593,0,0.00037441710065012424,0.0004765308553728854,676,711,35,5,4,4,2,3,653,378,586
5,11,112,626,955,329,7,7,489,489,0,0.00013615167296368154,0.0002042275094455223,530,581,51,5,4,4,2,4,988,645,560
6,0,206,1,964,963,0,20,1,506,505,0.0,0.0006126825283365669,1,735,734,3,-1,4,6,0,587,845,234
7,1,103,333,925,592,4,8,333,430,97,0.0,0.0005105687736138058,1,719,718,4,9,5,4,1,475,647,195
8,24,24,701,701,0,30,30,705,705,0,0.00013615167296368154,0.00013615167296368154,524,524,0,-1,3,3,4,3,762,519,685
9,0,0,1,1,0,0,0,1,1,0,0.0,0.0,1,1,0,-1,-1,-1,7,0,331,803,812
10,2,103,382,957,575,2,2,332,332,0,0.00017018959120460194,0.00030634126416828345,546,640,94,5,6,6,2,3,965,646,196
11,6,212,453,973,520,11,15,457,527,70,0.00010211375472276115,0.0008169100377820892,486,784,298,3,4,4,4,1,513,607,352
12,0,0,1,1,0,0,0,1,1,0,0.0,0.0,1,1,0,-1,-1,-1,8,0,508,228,573
13,68,68,848,848,0,54,54,799,799,0,0.0006807583648184077,0.0006807583648184077,752,752,0,-1,3,3,7,9,722,242,863
14,24,230,819,989,170,18,22,878,900,22,0.00442492937131965,0.005922597773920147,959,970,11,3,3,3,2,6,810,4,96
15,29,29,699,699,0,42,42,600,600,0,0.0006126825283365669,0.0006126825283365669,733,733,0,-1,3,3,8,6,483,459,789
16,2,2,352,352,0,11,11,352,352,0,6.807583648184077e-05,6.807583648184077e-05,437,437,0,-1,5,5,10,1,189,603,772
17,10,10,588,588,0,10,10,485,485,0,6.807583648184077e-05,6.807583648184077e-05,450,450,0,-1,4,4,3,4,337,617,624
18,1,102,332,966,634,2,2,332,332,0,0.0,0.00010211375472276115,1,481,480,5,7,6,2,1,968,402,454
19,0,0,1,1,0,0,0,1,1,0,0.0,0.0,1,1,0,-1,-1,-1,2,0,999,515,990
20,32,238,735,962,227,78,78,804,804,0,0.0007488342013002485,0.0009870996289866913,769,806,37,3,3,3,8,5,186,535,182
21,16,118,556,897,341,42,42,530,530,0,0.00013615167296368154,0.0002042275094455223,512,568,56,4,3,3,11,1,234,449,443
22,7,108,482,884,402,35,35,470,470,0,0.00013615167296368154,0.00013615167296368154,511,511,0,5,4,4,12,2,96,627,598
23,16,222,526,946,420,160,160,785,785,0,0.000442492937131965,0.0006807583648184077,669,722,53,3,3,3,20,2,70,160,173
24,0,616,1,993,992,0,29,1,524,523,0.0,0.0006126825283365669,1,744,743,2,-1,3,7,0,216,324,501
25,64,166,896,975,79,52,52,975,975,0,0.002927260968719153,0.0030634126416828346,917,919,2,4,2,2,3,9,693,154,410
26,19,19,658,658,0,22,22,617,617,0,0.0002723033459273631,0.0002723033459273631,615,615,0,-1,3,3,4,3,354,385,811
27,8,8,506,506,0,12,12,427,427,0,0.0,0.0,1,1,0,-1,4,4,5,2,571,602,955
28,0,0,1,1,0,0,0,1,1,0,0.0,0.0,1,1,0,-1,-1,-1,3,1,615,513,892
29,0,102,1,926,925,0,6,1,361,360,0.0,0.0002382654276864427,1,598,597,4,-1,5,5,0,843,423,409
30,7,623,535,998,463,12,26,494,748,254,0.00010211375472276115,0.004969536063174376,499,958,459,2,4,3,4,2,619,383,77
31,18,224,708,976,268,18,18,715,715,0,0.0002723033459273631,0.0014295925661186562,622,852,230,3,4,4,3,8,639,417,397
32,381,587,990,998,8,102,102,998,998,0,0.011062323428299126,0.01147077844719017,986,986,0,3,2,2,4,59,767,6,165
33,30,30,747,747,0,52,52,775,775,0,0.0010892133837094523,0.0010892133837094523,828,828,0,-1,3,3,7,4,305,207,768
34,0,102,1,866,865,0,20,1,349,348,0.0,3.4037918240920386e-05,1,400,399,4,-1,5,18,0,69,707,899
35,32,648,734,997,263,46,56,709,788,79,0.0010211375472276116,0.003267640151128357,812,931,119,2,3,3,6,5,514,535,393
36,0,101,1,878,877,0,17,1,331,330,0.0,0.0,1,1,0,6,-1,7,17,0,56,796,640
37,0,616,1,991,990,0,106,1,763,762,0.0,0.0022465026039007454,1,890,889,2,-1,3,14,0,181,977,13
38,0,616,1,997,996,0,30,1,738,737,0.0,0.0030293747234419145,1,931,930,2,-1,3,4,3,755,882,13
39,22,22,657,657,0,56,56,810,810,0,0.00037441710065012424,0.00037441710065012424,664,664,0,-1,3,3,6,2,536,700,643
40,0,0,1,1,0,0,0,1,1,0,0.0,0.0,1,1,0,-1,-1,-1,7,0,525,914,963
41,2,208,348,947,599,29,58,384,500,116,3.4037918240920386e-05,0.0009530617107457708,392,781,389,3,5,4,17,1,71,265,155
42,21,21,639,639,0,36,36,543,543,0,0.00010211375472276115,0.00010211375472276115,481,481,0,-1,4,4,8,6,483,486,868
43,2,2,347,347,0,16,16,370,370,0,0.0,0.0,1,1,0,-1,5,5,11,2,66,495,760
44,0,101,1,896,895,0,6,1,332,331,0.0,0.0,1,1,0,7,-1,8,6,0,473,912,582
45,17,17,663,663,0,20,20,597,597,0,6.807583648184077e-05,6.807583648184077e-05,440,440,0,-1,3,3,4,2,735,430,779
46,1,207,332,980,648,2,8,332,570,238,6.807583648184077e-05,0.0009530617107457708,456,830,374,3,6,4,2,3,995,466,161
47,23,639,759,1000,241,12,22,611,819,208,0.001157289220191293,0.00439089145307873,828,946,118,2,4,3,2,7,977,396,60
48,0,0,1,1,0,0,0,1,1,0,0.0,0.0,1,1,0,-1,-1,-1,5,1,467,948,632
49,0,102,1,927,926,0,6,1,381,380,0.0,0.0002042275094455223,1,575,574,4,-1,5,4,0,824,957,958
50,14,116,593,925,332,24,24,642,642,0,0.0004765308553728854,0.0005105687736138058,703,713,10,4,4,4,4,3,632,616,631
51,142,243,927,968,41,110,110,958,958,0,0.002927260968719153,0.0029612988869600733,922,923,1,5,2,2,6,17,312,45,357
52,0,102,1,938,937,0,4,1,435,434,0.0,0.0002382654276864427,1,604,603,4,-1,5,2,0,906,880,451
53,0,206,1,969,968,0,18,1,516,515,0.0,0.002484768031587188,1,908,907,3,-1,4,5,0,487,826,48
54,22,124,650,907,257,48,48,585,585,0,0.0006807583648184077,0.0007488342013002485,749,761,12,4,3,3,10,5,241,401,230
55,0,0,1,1,0,0,0,1,1,0,0.0,0.0,1,1,0,-1,-1,-1,8,0,595,776,632
56,6,212,387,944,557,75,83,561,585,24,6.807583648184077e-05,0.0007147962830593281,438,739,301,3,4,4,18,2,86,215,179
57,0,102,1,928,927,0,6,1,412,411,0.0,0.0002723033459273631,1,622,621,4,-1,5,3,0,935,888,494
58,372,372,980,980,0,192,192,986,986,0,0.006637394056979475,0.006637394056979475,971,971,0,-1,2,2,9,45,191,77,897
59,0,101,1,900,899,0,8,1,332,331,0.0,0.0,1,1,0,5,-1,6,8,1,521,828,181
60,0,206,1,970,969,0,22,1,555,554,0.0,0.001497668402600497,1,856,855,3,-1,4,5,0,724,932,106
61,2,2,359,359,0,11,11,392,392,0,3.4037918240920386e-05,3.4037918240920386e-05,413,413,0,-1,5,5,7,1,342,558,982
62,0,0,1,1,0,0,0,1,1,0,0.0,0.0,1,1,0,-1,-1,-1,21,0,3,773,608
63,0,0,1,1,0,0,0,1,1,0,0.0,0.0,1,1,0,-1,-1,-1,5,0,435,745,514
64,2,208,360,964,604,5,10,373,432,59,6.807583648184077e-05,0.0006807583648184077,441,753,312,3,5,4,3,1,731,771,461
65,2,208,359,969,610,8,22,389,563,174,0.0,0.0014295925661186562,1,856,855,3,5,4,5,2,290,597,55
66,0,102,1,903,902,0,8,1,384,383,0.0,0.0002723033459273631,1,608,607,4,-1,5,4,0,410,587,451
67,1,103,333,931,598,3,6,333,424,91,0.0,0.0018720855032506212,1,890,889,4,7,5,3,1,670,703,35
68,0,102,1,946,945,0,3,1,367,366,0.0,0.0,1,1,0,4,-1,5,2,0,979,740,935
69,6,6,500,500,0,14,14,624,624,0,6.807583648184077e-05,6.807583648184077e-05,454,454,0,-1,4,4,3,1,569,904,910
70,22,124,744,952,208,20,20,781,781,0,0.00034037918240920387,0.0007828721195411688,658,783,125,4,3,3,3,2,961,465,240
71,30,30,664,664,0,106,106,731,731,0,0.0002042275094455223,0.0002042275094455223,564,564,0,-1,3,3,14,9,133,29,436
72,0,0,1,1,0,0,0,1,1,0,0.0,0.0,1,1,0,-1,-1,-1,6,0,98,668,713
73,0,102,1,886,885,0,21,1,407,406,0.0,0.000442492937131965,1,674,673,4,-1,5,11,1,188,650,366
74,19,120,671,931,260,28,28,727,727,0,0.0002042275094455223,0.0002042275094455223,565,565,0,6,3,3,3,5,930,395,656
75,0,0,1,1,0,0,0,1,1,0,0.0,0.0,1,1,0,-1,-1,-1,10,0,254,349,522
76,0,616,1,999,998,0,28,1,839,838,0.0,0.014534191088873005,1,991,990,2,-1,3,3,0,654,969,3
77,1,1,333,333,0,5,5,333,333,0,0.0,0.0,1,1,0,-1,6,6,5,2,294,582,757
78,14,116,635,943,308,12,12,582,582,0,0.00013615167296368154,0.0002042275094455223,523,564,41,4,4,4,2,3,643,677,607
79,12,218,603,974,371,14,14,543,543,0,0.0002723033459273631,0.0004765308553728854,618,704,86,3,4,4,3,2,585,468,392
80,2,104,349,867,518,17,26,349,382,33,0.0,0.00034037918240920387,1,617,616,4,5,5,16,1,132,640,473
81,12,12,589,589,0,24,24,664,664,0,0.0002042275094455223,0.0002042275094455223,574,574,0,-1,4,4,4,4,513,149,356
82,59,59,843,843,0,50,50,839,839,0,0.0020763130126961434,0.0020763130126961434,889,889,0,-1,3,3,5,17,667,213,542
83,0,0,1,1,0,0,0,1,1,0,0.0,0.0,1,1,0,-1,-1,-1,7,0,221,950,614
84,6,212,410,957,547,14,18,424,478,54,0.00010211375472276115,0.0002723033459273631,486,609,123,3,4,4,5,1,238,931,711
85,0,0,1,1,0,0,0,1,1,0,0.0,0.0,1,1,0,-1,-1,-1,2,0,763,769,965
86,49,49,870,870,0,12,12,655,655,0,0.0010892133837094523,0.0010892133837094523,830,830,0,-1,4,4,2,18,874,148,794
87,6,108,439,927,488,16,16,530,530,0,0.0002042275094455223,0.0002723033459273631,573,628,55,4,4,4,4,1,755,420,556
88,0,102,1,913,912,0,5,1,355,354,0.0,6.807583648184077e-05,1,452,451,4,-1,5,4,0,632,744,496
89,0,101,1,944,943,0,2,1,331,330,0.0,6.807583648184077e-05,1,455,454,5,-1,6,2,0,960,774,319
90,8,110,582,952,370,8,8,525,525,0,0.0002723033459273631,0.0007147962830593281,629,766,137,4,4,4,2,2,975,491,284
91,2,103,348,879,531,25,25,376,376,0,3.4037918240920386e-05,3.4037918240920386e-05,395,395,0,9,5,5,17,2,80,615,647
92,0,206,1,965,964,0,20,1,489,488,0.0,0.0007147962830593281,1,759,758,3,-1,4,6,0,345,938,327
93,6,6,390,390,0,32,32,461,461,0,0.0,0.0,1,1,0,-1,4,4,12,2,212,550,436
94,22,22,711,711,0,28,28,778,778,0,0.0004765308553728854,0.0004765308553728854,706,706,0,-1,3,3,3,4,855,312,940
95,6,108,382,880,498,20,21,377,382,5,0.00013615167296368154,0.00013615167296368154,513,513,0,4,5,5,12,4,239,398,594
96,2,208,361,971,610,5,18,383,629,246,6.807583648184077e-05,0.0014636304843595766,464,860,396,3,5,4,3,1,780,265,146
97,0,616,1,990,989,0,90,1,776,775,0.0,0.0040845501889104465,1,947,946,2,-1,3,10,0,153,941,17
98,6,622,385,987,602,52,106,490,702,212,0.00010211375472276115,0.004050512270669526,460,942,482,2,4,3,16,3,132,309,105
99,0,0,1,1,0,0,0,1,1,0,0.0,0.0,1,1,0,-1,-1,-1,9,3,159,854,787
100,0,0,1,1,0,0,0,1,1,0,0.0,0.0,1,1,0,-1,-1,-1,9,0,202,954,860
101,98,199,937,977,40,22,22,829,829,0,0.002586881786309949,0.0026209197045508697,919,922,3,6,3,3,2,26,947,112,605
102,0,0,1,1,0,0,0,1,1,0,0.0,0.0,1,1,0,-1,-1,-1,14,0,172,982,678
103,28,234,654,956,302,76,76,681,681,0,0.00037441710065012424,0.0008509479560230097,651,783,132,3,3,3,11,4,66,336,249
104,0,102,1,918,917,0,8,1,392,391,0.0,0.0002042275094455223,1,561,560,4,-1,5,5,0,552,816,259
105,0,0,1,1,0,0,0,1,1,0,0.0,0.0,1,1,0,-1,-1,-1,7,0,416,900,947
106,25,231,693,968,275,39,48,661,708,47,0.0005105687736138058,0.0036760951700194017,706,942,236,3,3,3,7,7,324,427,126
107,0,0,1,1,0,0,0,1,1,0,0.0,0.0,1,1,0,-1,-1,-1,3,0,883,587,730
108,8,110,524,933,409,11,11,449,449,0,0.00010211375472276115,0.0002723033459273631,493,619,126,4,4,4,4,4,566,442,384
109,0,206,1,968,967,0,17,1,516,515,0.0,0.0010892133837094523,1,815,814,3,-1,4,5,0,692,201,147
110,237,443,953,980,27,190,190,896,896,0,0.002723033459273631,0.0028932230504782326,917,923,6,3,2,2,16,34,117,89,504
111,4,210,397,955,558,13,20,379,428,49,0.0,0.00037441710065012424,1,658,657,3,5,4,8,2,357,694,288
112,11,217,539,961,422,19,27,441,487,46,0.00013615167296368154,0.0004765308553728854,509,695,186,3,4,4,8,4,443,444,528
113,20,20,670,670,0,16,16,515,515,0,0.0002042275094455223,0.0002042275094455223,584,584,0,-1,4,4,4,6,622,435,912
114,48,48,854,854,0,12,12,635,635,0,0.0012594029749140542,0.0012594029749140542,847,847,0,-1,4,4,2,18,747,148,712
115,6,108,497,947,450,8,8,523,523,0,0.00034037918240920387,0.002927260968719153,649,925,276,4,4,4,2,3,929,285,48
116,31,31,808,808,0,24,24,801,801,0,0.0015657442390823377,0.0015657442390823377,865,865,0,-1,3,3,3,9,871,198,520
117,1054,1054,999,999,0,192,192,972,972,0,0.018482589604819768,0.018482589604819768,995,995,0,-1,3,3,12,157,93,2,850
118,40,246,779,975,196,58,62,787,808,21,0.0010211375472276116,0.002723033459273631,803,912,109,3,3,3,7,9,658,415,64
119,0,101,1,893,892,0,9,1,332,331,0.0,0.0,1,1,0,6,-1,7,9,0,245,851,590
120,0,101,1,893,892,0,8,1,332,331,0.0,0.0,1,1,0,5,-1,6,8,0,415,812,708
121,2,208,371,972,601,8,16,424,542,118,0.00010211375472276115,0.0008169100377820892,499,788,289,3,5,4,4,1,619,659,219
122,308,308,985,985,0,128,128,998,998,0,0.010926171755335444,0.010926171755335444,982,982,0,-1,2,2,5,61,602,14,820
123,2,2,372,372,0,4,4,375,375,0,0.0,0.0,1,1,0,-1,5,5,3,1,674,837,254
124,0,0,1,1,0,0,0,1,1,0,0.0,0.0,1,1,0,-1,-1,-1,2,0,830,815,731
125,2,208,370,980,610,4,8,482,589,107,0.00013615167296368154,0.0014295925661186562,534,869,335,3,5,4,2,2,283,648,180
126,282,382,972,983,11,134,134,920,920,0,0.003710133088260322,0.0037441710065012424,938,939,1,4,2,2,10,44,135,27,392
127,2,104,373,946,573,3,3,374,374,0,0.0,0.00013615167296368154,1,536,535,4,5,5,2,3,919,321,178
128,12,218,563,970,407,32,36,648,702,54,0.00037441710065012424,0.0007147962830593281,671,760,89,3,4,4,6,3,451,795,465
129,95,301,862,971,109,116,116,842,842,0,0.0019061234214915416,0.0019741992579733825,879,880,1,3,3,3,11,15,167,151,350
130,2,104,368,934,566,4,4,401,401,0,0.00010211375472276115,0.0004765308553728854,488,712,224,4,5,5,2,1,653,152,427
131,0,0,1,1,0,0,0,1,1,0,0.0,0.0,1,1,0,-1,-1,-1,8,1,541,660,633
132,6,212,427,967,540,26,26,596,596,0,3.4037918240920386e-05,0.0005786446100956465,405,736,331,3,4,4,5,1,537,720,289
133,18,120,629,915,286,52,52,734,734,0,0.000442492937131965,0.0005105687736138058,691,708,17,4,3,3,7,2,637,700,477
134,2,104,371,927,556,6,6,423,423,0,6.807583648184077e-05,0.001055175465468532,454,824,370,4,5,5,3,1,831,762,78
135,0,102,1,944,943,0,3,1,380,379,0.0,3.4037918240920386e-05,1,395,394,4,-1,5,2,0,929,822,519
136,0,102,1,907,906,0,10,1,371,370,0.0,3.4037918240920386e-05,1,393,392,4,-1,5,7,1,324,789,512
137,16,222,639,976,337,30,34,749,773,24,0.00034037918240920387,0.0022465026039007454,654,897,243,3,3,3,4,2,475,652,94
138,0,206,1,967,966,0,14,1,488,487,0.0,0.0007147962830593281,1,765,764,3,-1,4,5,0,552,436,138
139,6,622,386,992,606,37,138,441,834,393,6.807583648184077e-05,0.006841621566424997,444,969,525,2,4,3,13,1,165,799,70
140,100,202,884,958,74,88,88,878,878,0,0.0014295925661186562,0.0016678579938050988,849,863,14,4,3,3,8,15,365,206,494
141,0,0,1,1,0,0,0,1,1,0,0.0,0.0,1,1,0,-1,-1,-1,10,0,285,205,276
142,13,219,564,962,398,40,40,604,604,0,0.00013615167296368154,0.002723033459273631,506,916,410,3,4,4,8,3,201,291,135
143,106,106,971,971,0,12,12,779,779,0,0.003199564314646516,0.003199564314646516,934,934,0,-1,4,4,2,44,884,27,235
144,0,206,1,953,952,0,46,1,521,520,0.0,0.0007147962830593281,1,761,760,3,-1,4,11,0,227,324,83
145,32,238,756,972,216,30,30,702,702,0,0.0002042275094455223,0.0004084550188910446,567,668,101,3,3,3,4,8,717,90,477
146,45,251,776,963,187,70,70,725,725,0,0.0007147962830593281,0.0008509479560230097,755,774,19,3,3,3,9,6,159,4,491
147,41,247,832,977,145,28,28,776,776,0,0.0011913271384322134,0.0014295925661186562,840,862,22,3,3,3,3,11,935,193,278
148,18,119,578,894,316,86,86,590,590,0,0.00030634126416828345,0.00030634126416828345,630,630,0,5,4,4,17,4,39,637,344
149,0,102,1,967,966,0,3,1,404,403,0.0,0.0015657442390823377,1,866,865,4,-1,5,2,0,807,533,94
150,0,102,1,890,889,0,11,1,358,357,0.0,0.00013615167296368154,1,513,512,4,-1,5,10,0,427,992,464
151,1,207,332,978,646,2,12,332,634,302,0.0,0.003437829742332959,1,933,932,3,6,4,2,2,723,764,51
152,9,1649,582,1000,418,10,48,509,958,449,0.00010211375472276115,0.03437829742332959,492,997,505,1,4,2,3,5,676,710,663
153,0,0,1,1,0,0,0,1,1,0,0.0,0.0,1,1,0,-1,-1,-1,2,1,283,583,564
154,0,102,1,900,899,0,11,1,386,385,0.0,0.00013615167296368154,1,521,520,4,-1,5,7,0,497,698,427
155,0,102,1,952,951,0,3,1,374,373,0.0,0.0002382654276864427,1,605,604,4,-1,5,2,1,830,568,584
156,62,163,881,965,84,34,34,799,799,0,0.0014636304843595766,0.0015317063208414173,859,863,4,5,3,3,4,17,462,269,618
157,42,144,809,948,139,38,38,765,765,0,0.0007828721195411688,0.0009870996289866913,779,813,34,4,3,3,5,7,363,170,220
158,151,151,948,948,0,82,82,919,919,0,0.0045270431260424114,0.0045270431260424114,948,948,0,-1,3,3,7,29,439,17,834
159,1,207,333,963,630,9,38,333,570,237,0.0,0.0019741992579733825,1,876,875,3,6,4,9,1,190,861,123
160,12,628,526,994,468,24,42,450,592,142,0.0002042275094455223,0.0006126825283365669,555,722,167,2,4,3,8,5,244,350,223
161,56,262,861,977,116,22,22,746,746,0,0.002586881786309949,0.0030974505599237552,915,930,15,3,3,3,2,10,971,227,289
162,80,182,917,972,55,22,22,820,820,0,0.0018040096667687805,0.0019061234214915416,892,895,3,4,3,3,2,18,896,171,465
163,43,145,824,947,123,34,34,752,752,0,0.0004765308553728854,0.0005105687736138058,721,730,9,4,3,3,4,8,542,286,598
164,21,123,737,955,218,24,24,801,801,0,0.0005105687736138058,0.0007147962830593281,723,770,47,4,3,3,3,4,871,312,637
165,16,118,636,930,294,36,36,739,739,0,0.0008169100377820892,0.0008509479560230097,783,788,5,4,4,4,6,6,764,490,230
166,12,218,598,974,376,14,14,554,554,0,6.807583648184077e-05,0.0012934408931549745,451,845,394,3,4,4,3,3,801,496,213
167,3,3,426,426,0,7,7,401,401,0,0.0,0.0,1,1,0,-1,5,5,4,5,458,225,633
168,54,156,772,922,150,128,128,776,776,0,0.0008169100377820892,0.0008169100377820892,750,750,0,4,3,3,16,8,195,264,607
169,0,206,1,965,964,0,14,1,415,414,0.0,0.00010211375472276115,1,475,474,3,-1,4,7,0,141,845,410
170,2,208,366,973,607,5,14,385,552,167,6.807583648184077e-05,0.0014636304843595766,446,854,408,3,5,4,3,1,791,421,38
171,18,120,601,900,299,88,88,734,734,0,0.0004084550188910446,0.0004084550188910446,677,677,0,4,3,3,12,2,96,101,527
172,2,208,353,957,604,11,21,365,423,58,3.4037918240920386e-05,0.0005105687736138058,402,710,308,3,5,4,9,1,245,593,175
173,18,18,687,687,0,14,14,559,559,0,0.0002723033459273631,0.0002723033459273631,621,621,0,-1,4,4,3,10,833,266,730
174,6,108,467,936,469,13,14,502,529,27,0.00013615167296368154,0.0006807583648184077,523,754,231,4,4,4,5,2,695,691,396
175,0,101,1,926,925,0,5,1,331,330,0.0,0.0,1,1,0,6,-1,7,5,3,647,882,748
176,0,102,1,903,902,0,11,1,405,404,0.0,0.00010211375472276115,1,477,476,4,-1,5,6,0,451,973,741
177,0,102,1,957,956,0,6,1,456,455,0.0,0.0005105687736138058,1,714,713,4,-1,5,3,0,850,907,145
178,10,216,508,956,448,44,52,565,615,50,0.0002382654276864427,0.0020082371762143027,578,877,299,3,4,4,10,5,254,722,85
179,38,140,719,905,186,118,118,796,796,0,0.0008169100377820892,0.00088498587426393,772,782,10,4,3,3,13,6,41,494,829
180,0,0,1,1,0,0,0,1,1,0,0.0,0.0,1,1,0,-1,-1,-1,2,0,830,848,792
181,7,109,513,922,409,16,16,511,511,0,0.00010211375472276115,0.00013615167296368154,474,504,30,4,4,4,4,3,832,631,468
182,6,108,453,928,475,9,10,462,472,10,3.4037918240920386e-05,0.00037441710065012424,401,671,270,4,4,4,3,2,585,518,272
183,0,0,1,1,0,0,0,1,1,0,0.0,0.0,1,1,0,-1,-1,-1,2,0,807,943,976
184,25,127,821,972,151,12,12,713,713,0,0.0008169100377820892,0.0010211375472276116,789,815,26,4,4,4,2,14,963,175,149
185,0,0,1,1,0,0,0,1,1,0,0.0,0.0,1,1,0,-1,-1,-1,5,0,557,912,871
186,16,118,618,928,310,40,40,747,747,0,0.0004765308553728854,0.0005105687736138058,707,727,20,4,3,3,5,1,665,480,361
187,9,9,652,652,0,8,8,614,614,0,0.00017018959120460194,0.00017018959120460194,569,569,0,-1,4,4,2,3,987,280,977
188,5,106,525,962,437,4,4,439,439,0,3.4037918240920386e-05,6.807583648184077e-05,417,454,37,5,5,5,2,3,997,214,485
189,6,212,478,977,499,10,14,506,586,80,0.0002382654276864427,0.0020763130126961434,593,902,309,3,4,4,3,1,748,659,60
190,0,206,1,948,947,0,24,1,417,416,0.0,0.0002042275094455223,1,551,550,3,-1,4,11,0,163,933,391
191,0,206,1,960,959,0,25,1,463,462,0.0,0.0005105687736138058,1,702,701,3,-1,4,9,0,395,960,232
192,1,103,331,914,583,6,7,331,357,26,0.0,3.4037918240920386e-05,1,413,412,4,6,5,6,1,446,437,544
193,100,100,862,862,0,100,100,645,645,0,0.021784267674189048,0.0228734810578985,998,999,1,2,1,1,17,91,71,7,177
194,334,436,991,996,5,72,72,995,995,0,0.020865243881684196,0.020933319718166036,996,996,0,4,2,2,3,75,867,24,710
195,88,294,882,979,97,66,66,864,864,0,0.0021784267674189047,0.0032336022328874367,891,935,44,3,3,3,6,15,267,158,612
196,96,712,859,995,136,186,186,953,953,0,0.0037441710065012424,0.010041185881071514,936,975,39,2,2,2,12,6,292,73,18
197,2,2,359,359,0,12,12,416,416,0,3.4037918240920386e-05,3.4037918240920386e-05,403,403,0,-1,5,5,6,2,489,342,850
198,108,210,874,942,68,184,184,875,875,0,0.0013955546478777359,0.0015657442390823377,847,860,13,4,2,2,15,10,77,405,401
199,67,169,899,969,70,28,28,855,855,0,0.002314578440382586,0.002382654276864427,908,911,3,4,3,3,3,17,674,85,406
200,0,0,1,1,0,0,0,1,1,0,0.0,0.0,1,1,0,-1,-1,-1,10,0,285,702,693
201,16,16,644,644,0,20,20,733,733,0,0.00017018959120460194,0.00017018959120460194,542,542,0,-1,3,3,3,2,842,714,903
202,1,1,332,332,0,3,3,332,332,0,3.4037918240920386e-05,3.4037918240920386e-05,403,403,0,-1,6,6,3,2,583,692,823
203,44,145,752,920,168,62,62,612,612,0,0.0002042275094455223,0.0002042275094455223,566,566,0,5,3,3,12,13,183,256,893
204,15,221,634,971,337,18,18,624,624,0,0.0002723033459273631,0.002757071377514551,612,910,298,3,4,4,3,4,554,164,108
205,2,104,361,915,554,6,6,396,396,0,6.807583648184077e-05,0.0009870996289866913,443,814,371,4,5,5,3,1,892,862,415
206,16,16,529,529,0,60,60,508,508,0,0.00013615167296368154,0.00013615167296368154,513,513,0,-1,4,4,16,4,59,315,895
207,10,10,570,570,0,18,18,637,637,0,0.00034037918240920387,0.00034037918240920387,643,643,0,-1,4,4,3,3,577,268,977
208,0,102,1,943,942,0,4,1,426,425,0.0,0.0005786446100956465,1,736,735,4,-1,5,2,0,896,546,232
209,0,206,1,979,978,0,10,1,517,516,0.0,0.0006467204465774873,1,749,748,3,-1,4,3,0,902,826,642
210,72,174,870,959,89,50,50,825,825,0,0.001599782157323258,0.001599782157323258,858,858,0,4,3,3,5,13,605,261,152
211,0,206,1,954,953,0,27,1,449,448,0.0,0.00030634126416828345,1,615,614,3,-1,4,10,1,153,705,132
212,0,206,1,947,946,0,44,1,510,509,0.0,0.0012253650566731338,1,821,820,3,-1,4,12,0,292,917,261
213,2,208,371,975,604,4,14,374,619,245,0.0,0.001599782157323258,1,866,865,3,5,4,3,1,523,924,119
214,0,102,1,893,892,0,11,1,373,372,0.0,0.00017018959120460194,1,553,552,4,-1,5,8,0,186,940,524
215,143,343,953,988,35,68,68,969,969,0,0.005037611899656217,0.0053099152455835805,957,959,2,3,2,2,4,26,597,112,379
216,0,206,1,946,945,0,29,1,406,405,0.0,6.807583648184077e-05,1,442,441,3,-1,4,13,0,92,201,553
217,15,15,714,714,0,8,8,562,562,0,0.00030634126416828345,0.00030634126416828345,655,655,0,-1,4,4,2,7,994,188,731
218,351,557,980,991,11,104,104,978,978,0,0.008339289969025495,0.008611593314952858,976,978,2,3,2,2,5,45,793,77,29
219,0,616,1,991,990,0,35,1,494,493,0.0,0.0004765308553728854,1,691,690,2,-1,3,11,0,234,961,215
220,2,208,367,969,602,6,10,406,466,60,0.00013615167296368154,0.0002042275094455223,514,570,56,3,5,4,3,1,703,452,215
221,1,617,333,988,655,20,148,333,758,425,0.0,0.0053099152455835805,1,948,947,2,6,3,20,1,88,972,14
222,2,2,356,356,0,11,11,382,382,0,0.0,0.0,1,1,0,-1,5,5,7,1,273,837,835
223,0,206,1,959,958,0,44,1,605,604,0.0,0.002110350930937064,1,884,883,3,-1,4,10,0,527,938,135
224,52,52,796,796,0,70,70,737,737,0,0.0009870996289866913,0.0009870996289866913,804,804,0,-1,3,3,9,9,274,242,254
225,6,6,444,444,0,11,11,453,453,0,3.4037918240920386e-05,3.4037918240920386e-05,412,412,0,-1,4,4,4,2,649,662,887
226,0,101,1,912,911,0,6,1,330,329,0.0,0.0,1,1,0,6,-1,7,6,0,522,620,344
227,0,206,1,946,945,0,42,1,502,501,0.0,0.0009870996289866913,1,800,799,3,-1,4,11,0,66,955,131
228,105,207,936,975,39,38,38,886,886,0,0.004731270635487933,0.004935498144933456,949,952,3,4,3,3,3,31,670,126,827
229,8,110,541,926,385,12,12,491,491,0,0.00010211375472276115,0.00013615167296368154,490,524,34,4,4,4,4,3,397,361,627
230,2,2,355,355,0,16,16,401,401,0,3.4037918240920386e-05,3.4037918240920386e-05,414,414,0,-1,5,5,9,2,180,842,888
231,52,52,817,817,0,52,52,707,707,0,0.0011232513019503727,0.0011232513019503727,819,819,0,-1,3,3,7,9,591,130,939
232,26,232,795,983,188,12,12,673,673,0,0.0005446066918547262,0.0015657442390823377,726,877,151,3,4,4,2,8,951,187,335
233,0,0,1,1,0,0,0,1,1,0,0.0,0.0,1,1,0,-1,-1,-1,4,3,754,854,538
234,29,235,745,974,229,36,36,746,746,0,0.0007147962830593281,0.0014295925661186562,762,851,89,3,3,3,5,5,519,591,218
235,40,656,759,995,236,68,102,705,857,152,0.0012934408931549745,0.0048674223084516155,821,952,131,2,2,2,11,1,379,322,31
236,0,0,1,1,0,0,0,1,1,0,0.0,0.0,1,1,0,-1,-1,-1,9,0,388,951,950
237,0,101,1,913,912,0,4,1,332,331,0.0,0.0,1,1,0,5,-1,6,4,0,512,886,321
238,112,318,918,979,61,46,46,733,733,0,0.002484768031587188,0.002995336805200994,914,922,8,3,3,3,6,20,341,94,154
239,6,108,435,918,483,20,20,496,496,0,0.00010211375472276115,0.0002723033459273631,487,610,123,4,4,4,6,2,515,492,527
240,40,141,780,933,153,56,56,763,763,0,0.0005105687736138058,0.0005105687736138058,720,720,0,6,3,3,6,5,368,283,663
241,16,222,484,941,457,69,84,466,505,39,0.0002042275094455223,0.0004084550188910446,549,671,122,3,3,3,23,2,4,654,610
242,266,266,992,992,0,32,32,963,963,0,0.012015385139044895,0.012015385139044895,983,983,0,-1,3,3,2,85,847,0,359
243,32,238,699,961,262,72,72,711,711,0,0.0006126825283365669,0.0007828721195411688,714,755,41,3,3,3,11,9,271,145,258
244,95,197,906,969,63,80,80,951,951,0,0.0035059055788147996,0.003608019333537561,932,934,2,4,2,2,5,13,662,183,323
245,6,6,432,432,0,14,14,457,457,0,6.807583648184077e-05,6.807583648184077e-05,450,450,0,-1,4,4,5,1,492,555,483
246,8,8,553,553,0,8,8,488,488,0,0.000442492937131965,0.000442492937131965,696,696,0,-1,4,4,2,3,705,525,638
247,0,102,1,937,936,0,4,1,406,405,0.0,0.00013615167296368154,1,539,538,4,-1,5,2,0,948,715,220
248,0,0,1,1,0,0,0,1,1,0,0.0,0.0,1,1,0,-1,-1,-1,6,0,341,675,457
249,26,226,676,958,282,46,46,589,589,0,0.0004765308553728854,0.0016678579938050988,700,862,162,3,4,4,9,7,277,303,147
250,580,780,995,999,4,152,152,983,983,0,0.012117498893767658,0.013853432724054596,985,988,3,3,2,2,8,83,257,10,47
251,32,32,712,712,0,70,70,775,775,0,0.0006467204465774873,0.0006467204465774873,737,737,0,-1,3,3,8,2,411,453,583
252,0,206,1,972,971,0,12,1,468,467,0.0,0.0005446066918547262,1,728,727,3,-1,4,4,0,649,866,242
253,22,638,643,991,348,106,116,842,880,38,0.0011232513019503727,0.002586881786309949,817,906,89,2,3,3,11,5,234,412,153
254,0,0,1,1,0,0,0,1,1,0,0.0,0.0,1,1,0,-1,-1,-1,2,1,988,948,822
255,8,624,510,995,485,16,42,454,709,255,0.0002042275094455223,0.0023486163586235067,567,896,329,2,4,3,6,5,387,231,68
256,0,616,1,997,996,0,18,1,644,643,0.0,0.002484768031587188,1,909,908,2,-1,3,3,1,626,738,756
257,30,30,774,774,0,28,28,773,773,0,0.0004084550188910446,0.0004084550188910446,684,684,0,-1,3,3,3,6,780,107,923
258,0,616,1,995,994,0,29,1,590,589,0.0,0.0011913271384322134,1,823,822,2,-1,3,6,0,345,844,727
259,8,214,552,972,420,14,14,548,548,0,0.00010211375472276115,0.0010892133837094523,482,825,343,3,4,4,3,2,923,724,397
260,110,212,902,960,58,98,98,879,879,0,0.0020763130126961434,0.002144388849177984,894,896,2,4,3,3,8,19,428,297,592
261,0,616,1,996,995,0,22,1,639,638,0.0,0.0012934408931549745,1,841,840,2,-1,3,4,2,917,462,169
262,0,0,1,1,0,0,0,1,1,0,0.0,0.0,1,1,0,-1,-1,-1,5,0,724,906,967
263,2,104,368,939,571,6,6,436,436,0,0.00013615167296368154,0.0002723033459273631,525,631,106,4,5,5,3,1,825,481,263
264,10,112,497,883,386,29,29,418,418,0,0.00013615167296368154,0.00034037918240920387,504,636,132,4,4,4,13,3,120,534,197
265,0,0,1,1,0,0,0,1,1,0,0.0,0.0,1,1,0,-1,-1,-1,6,2,518,752,818
266,151,253,910,955,45,196,196,906,906,0,0.0026209197045508697,0.0026549576227917903,908,910,2,4,3,3,16,18,27,63,837
267,6,6,410,410,0,30,30,485,485,0,6.807583648184077e-05,6.807583648184077e-05,445,445,0,-1,4,4,9,2,192,648,959
268,0,206,1,977,976,0,16,1,610,609,0.0,0.0010892133837094523,1,820,819,3,-1,4,4,0,754,802,91
269,0,0,1,1,0,0,0,1,1,0,0.0,0.0,1,1,0,-1,-1,-1,2,0,776,429,773
270,112,318,900,977,77,102,102,908,908,0,0.002110350930937064,0.003199564314646516,888,927,39,3,2,2,8,14,236,146,118
271,30,30,680,680,0,140,140,834,834,0,0.0009870996289866913,0.0009870996289866913,794,794,0,-1,3,3,15,4,45,207,707
272,0,1640,1,1000,999,0,62,1,683,682,0.0,0.010449640899962559,1,979,978,1,-1,2,10,0,169,976,339
273,6,6,429,429,0,16,16,519,519,0,0.0002042275094455223,0.0002042275094455223,575,575,0,-1,4,4,4,1,694,797,782
274,14,220,622,973,351,12,16,481,529,48,0.00013615167296368154,0.00034037918240920387,514,642,128,3,4,4,4,3,424,526,260
275,52,52,826,826,0,38,38,705,705,0,0.0012934408931549745,0.0012934408931549745,833,833,0,-1,3,3,6,12,446,67,800
276,0,0,1,1,0,0,0,1,1,0,0.0,0.0,1,1,0,-1,-1,-1,13,1,129,738,779
277,6,6,444,444,0,12,12,463,463,0,0.00010211375472276115,0.00010211375472276115,494,494,0,-1,4,4,4,3,969,285,766
278,0,206,1,941,940,0,43,1,462,461,0.0,0.0002382654276864427,1,582,581,3,-1,4,16,0,134,774,759
279,77,178,852,947,95,64,64,719,719,0,0.0010892133837094523,0.0011232513019503727,807,811,4,5,3,3,9,16,262,113,265
280,90,90,898,898,0,50,50,850,850,0,0.0024507301133462676,0.0024507301133462676,908,908,0,-1,3,3,5,19,688,72,814
281,115,217,974,990,16,12,12,785,785,0,0.004935498144933456,0.005582218591510943,961,967,6,4,4,4,2,45,936,77,139
282,10,216,564,972,408,16,16,523,523,0,0.000442492937131965,0.0010211375472276116,689,810,121,3,4,4,4,6,815,447,186
283,95,711,904,998,94,40,40,844,844,0,0.0014636304843595766,0.0030974505599237552,863,929,66,2,3,3,4,18,949,148,438
284,76,76,874,874,0,56,56,822,822,0,0.0011232513019503727,0.0011232513019503727,827,827,0,-1,3,3,6,20,451,189,757
285,0,0,1,1,0,0,0,1,1,0,0.0,0.0,1,1,0,-1,-1,-1,4,0,532,800,388
286,34,136,796,954,158,34,34,817,817,0,0.0006467204465774873,0.001055175465468532,750,818,68,4,3,3,4,4,511,470,345
287,0,206,1,944,943,0,28,1,403,402,0.0,0.00010211375472276115,1,470,469,3,-1,4,13,0,115,760,450
288,0,0,1,1,0,0,0,1,1,0,0.0,0.0,1,1,0,-1,-1,-1,16,0,78,826,888
289,0,0,1,1,0,0,0,1,1,0,0.0,0.0,1,1,0,-1,-1,-1,18,0,86,678,498
290,0,102,1,885,884,0,13,1,359,358,0.0,0.0,1,1,0,4,-1,5,11,0,167,520,337
291,0,206,1,952,951,0,41,1,517,516,0.0,0.0006126825283365669,1,725,724,3,-1,4,11,0,220,867,125
292,0,616,1,991,990,0,140,1,855,854,0.0,0.01147077844719017,1,982,981,2,-1,3,14,1,181,747,3
293,22,124,658,923,265,50,50,689,689,0,0.0002382654276864427,0.0002723033459273631,586,603,17,4,3,3,8,3,146,300,617
294,74,176,880,962,82,22,22,741,741,0,0.0014636304843595766,0.0015317063208414173,850,857,7,4,3,3,2,13,905,261,223
295,69,69,834,834,0,86,86,775,775,0,0.0013615167296368155,0.0013615167296368155,837,837,0,-1,2,2,10,9,206,391,752
296,6,6,434,434,0,15,15,454,454,0,6.807583648184077e-05,6.807583648184077e-05,456,456,0,-1,4,4,6,1,267,552,872
297,0,102,1,883,882,0,16,1,359,358,0.0,3.4037918240920386e-05,1,386,385,4,-1,5,14,0,172,942,743
298,0,101,1,944,943,0,2,1,331,330,0.0,0.0,1,1,0,7,-1,8,2,0,548,897,582
299,0,616,1,987,986,0,44,1,467,466,0.0,0.0002382654276864427,1,580,579,2,-1,3,14,1,122,814,553
300,2,104,361,901,540,15,15,423,423,0,0.0,0.0,1,1,0,4,5,5,8,2,449,419,347
301,1,1,333,333,0,14,14,333,333,0,0.0,0.0,1,1,0,-1,6,6,14,2,144,344,838
302,0,0,1,1,0,0,0,1,1,0,0.0,0.0,1,1,0,-1,-1,-1,3,0,927,657,757
303,0,0,1,1,0,0,0,1,1,0,0.0,0.0,1,1,0,-1,-1,-1,2,0,781,446,686
304,22,228,757,980,223,18,18,809,809,0,0.00037441710065012424,0.0008509479560230097,690,807,117,3,3,3,2,2,283,468,216
305,35,137,764,934,170,26,26,565,565,0,0.0005105687736138058,0.0005786446100956465,707,727,20,4,4,4,5,8,347,284,710
306,0,0,1,1,0,0,0,1,1,0,0.0,0.0,1,1,0,-1,-1,-1,4,0,759,886,744
307,108,108,886,886,0,144,144,850,850,0,0.0013615167296368155,0.0013615167296368155,849,849,0,-1,3,3,14,18,332,148,753
308,0,0,1,1,0,0,0,1,1,0,0.0,0.0,1,1,0,-1,-1,-1,3,0,901,934,817
309,0,0,1,1,0,0,0,1,1,0,0.0,0.0,1,1,0,-1,-1,-1,2,0,976,966,760
310,0,0,1,1,0,0,0,1,1,0,0.0,0.0,1,1,0,-1,-1,-1,3,1,837,529,977
311,6,622,436,997,561,12,22,559,709,150,0.00010211375472276115,0.008986010415602982,477,981,504,2,4,3,2,1,893,720,23
312,67,67,875,875,0,36,36,782,782,0,0.0014295925661186562,0.0014295925661186562,855,855,0,-1,3,3,5,19,574,59,643
313,41,142,852,970,118,12,12,666,666,0,0.0008169100377820892,0.0008169100377820892,790,790,0,5,4,4,2,14,548,139,585
314,3,209,444,978,534,4,8,401,489,88,3.4037918240920386e-05,0.0006467204465774873,408,751,343,3,5,4,2,3,689,434,242
315,6,108,482,948,466,7,8,498,511,13,6.807583648184077e-05,0.0004765308553728854,448,707,259,4,4,4,2,1,910,878,257
316,2,2,357,357,0,7,7,402,402,0,0.0,0.0,1,1,0,-1,5,5,4,2,635,615,990
317,6,108,433,914,481,16,16,464,464,0,0.0,0.0,1,1,0,4,4,4,6,1,266,531,210
318,0,206,1,971,970,0,8,1,438,437,0.0,0.00034037918240920387,1,639,638,3,-1,4,2,0,893,750,584
319,48,254,751,955,204,100,108,651,693,42,0.00030634126416828345,0.00088498587426393,632,788,156,3,3,3,16,7,53,389,234
320,5,107,466,936,470,8,8,442,442,0,0.00034037918240920387,0.00037441710065012424,652,667,15,4,5,5,4,4,581,278,223
321,70,172,898,970,72,22,22,787,787,0,0.0017018959120460194,0.0029612988869600733,879,931,52,4,3,3,2,18,804,64,203
322,100,100,873,873,0,100,100,768,768,0,0.01494264610776405,0.01494264610776405,992,992,0,5,1,1,13,36,242,48,563
323,47,47,733,733,0,110,110,639,639,0,0.0007488342013002485,0.0007488342013002485,735,735,0,-1,2,2,19,4,83,278,712
324,38,38,869,869,0,12,12,732,732,0,0.00088498587426393,0.00088498587426393,809,809,0,-1,4,4,2,15,481,92,777
325,0,0,1,1,0,0,0,1,1,0,0.0,0.0,1,1,0,-1,-1,-1,9,0,119,614,664
326,0,206,1,955,954,0,21,1,408,407,0.0,0.00013615167296368154,1,506,505,3,-1,4,10,0,125,587,22
327,1,103,332,929,597,4,7,332,401,69,0.0,0.00013615167296368154,1,517,516,4,6,5,4,4,635,595,107
328,57,673,846,998,152,30,30,746,746,0,0.0013615167296368155,0.003369753905851118,845,935,90,2,3,3,4,12,659,99,143
329,39,39,857,857,0,22,22,859,859,0,0.0007488342013002485,0.0007488342013002485,775,775,0,-1,3,3,2,9,792,375,678
330,0,206,1,965,964,0,12,1,462,461,0.0,0.00034037918240920387,1,634,633,3,-1,4,4,0,832,908,136
331,0,102,1,907,906,0,7,1,383,382,0.0,0.00010211375472276115,1,487,486,4,-1,5,4,0,448,969,666
332,36,137,741,916,175,92,92,889,889,0,0.0010892133837094523,0.0011232513019503727,815,818,3,5,3,3,7,6,296,471,466
333,0,0,1,1,0,0,0,1,1,0,0.0,0.0,1,1,0,-1,-1,-1,19,0,36,887,707
334,0,206,1,976,975,0,10,1,532,531,0.0,0.001055175465468532,1,825,824,3,-1,4,3,0,899,897,71
335,0,102,1,913,912,0,7,1,370,369,0.0,0.00010211375472276115,1,485,484,4,-1,5,5,0,605,707,840
336,6,622,378,990,612,58,84,462,548,86,3.4037918240920386e-05,0.0007147962830593281,392,745,353,2,4,3,19,1,11,873,306
337,2,103,361,914,553,4,4,362,362,0,0.0,0.0,1,1,0,5,5,5,3,1,892,543,896
338,53,259,809,968,159,58,58,767,767,0,0.00088498587426393,0.0015317063208414173,784,850,66,3,3,3,7,8,472,284,137
339,4,210,466,978,512,4,8,417,519,102,0.0,0.0006807583648184077,1,750,749,3,5,4,2,3,999,580,137
340,0,101,1,889,888,0,7,1,330,329,0.0,0.0,1,1,0,5,-1,6,7,0,372,498,402
341,0,0,1,1,0,0,0,1,1,0,0.0,0.0,1,1,0,-1,-1,-1,3,0,875,846,737
342,0,0,1,1,0,0,0,1,1,0,0.0,0.0,1,1,0,-1,-1,-1,13,0,92,201,985
343,0,0,1,1,0,0,0,1,1,0,0.0,0.0,1,1,0,-1,-1,-1,3,0,628,860,789
344,22,22,731,731,0,22,22,771,771,0,0.0002042275094455223,0.0002042275094455223,577,577,0,-1,3,3,2,4,586,551,825
345,19,120,787,969,182,12,12,755,755,0,0.00088498587426393,0.00088498587426393,805,805,0,6,4,4,2,11,987,193,739
346,0,0,1,1,0,0,0,1,1,0,0.0,0.0,1,1,0,-1,-1,-1,8,0,308,750,963
347,0,206,1,969,968,0,10,1,456,455,0.0,0.0004765308553728854,1,692,691,3,-1,4,3,0,989,324,386
348,0,102,1,911,910,0,10,1,395,394,0.0,0.00037441710065012424,1,663,662,4,-1,5,6,0,251,665,869
349,0,0,1,1,0,0,0,1,1,0,0.0,0.0,1,1,0,-1,-1,-1,2,0,596,839,815
350,164,266,910,952,42,220,220,870,870,0,0.002144388849177984,0.0022465026039007454,888,892,4,4,3,3,20,17,5,96,310
351,274,480,970,987,17,176,176,955,955,0,0.004731270635487933,0.005548180673270023,954,959,5,3,2,2,12,31,212,76,174
352,0,0,1,1,0,0,0,1,1,0,0.0,0.0,1,1,0,-1,-1,-1,8,1,225,472,948
353,19,120,740,960,220,24,24,831,831,0,0.0006467204465774873,0.0006467204465774873,756,756,0,5,3,3,3,3,718,653,558
354,160,366,946,980,34,64,64,906,906,0,0.003165526396405596,0.004152626025392287,937,950,13,3,3,3,4,19,410,133,97
355,6,212,384,943,559,43,48,438,469,31,3.4037918240920386e-05,0.000442492937131965,400,672,272,3,4,4,16,1,53,799,376
356,0,102,1,946,945,0,4,1,374,373,0.0,0.00030634126416828345,1,644,643,4,-1,5,3,0,600,445,308
357,0,206,1,967,966,0,18,1,513,512,0.0,0.002110350930937064,1,884,883,3,-1,4,5,0,604,945,8
358,23,229,737,975,238,26,26,660,660,0,0.0008509479560230097,0.0015657442390823377,792,864,72,3,4,4,5,7,647,399,217
359,2,104,391,967,576,4,4,471,471,0,0.0002042275094455223,0.0013615167296368155,584,853,269,4,5,5,2,3,873,309,55
360,2,618,357,995,638,14,32,420,604,184,3.4037918240920386e-05,0.001497668402600497,401,854,453,2,5,3,7,1,335,870,60
361,70,276,855,976,121,74,74,847,847,0,0.0016338200755641784,0.002110350930937064,866,887,21,3,3,3,8,11,158,166,326
362,6,212,429,961,532,38,38,630,630,0,0.00030634126416828345,0.002382654276864427,628,900,272,3,4,4,7,1,364,404,123
363,14,116,702,966,264,4,4,442,442,0,0.0002723033459273631,0.0005446066918547262,618,728,110,4,5,5,2,9,982,240,386
364,10,10,538,538,0,29,29,555,555,0,0.0002382654276864427,0.0002382654276864427,584,584,0,-1,4,4,7,4,413,230,926
365,8,624,488,992,504,31,54,485,627,142,3.4037918240920386e-05,0.002484768031587188,406,899,493,2,4,3,10,2,272,244,129
366,118,324,912,980,68,94,94,872,872,0,0.002927260968719153,0.0032336022328874367,918,924,6,3,3,3,9,17,190,45,115
367,118,118,933,933,0,54,54,907,907,0,0.0027911092957554717,0.0027911092957554717,916,916,0,-1,3,3,4,20,815,94,922
368,0,206,1,961,960,0,21,1,481,480,0.0,0.000442492937131965,1,686,685,3,-1,4,7,0,170,707,233
369,0,0,1,1,0,0,0,1,1,0,0.0,0.0,1,1,0,-1,-1,-1,8,3,317,854,875
370,0,102,1,883,882,0,16,1,376,375,0.0,0.0002382654276864427,1,584,583,4,-1,5,10,1,240,539,368
371,0,206,1,977,976,0,14,1,565,564,0.0,0.0015317063208414173,1,870,869,3,-1,4,3,0,958,868,153
372,8,109,593,957,364,8,8,550,550,0,0.00010211375472276115,0.00010211375472276115,488,488,0,7,4,4,2,3,946,508,540
373,299,400,981,989,8,48,48,933,933,0,0.008305252050784574,0.008271214132543654,978,978,0,5,3,3,3,59,726,6,518
374,0,101,1,945,944,0,2,1,332,331,0.0,6.807583648184077e-05,1,448,447,5,-1,6,2,0,232,907,654
375,890,991,996,998,2,464,464,993,993,0,0.012696143503863304,0.012696143503863304,989,989,0,5,2,2,23,83,57,10,603
376,9,110,581,946,365,4,4,426,426,0,0.0005105687736138058,0.0005105687736138058,713,713,0,5,5,5,2,7,609,303,526
377,0,0,1,1,0,0,0,1,1,0,0.0,0.0,1,1,0,-1,-1,-1,7,0,472,715,702
378,16,222,644,976,332,20,24,732,733,1,0.0002382654276864427,0.0011913271384322134,607,833,226,3,3,3,3,1,680,618,559
379,1,1,333,333,0,3,3,333,333,0,0.0,0.0,1,1,0,-1,6,6,3,1,676,896,987
380,0,206,1,969,968,0,14,1,464,463,0.0,0.00013615167296368154,1,520,519,3,-1,4,6,0,764,400,541
381,0,0,1,1,0,0,0,1,1,0,0.0,0.0,1,1,0,-1,-1,-1,4,0,603,997,967
382,0,0,1,1,0,0,0,1,1,0,0.0,0.0,1,1,0,-1,-1,-1,5,0,744,388,664
383,33,239,740,969,229,62,62,745,745,0,0.00030634126416828345,0.0004084550188910446,631,665,34,3,3,3,9,4,278,339,553
384,72,278,909,988,79,22,22,843,843,0,0.00176997174852786,0.0033016780693692774,882,934,52,3,3,3,2,16,942,78,403
385,0,102,1,887,886,0,15,1,387,386,0.0,0.00010211375472276115,1,478,477,4,-1,5,9,1,269,428,248
386,0,102,1,883,882,0,20,1,374,373,0.0,3.4037918240920386e-05,1,406,405,4,-1,5,14,0,144,993,239
387,22,638,597,990,393,61,72,486,516,30,3.4037918240920386e-05,0.0005786446100956465,404,720,316,2,3,3,21,3,2,290,354
388,17,119,698,947,249,20,20,776,776,0,6.807583648184077e-05,0.0008509479560230097,451,806,355,4,3,3,3,2,826,244,79
389,0,0,1,1,0,0,0,1,1,0,0.0,0.0,1,1,0,-1,-1,-1,4,0,659,969,446
390,22,22,643,643,0,54,54,661,661,0,0.00037441710065012424,0.00037441710065012424,666,666,0,-1,3,3,8,3,231,197,845
391,6,212,411,957,546,43,52,589,655,66,0.0002042275094455223,0.0028591851322373124,568,913,345,3,4,4,10,2,243,384,75
392,0,102,1,916,915,0,6,1,369,368,0.0,0.0002382654276864427,1,597,596,4,-1,5,5,0,570,812,524
393,0,102,1,934,933,0,6,1,395,394,0.0,0.00013615167296368154,1,527,526,4,-1,5,4,0,721,620,302
394,1,1,333,333,0,18,18,333,333,0,0.0,0.0,1,1,0,-1,6,6,18,3,34,626,939
395,12,628,524,992,468,35,50,480,557,77,3.4037918240920386e-05,0.0013274788113958951,396,832,436,2,4,3,12,2,187,576,116
396,7,109,516,928,412,12,12,458,458,0,0.00013615167296368154,0.0002382654276864427,520,587,67,4,4,4,4,2,709,724,408
397,4,4,440,440,0,4,4,411,411,0,0.00017018959120460194,0.00017018959120460194,538,538,0,-1,5,5,2,2,733,697,271
398,50,256,829,974,145,38,38,644,644,0,0.0008509479560230097,0.0013955546478777359,781,848,67,3,4,4,7,12,342,99,312
399,0,206,1,954,953,0,36,1,468,467,0.0,0.0005105687736138058,1,689,688,3,-1,4,12,1,348,641,268
400,0,206,1,956,955,0,19,1,422,421,0.0,0.0002382654276864427,1,595,594,3,-1,4,9,0,200,976,634
401,44,44,813,813,0,30,30,737,737,0,0.0008169100377820892,0.0008169100377820892,782,782,0,-1,3,3,4,4,539,40,959
402,80,286,851,975,124,72,72,822,822,0,0.001157289220191293,0.0023486163586235067,819,905,86,3,3,3,7,9,374,130,67
403,0,102,1,907,906,0,12,1,418,417,0.0,0.0005105687736138058,1,710,709,4,-1,5,6,0,275,983,294
404,78,694,842,996,154,96,100,847,861,14,0.0009870996289866913,0.002757071377514551,789,907,118,2,3,3,10,9,169,242,97
405,0,206,1,959,958,0,14,1,432,431,0.0,0.00013615167296368154,1,515,514,3,-1,4,6,0,536,889,86
406,24,24,712,712,0,44,44,877,877,0,0.0012934408931549745,0.0012934408931549745,841,841,0,-1,3,3,4,4,520,281,675
407,22,124,662,912,250,30,30,549,549,0,6.807583648184077e-05,0.0002042275094455223,448,570,122,4,3,3,8,4,488,164,360
408,46,252,745,964,219,88,120,644,766,122,0.0007828721195411688,0.0029612988869600733,755,924,169,3,2,2,15,4,107,239,56
409,8,109,542,933,391,15,15,552,552,0,0.00010211375472276115,0.0002382654276864427,487,609,122,5,4,4,4,3,543,496,549
410,38,654,695,993,298,78,110,634,794,160,0.0004765308553728854,0.003267640151128357,687,927,240,2,3,3,13,5,92,710,88
411,85,291,890,981,91,44,44,806,806,0,0.0010892133837094523,0.0020422750944552232,816,885,69,3,3,3,4,15,822,219,53
412,12,114,571,912,341,26,26,481,481,0,0.00013615167296368154,0.0002042275094455223,521,566,45,4,4,4,11,4,261,315,486
413,18,120,694,949,255,12,12,600,600,0,0.0002042275094455223,0.0010892133837094523,583,838,255,4,4,4,2,6,925,376,53
414,18,119,665,933,268,16,16,544,544,0,0.00013615167296368154,0.00017018959120460194,517,554,37,5,4,4,4,8,593,477,353
415,14,116,552,911,359,50,50,646,646,0,0.00010211375472276115,0.00010211375472276115,479,479,0,4,4,4,9,4,330,501,244
416,12,114,620,940,320,14,14,500,500,0,0.00013615167296368154,0.0004084550188910446,520,676,156,4,4,4,5,4,602,164,308
417,443,649,981,990,9,350,350,988,988,0,0.006262976956329351,0.006773545729943157,963,964,1,3,2,2,18,45,69,77,232
418,3,105,412,903,491,11,16,363,409,46,0.0,3.4037918240920386e-05,1,404,403,4,5,5,9,5,388,605,363
419,1,207,332,973,641,4,10,332,476,144,3.4037918240920386e-05,0.0009190237925048504,408,797,389,3,6,4,4,2,423,739,159
420,0,0,1,1,0,0,0,1,1,0,0.0,0.0,1,1,0,-1,-1,-1,3,0,888,915,745
421,17,118,657,938,281,12,12,559,559,0,0.00017018959120460194,0.0002042275094455223,537,566,29,5,4,4,2,5,893,528,464
422,22,22,728,728,0,14,14,543,543,0,0.000442492937131965,0.000442492937131965,690,690,0,-1,4,4,3,6,626,376,824
423,43,249,802,973,171,36,36,681,681,0,0.0006467204465774873,0.0011913271384322134,746,828,82,3,3,3,5,9,347,211,299
424,108,210,943,978,35,22,22,805,805,0,0.0029612988869600733,0.003199564314646516,930,935,5,4,3,3,2,26,939,108,510
425,6,108,454,933,479,12,12,483,483,0,6.807583648184077e-05,0.0002042275094455223,446,563,117,4,4,4,4,3,660,755,301
426,0,206,1,972,971,0,11,1,466,465,0.0,0.00034037918240920387,1,640,639,3,-1,4,4,0,650,946,408
427,0,0,1,1,0,0,0,1,1,0,0.0,0.0,1,1,0,-1,-1,-1,2,1,849,789,773
428,10,10,474,474,0,112,112,620,620,0,0.0002723033459273631,0.0002723033459273631,601,601,0,-1,4,4,22,4,22,287,996
429,190,292,961,979,18,70,70,929,929,0,0.004561081044283332,0.004629156880765172,949,949,0,4,3,3,5,27,538,88,230
430,101,202,923,973,50,56,56,880,880,0,0.002757071377514551,0.002757071377514551,919,919,0,5,3,3,6,18,594,141,592
431,0,0,1,1,0,0,0,1,1,0,0.0,0.0,1,1,0,-1,-1,-1,6,0,657,794,446
432,1,102,333,915,582,4,4,333,333,0,0.0,0.0,1,1,0,6,6,6,4,4,444,595,763
433,2,2,354,354,0,12,12,384,384,0,0.0,0.0,1,1,0,-1,5,5,8,1,270,402,400
434,100,202,937,979,42,22,22,820,820,0,0.003608019333537561,0.003948398515946765,937,941,4,4,3,3,2,27,977,69,354
435,0,0,1,1,0,0,0,1,1,0,0.0,0.0,1,1,0,-1,-1,-1,2,0,965,803,929
436,89,295,901,983,82,36,36,776,776,0,0.0014636304843595766,0.004935498144933456,857,959,102,3,3,3,5,21,430,157,34
437,45,146,861,967,106,24,24,836,836,0,0.0009190237925048504,0.0009870996289866913,810,820,10,5,3,3,3,11,790,97,487
438,0,0,1,1,0,0,0,1,1,0,0.0,0.0,1,1,0,-1,-1,-1,10,2,256,752,938
439,16,632,605,997,392,28,46,620,790,170,0.0004765308553728854,0.0020422750944552232,703,895,192,2,3,3,5,1,408,420,482
440,50,152,837,944,107,48,48,913,913,0,0.002110350930937064,0.0021784267674189047,894,901,7,4,2,2,3,6,778,234,325
441,0,0,1,1,0,0,0,1,1,0,0.0,0.0,1,1,0,-1,-1,-1,11,0,220,632,919
442,34,240,756,972,216,32,36,674,695,21,0.0004765308553728854,0.00088498587426393,709,792,83,3,3,3,5,6,537,258,610
443,0,101,1,893,892,0,9,1,332,331,0.0,0.0,1,1,0,7,-1,8,9,1,316,913,469
444,0,0,1,1,0,0,0,1,1,0,0.0,0.0,1,1,0,-1,-1,-1,15,0,32,992,754
445,0,206,1,968,967,0,13,1,453,452,0.0,0.00017018959120460194,1,540,539,3,-1,4,5,2,692,462,168
446,56,672,805,993,188,90,112,754,835,81,0.0010211375472276116,0.0048674223084516155,802,955,153,2,2,2,12,6,187,486,16
447,0,0,1,1,0,0,0,1,1,0,0.0,0.0,1,1,0,-1,-1,-1,10,0,241,620,994
448,18,634,654,997,343,30,44,702,835,133,0.00013615167296368154,0.002144388849177984,515,891,376,2,3,3,4,2,717,251,117
449,0,102,1,904,903,0,9,1,379,378,0.0,3.4037918240920386e-05,1,407,406,4,-1,5,6,0,402,908,93
450,0,0,1,1,0,0,0,1,1,0,0.0,0.0,1,1,0,-1,-1,-1,2,0,821,981,835
451,654,756,999,999,0,104,104,991,991,0,0.017257224548146634,0.017257224548146634,993,993,0,4,2,2,5,130,291,3,430
452,12,113,593,928,335,30,30,708,708,0,0.0005786446100956465,0.0006467204465774873,720,738,18,5,4,4,5,3,456,610,596
453,13,13,685,685,0,8,8,552,552,0,0.00037441710065012424,0.00037441710065012424,680,680,0,-1,4,4,2,8,742,132,927
454,37,37,757,757,0,66,66,848,848,0,0.0009190237925048504,0.0009190237925048504,790,790,0,-1,3,3,6,9,255,293,429
455,0,0,1,1,0,0,0,1,1,0,0.0,0.0,1,1,0,-1,-1,-1,2,0,750,865,685
456,0,102,1,886,885,0,12,1,354,353,0.0,3.4037918240920386e-05,1,396,395,4,-1,5,11,0,188,922,935
457,6,107,460,931,471,11,11,478,478,0,0.00017018959120460194,0.00017018959120460194,548,548,0,5,4,4,4,1,682,334,585
458,0,0,1,1,0,0,0,1,1,0,0.0,0.0,1,1,0,-1,-1,-1,23,2,43,775,587
459,40,246,724,957,233,90,90,688,688,0,0.0006467204465774873,0.002314578440382586,738,903,165,3,3,3,14,8,108,345,82
460,0,101,1,949,948,0,2,1,331,330,0.0,0.00010211375472276115,1,482,481,5,-1,6,2,0,809,978,567
461,9,111,511,901,390,24,24,436,436,0,3.4037918240920386e-05,3.4037918240920386e-05,400,400,0,4,4,4,11,3,379,580,594
462,1,103,333,931,598,3,5,333,393,60,0.0,0.0002723033459273631,1,618,617,4,8,5,3,1,670,857,258
463,8,109,526,923,397,30,30,676,676,0,0.0004084550188910446,0.0004084550188910446,674,674,0,6,4,4,5,2,326,700,402
464,0,0,1,1,0,0,0,1,1,0,0.0,0.0,1,1,0,-1,-1,-1,6,0,255,574,984
465,0,102,1,895,894,0,10,1,352,351,0.0,0.0,1,1,0,4,-1,5,9,0,315,986,506
466,120,120,925,925,0,50,50,817,817,0,0.0018040096667687805,0.0018040096667687805,872,872,0,-1,3,3,5,24,173,129,911
467,6,6,427,427,0,26,26,528,528,0,3.4037918240920386e-05,3.4037918240920386e-05,402,402,0,-1,4,4,7,1,413,607,478
468,0,0,1,1,0,0,0,1,1,0,0.0,0.0,1,1,0,-1,-1,-1,2,0,978,731,201
469,6,108,428,903,475,44,44,635,635,0,0.00010211375472276115,0.0002042275094455223,482,571,89,4,4,4,8,1,260,655,691
470,0,206,1,949,948,0,44,1,493,492,0.0,0.0002382654276864427,1,584,583,3,-1,4,14,1,79,705,404
471,0,206,1,954,953,0,18,1,416,415,0.0,0.00034037918240920387,1,642,641,3,-1,4,8,0,434,936,90
472,9,9,545,545,0,16,16,476,476,0,0.00017018959120460194,0.00017018959120460194,557,557,0,-1,4,4,6,3,526,248,852
473,32,133,776,947,171,32,32,733,733,0,0.0007488342013002485,0.0007828721195411688,768,774,6,6,3,3,5,6,765,194,861
474,0,101,1,960,959,0,2,1,331,330,0.0,3.4037918240920386e-05,1,406,405,5,-1,6,2,0,847,880,560
475,0,0,1,1,0,0,0,1,1,0,0.0,0.0,1,1,0,-1,-1,-1,9,2,287,633,901
476,22,228,701,967,266,34,34,738,738,0,0.0006126825283365669,0.0007147962830593281,742,759,17,3,3,3,4,4,532,312,512
477,0,102,1,905,904,0,8,1,381,380,0.0,3.4037918240920386e-05,1,395,394,4,-1,5,5,0,377,574,710
478,309,411,986,989,3,78,78,974,974,0,0.009360427516253106,0.00966676878042139,980,981,1,4,2,2,4,69,682,12,404
479,0,0,1,1,0,0,0,1,1,0,0.0,0.0,1,1,0,-1,-1,-1,9,1,306,779,849
480,0,102,1,940,939,0,3,1,368,367,0.0,6.807583648184077e-05,1,457,456,4,-1,5,2,3,980,746,508
481,0,102,1,912,911,0,7,1,373,372,0.0,6.807583648184077e-05,1,448,447,4,-1,5,5,0,311,686,241
482,14,220,570,962,392,40,40,604,604,0,0.00034037918240920387,0.0007828721195411688,650,760,110,3,4,4,8,3,201,351,306
483,0,0,1,1,0,0,0,1,1,0,0.0,0.0,1,1,0,-1,-1,-1,11,0,155,955,569
484,50,256,850,976,126,36,36,771,771,0,0.0006467204465774873,0.0011232513019503727,743,831,88,3,3,3,5,11,376,52,191
485,0,0,1,1,0,0,0,1,1,0,0.0,0.0,1,1,0,-1,-1,-1,5,0,629,812,801
486,27,129,748,941,193,54,54,881,881,0,0.0006126825283365669,0.0010211375472276116,742,817,75,4,3,3,4,10,532,266,162
487,0,101,1,880,879,0,14,1,332,331,0.0,0.0,1,1,0,5,-1,6,14,1,21,767,460
488,0,101,1,925,924,0,2,1,331,330,0.0,0.00010211375472276115,1,484,483,5,-1,6,2,0,932,831,156
489,47,149,879,971,92,14,14,644,644,0,0.001497668402600497,0.0018720855032506212,860,886,26,4,4,4,3,18,922,64,490
490,2,2,352,352,0,5,5,352,352,0,0.0,0.0,1,1,0,-1,5,5,4,1,503,140,753
491,0,0,1,1,0,0,0,1,1,0,0.0,0.0,1,1,0,-1,-1,-1,24,1,28,660,882
492,2,208,360,974,614,5,14,384,542,158,3.4037918240920386e-05,0.0028932230504782326,402,920,518,3,5,4,3,2,626,690,75
493,0,101,1,938,937,0,3,1,331,330,0.0,0.0,1,1,0,7,-1,8,3,0,888,969,765
494,0,0,1,1,0,0,0,1,1,0,0.0,0.0,1,1,0,-1,-1,-1,2,0,838,984,988
495,32,238,764,972,208,52,52,814,814,0,0.0005446066918547262,0.001497668402600497,715,858,143,3,3,3,6,9,587,212,255
496,9,625,535,995,460,29,56,497,683,186,0.0002382654276864427,0.004935498144933456,597,959,362,2,4,3,9,4,119,319,31
497,296,296,969,969,0,212,212,968,968,0,0.005377991082065421,0.005377991082065421,959,959,0,-1,2,2,13,30,120,75,866
498,0,0,1,1,0,0,0,1,1,0,0.0,0.0,1,1,0,-1,-1,-1,5,0,908,950,513
499,40,246,777,975,198,52,52,729,729,0,0.0007147962830593281,0.0010892133837094523,762,820,58,3,3,3,7,6,320,46,293
500,0,206,1,978,977,0,8,1,507,506,0.0,0.0009870996289866913,1,823,822,3,-1,4,2,0,776,254,67
501,236,236,968,968,0,88,88,963,963,0,0.006501242384015794,0.006501242384015794,971,971,0,-1,2,2,4,31,410,76,812
502,185,391,964,989,25,64,64,940,940,0,0.005786446100956465,0.00616086320160659,966,968,2,3,3,3,4,24,453,8,338
503,2,208,369,973,604,3,14,332,567,235,0.0,0.002280540522141666,1,902,901,3,6,4,3,5,583,605,69
504,9,111,569,935,366,24,24,673,673,0,0.0002382654276864427,0.00034037918240920387,590,656,66,4,4,4,4,4,475,230,710
505,39,141,827,960,133,12,12,616,616,0,0.0012253650566731338,0.0012594029749140542,834,837,3,4,4,4,2,17,937,269,682
506,42,42,705,705,0,128,128,748,748,0,0.00037441710065012424,0.00037441710065012424,641,641,0,-1,3,3,17,6,103,467,973
507,7,213,536,977,441,6,14,418,586,168,0.0002382654276864427,0.001497668402600497,593,868,275,3,5,4,3,4,748,208,174
508,6,212,385,947,562,37,48,418,460,42,6.807583648184077e-05,0.00013615167296368154,442,506,64,3,4,4,18,1,34,592,491
509,0,206,1,976,975,0,13,1,579,578,0.0,0.00030634126416828345,1,639,638,3,-1,4,3,0,835,569,310
510,2,208,382,981,599,6,14,457,643,186,0.00017018959120460194,0.0012253650566731338,558,838,280,3,5,4,3,1,922,420,109
511,72,278,842,972,130,138,138,950,950,0,0.0020082371762143027,0.003948398515946765,889,946,57,3,2,2,9,4,147,281,108
512,6,6,501,501,0,12,12,530,530,0,0.00034037918240920387,0.00034037918240920387,648,648,0,-1,4,4,4,2,738,805,954
513,16,118,587,907,320,34,34,637,637,0,0.00034037918240920387,0.0004084550188910446,645,675,30,4,3,3,6,1,425,370,408
514,32,134,730,930,200,48,48,675,675,0,0.0005786446100956465,0.0005786446100956465,735,735,0,4,3,3,7,7,265,303,935
515,1,207,333,965,632,5,13,333,438,105,0.0,0.0002042275094455223,1,570,569,3,6,4,5,1,555,621,260
516,8,8,500,500,0,19,19,481,481,0,0.00017018959120460194,0.00017018959120460194,523,523,0,-1,4,4,6,3,556,829,953
517,147,249,939,971,32,82,82,855,855,0,0.003437829742332959,0.0035059055788147996,934,934,0,4,3,3,7,26,118,112,493
518,6,622,435,996,561,14,36,483,734,251,0.00013615167296368154,0.005548180673270023,526,967,441,2,4,3,5,1,669,904,70
519,0,0,1,1,0,0,0,1,1,0,0.0,0.0,1,1,0,-1,-1,-1,11,1,333,583,705
520,0,206,1,965,964,0,24,1,611,610,0.0,0.0013274788113958951,1,845,844,3,-1,4,4,0,567,922,158
521,204,305,946,971,25,256,256,956,956,0,0.0026549576227917903,0.0026549576227917903,914,914,0,5,2,2,17,28,71,98,717
522,0,206,1,988,987,0,12,1,759,758,0.0,0.005480104836788182,1,963,962,3,-1,4,2,0,898,802,21
523,0,102,1,927,926,0,5,1,383,382,0.0,0.00013615167296368154,1,515,514,4,-1,5,3,0,626,672,229
524,16,16,592,592,0,34,34,587,587,0,0.00013615167296368154,0.00013615167296368154,501,501,0,-1,3,3,8,2,431,532,930
525,20,122,686,938,252,56,56,854,854,0,0.0012253650566731338,0.0016338200755641784,834,861,27,4,3,3,6,5,494,355,475
526,160,366,913,979,66,242,242,900,900,0,0.0018720855032506212,0.002552843868069029,875,906,31,3,2,2,21,15,12,206,284
527,52,258,858,981,123,54,54,939,939,0,0.0025188059498281084,0.004629156880765172,913,949,36,3,3,3,4,6,728,73,43
528,18,224,610,961,351,38,42,555,582,27,6.807583648184077e-05,0.0012253650566731338,444,824,380,3,4,4,9,3,178,485,148
529,0,1640,1,1000,999,0,92,1,774,773,0.0,0.011675005956635693,1,980,979,1,-1,2,11,0,215,991,141
530,79,679,854,994,140,84,84,834,834,0,0.0018380475850097008,0.00353994349705572,874,928,54,2,3,3,9,15,289,151,117
531,37,139,772,935,163,50,50,791,791,0,0.0005786446100956465,0.001157289220191293,723,819,96,4,3,3,5,11,492,162,113
532,0,101,1,937,936,0,2,1,332,331,0.0,6.807583648184077e-05,1,451,450,5,-1,6,2,0,598,808,408
533,46,46,790,790,0,94,94,812,812,0,0.0012253650566731338,0.0012253650566731338,826,826,0,-1,3,3,9,6,213,114,672
534,6,107,442,924,482,26,26,615,615,0,0.0005446066918547262,0.0005446066918547262,716,716,0,5,4,4,5,1,691,439,558
535,0,0,1,1,0,0,0,1,1,0,0.0,0.0,1,1,0,-1,-1,-1,7,2,413,775,939
536,0,206,1,949,948,0,56,1,573,572,0.0,0.002110350930937064,1,883,882,3,-1,4,12,0,96,740,133
537,26,128,717,936,219,24,24,688,688,0,0.0005446066918547262,0.0008509479560230097,715,795,80,4,3,3,3,4,725,365,124
538,2,208,358,964,606,7,16,386,508,122,0.0,0.0005446066918547262,1,721,720,3,5,4,4,1,516,606,306
539,4,106,449,929,480,7,7,413,413,0,3.4037918240920386e-05,0.0002382654276864427,404,603,199,4,5,5,4,3,706,598,652
540,3,104,428,930,502,7,7,402,402,0,3.4037918240920386e-05,6.807583648184077e-05,397,447,50,5,5,5,4,2,635,627,837
541,2,2,351,351,0,25,25,391,391,0,3.4037918240920386e-05,3.4037918240920386e-05,401,401,0,-1,5,5,14,2,203,885,583
542,16,16,575,575,0,62,62,753,753,0,0.0002723033459273631,0.0002723033459273631,621,621,0,-1,3,3,7,1,193,168,349
543,2,2,371,371,0,6,6,429,429,0,3.4037918240920386e-05,3.4037918240920386e-05,399,399,0,-1,5,5,3,2,590,654,884
544,6,107,455,933,478,14,14,494,494,0,6.807583648184077e-05,0.00010211375472276115,453,489,36,5,4,4,5,1,848,609,690
545,7,7,507,507,0,10,10,460,460,0,6.807583648184077e-05,6.807583648184077e-05,441,441,0,-1,4,4,3,3,778,631,786
546,1,1,331,331,0,3,3,331,331,0,0.0,0.0,1,1,0,-1,6,6,3,2,796,739,942
547,239,239,972,972,0,134,134,990,990,0,0.006433166547533953,0.006433166547533953,967,967,0,-1,2,2,6,27,549,88,926
548,12,218,546,964,418,32,32,577,577,0,0.00034037918240920387,0.0009530617107457708,654,794,140,3,4,4,8,2,541,453,250
549,49,151,808,933,125,58,58,755,755,0,0.0006467204465774873,0.00088498587426393,748,790,42,4,3,3,8,8,488,187,521
550,24,125,723,944,221,44,44,786,786,0,0.0010892133837094523,0.0012253650566731338,822,839,17,5,3,3,6,4,657,332,576
551,0,206,1,950,949,0,21,1,395,394,0.0,6.807583648184077e-05,1,443,442,3,-1,4,12,0,143,707,238
552,259,361,963,975,12,228,228,932,932,0,0.0037441710065012424,0.0037441710065012424,940,940,0,4,3,3,18,37,34,74,394
553,8,8,520,520,0,20,20,560,560,0,3.4037918240920386e-05,3.4037918240920386e-05,398,398,0,-1,4,4,4,3,762,508,952
554,21,123,653,913,260,48,48,649,649,0,0.0004765308553728854,0.0005446066918547262,702,720,18,4,3,3,7,5,331,454,309
555,95,301,911,984,73,44,44,857,857,0,0.003880322679464924,0.0051397256543789785,942,961,19,3,3,3,4,18,545,141,227
556,1,1,333,333,0,6,6,333,333,0,0.0,0.0,1,1,0,-1,7,7,6,2,399,582,713
557,22,22,609,609,0,56,56,525,525,0,0.00010211375472276115,0.00010211375472276115,473,473,0,-1,3,3,15,4,45,270,668
558,19,121,695,940,245,22,22,616,616,0,0.00030634126416828345,0.0007828721195411688,631,785,154,4,4,4,5,6,376,379,312
559,0,0,1,1,0,0,0,1,1,0,0.0,0.0,1,1,0,-1,-1,-1,10,0,82,982,707
560,0,102,1,920,919,0,5,1,362,361,0.0,3.4037918240920386e-05,1,411,410,4,-1,5,4,0,649,702,164
561,2,2,375,375,0,3,3,376,376,0,0.0,0.0,1,1,0,-1,5,5,2,1,760,618,515
562,32,134,654,894,240,124,124,693,693,0,0.00030634126416828345,0.0004084550188910446,634,672,38,4,3,3,19,2,36,682,523
563,22,22,830,830,0,8,8,680,680,0,0.00088498587426393,0.00088498587426393,805,805,0,-1,4,4,2,11,920,83,423
564,0,102,1,912,911,0,7,1,373,372,0.0,0.0002382654276864427,1,587,586,4,-1,5,5,0,406,608,424
565,0,0,1,1,0,0,0,1,1,0,0.0,0.0,1,1,0,-1,-1,-1,5,0,173,783,695
566,50,256,842,977,135,50,54,911,912,1,0.002927260968719153,0.004663194799006093,916,953,37,3,2,2,4,4,631,164,304
567,9,110,634,963,329,8,8,571,571,0,0.00017018959120460194,0.00017018959120460194,543,543,0,6,4,4,2,3,950,596,763
568,81,182,893,971,78,34,34,790,790,0,0.002212464685659825,0.002280540522141666,890,895,5,5,3,3,4,22,660,128,870
569,0,102,1,908,907,0,6,1,391,390,0.0,0.00030634126416828345,1,630,629,4,-1,5,3,0,837,790,209
570,0,0,1,1,0,0,0,1,1,0,0.0,0.0,1,1,0,-1,-1,-1,7,0,156,669,423
571,76,282,913,986,73,12,12,616,616,0,0.0020763130126961434,0.002586881786309949,899,920,21,3,4,4,2,24,734,129,338
572,13,13,525,525,0,22,22,424,424,0,0.0,0.0,1,1,0,-1,4,4,9,5,101,274,925
573,84,84,863,863,0,96,96,912,912,0,0.0030974505599237552,0.0030974505599237552,925,925,0,-1,2,2,7,8,372,174,786
574,16,632,532,987,455,60,74,510,553,43,0.0004765308553728854,0.0011913271384322134,679,827,148,2,3,3,17,1,63,500,274
575,4,210,420,964,544,12,18,399,467,68,3.4037918240920386e-05,0.0005786446100956465,399,719,320,3,5,4,7,3,336,761,136
576,55,55,776,776,0,126,126,762,762,0,0.0009530617107457708,0.0009530617107457708,787,787,0,-1,3,3,15,5,51,216,952
577,435,435,992,992,0,48,48,906,906,0,0.009326389598012186,0.009326389598012186,983,983,0,-1,3,3,3,81,892,32,917
578,6,6,406,406,0,22,22,465,465,0,3.4037918240920386e-05,3.4037918240920386e-05,411,411,0,-1,4,4,7,2,179,384,871
579,0,206,1,967,966,0,20,1,552,551,0.0,0.001599782157323258,1,868,867,3,-1,4,6,0,661,926,73
580,1,207,333,968,635,5,14,333,482,149,0.0,0.0005105687736138058,1,712,711,3,6,4,5,1,476,402,267
581,2,2,384,384,0,4,4,388,388,0,0.0,0.0,1,1,0,-1,5,5,3,1,730,606,959
582,0,101,1,900,899,0,7,1,332,331,0.0,0.0,1,1,0,5,-1,6,7,0,156,836,893
583,100,100,887,887,0,100,100,944,944,0,0.0317233398005378,0.0317233398005378,996,996,0,-1,1,1,5,27,238,61,854
584,8,8,614,614,0,12,12,759,759,0,0.0002382654276864427,0.0002382654276864427,612,612,0,-1,4,4,2,3,805,268,568
585,14,630,609,998,389,16,26,534,705,171,0.00017018959120460194,0.003778208924742163,541,935,394,2,4,3,4,3,384,677,57
586,0,206,1,956,955,0,48,1,646,645,0.0,0.0030634126416828346,1,924,923,3,-1,4,8,0,236,744,102
587,0,102,1,924,923,0,6,1,384,383,0.0,3.4037918240920386e-05,1,401,400,4,-1,5,4,0,511,672,491
588,0,0,1,1,0,0,0,1,1,0,0.0,0.0,1,1,0,-1,-1,-1,3,0,854,732,906
589,0,101,1,914,913,0,6,1,332,331,0.0,0.0,1,1,0,5,-1,6,6,0,322,433,879
590,60,266,851,977,126,66,66,863,863,0,0.0010211375472276116,0.0011232513019503727,825,837,12,3,3,3,6,8,526,345,609
591,1,103,333,879,546,12,21,333,388,55,3.4037918240920386e-05,0.0002042275094455223,404,565,161,4,6,5,12,3,183,708,362
592,106,208,903,957,54,88,88,869,869,0,0.002280540522141666,0.002280540522141666,900,900,0,4,3,3,8,23,142,122,899
593,1,1,332,332,0,2,2,332,332,0,0.0,0.0,1,1,0,-1,6,6,2,3,985,466,457
594,10,111,612,942,330,14,14,598,598,0,0.00030634126416828345,0.00030634126416828345,658,658,0,5,4,4,3,3,530,301,578
595,9,9,596,596,0,8,8,502,502,0,6.807583648184077e-05,6.807583648184077e-05,457,457,0,-1,4,4,2,5,980,570,971
596,0,616,1,989,988,0,116,1,667,666,0.0,0.0045270431260424114,1,944,943,2,-1,3,21,1,2,780,14
597,28,130,775,952,177,22,22,783,783,0,0.0006126825283365669,0.0010892133837094523,745,825,80,4,3,3,2,4,972,288,118
598,0,0,1,1,0,0,0,1,1,0,0.0,0.0,1,1,0,-1,-1,-1,9,0,168,826,706
599,97,97,873,873,0,74,74,748,748,0,0.0018040096667687805,0.0018040096667687805,869,869,0,-1,3,3,9,19,381,297,819
600,108,108,901,901,0,82,82,879,879,0,0.002552843868069029,0.002552843868069029,908,908,0,-1,3,3,7,13,335,261,664
601,0,206,1,967,966,0,10,1,456,455,0.0,0.0002382654276864427,1,597,596,3,-1,4,3,0,687,790,249
602,0,0,1,1,0,0,0,1,1,0,0.0,0.0,1,1,0,-1,-1,-1,7,0,305,826,912
603,0,0,1,1,0,0,0,1,1,0,0.0,0.0,1,1,0,-1,-1,-1,2,0,589,205,994
604,6,6,399,399,0,36,36,465,465,0,6.807583648184077e-05,6.807583648184077e-05,450,450,0,-1,4,4,12,2,44,560,957
605,154,360,949,985,36,60,60,891,891,0,0.002757071377514551,0.005037611899656217,908,960,52,3,3,3,5,24,524,8,57
606,2,2,350,350,0,15,15,375,375,0,0.00010211375472276115,0.00010211375472276115,485,485,0,-1,5,5,10,1,128,687,987
607,12,218,568,968,400,32,32,630,630,0,0.00034037918240920387,0.00088498587426393,651,796,145,3,4,4,6,2,402,473,195
608,195,297,964,980,16,94,94,977,977,0,0.004935498144933456,0.006705469893461316,956,973,17,4,2,2,5,24,538,13,44
609,13,114,650,946,296,10,10,537,537,0,6.807583648184077e-05,6.807583648184077e-05,447,447,0,7,4,4,3,5,961,528,582
610,0,0,1,1,0,0,0,1,1,0,0.0,0.0,1,1,0,-1,-1,-1,3,0,911,546,574
611,0,0,1,1,0,0,0,1,1,0,0.0,0.0,1,1,0,-1,-1,-1,9,0,190,886,929
612,3,104,423,924,501,6,6,412,412,0,3.4037918240920386e-05,6.807583648184077e-05,414,463,49,5,5,5,3,2,780,430,558
613,16,16,618,618,0,29,29,710,710,0,6.807583648184077e-05,6.807583648184077e-05,443,443,0,-1,3,3,4,1,949,282,971
614,27,129,696,921,225,38,38,609,609,0,0.0005786446100956465,0.0006467204465774873,719,744,25,4,4,4,7,8,209,90,463
615,10,10,568,568,0,12,12,478,478,0,0.00017018959120460194,0.00017018959120460194,538,538,0,-1,4,4,4,4,650,443,776
616,2,2,364,364,0,6,6,365,365,0,0.0,0.0,1,1,0,-1,5,5,5,1,691,671,758
617,1,1,333,333,0,15,15,333,333,0,0.0,0.0,1,1,0,-1,6,6,15,3,68,708,928
618,10,10,493,493,0,45,45,464,464,0,6.807583648184077e-05,6.807583648184077e-05,445,445,0,-1,4,4,16,3,50,311,890
619,0,0,1,1,0,0,0,1,1,0,0.0,0.0,1,1,0,-1,-1,-1,3,0,984,821,695
620,121,737,897,995,98,190,190,907,907,0,0.001940161339732462,0.005105687736138058,883,956,73,2,3,3,15,27,40,304,75
621,42,42,798,798,0,54,54,864,864,0,0.00176997174852786,0.00176997174852786,868,868,0,-1,3,3,4,5,638,393,611
622,24,230,688,968,280,42,42,784,784,0,0.0002723033459273631,0.0005446066918547262,606,723,117,3,3,3,5,4,793,567,510
623,50,256,794,966,172,74,74,758,758,0,0.0008509479560230097,0.001055175465468532,785,814,29,3,3,3,9,10,263,296,617
624,0,0,1,1,0,0,0,1,1,0,0.0,0.0,1,1,0,-1,-1,-1,7,0,141,774,825
625,0,102,1,931,930,0,7,1,412,411,0.0,0.00013615167296368154,1,511,510,4,-1,5,4,0,581,845,477
626,0,102,1,875,874,0,16,1,355,354,0.0,3.4037918240920386e-05,1,394,393,4,-1,5,14,0,85,588,373
627,0,0,1,1,0,0,0,1,1,0,0.0,0.0,1,1,0,-1,-1,-1,18,0,34,929,815
628,30,132,749,938,189,30,30,676,676,0,0.0005786446100956465,0.0005786446100956465,738,738,0,4,4,4,5,8,773,345,743
629,17,17,718,718,0,8,8,520,520,0,0.0004084550188910446,0.0004084550188910446,692,692,0,-1,4,4,2,6,947,4,946
630,0,206,1,956,955,0,38,1,565,564,0.0,0.0031314884781646754,1,928,927,3,-1,4,9,2,330,633,76
631,48,149,838,954,116,28,28,771,771,0,0.0007828721195411688,0.0007828721195411688,775,775,0,5,3,3,3,9,839,130,506
632,6,6,438,438,0,15,15,452,452,0,0.0,0.0,1,1,0,-1,4,4,6,1,345,360,836
633,35,35,808,808,0,40,40,823,823,0,0.0008509479560230097,0.0008509479560230097,793,793,0,-1,3,3,5,9,629,294,649
634,1,207,332,958,626,8,23,332,451,119,0.0,0.0002382654276864427,1,580,579,3,8,4,8,1,358,765,470
635,0,102,1,880,879,0,16,1,383,382,0.0,0.00017018959120460194,1,530,529,4,-1,5,10,0,105,877,562
636,0,0,1,1,0,0,0,1,1,0,0.0,0.0,1,1,0,-1,-1,-1,2,0,884,898,859
637,184,286,973,985,12,48,48,953,953,0,0.006399128629293032,0.006535280302256714,968,968,0,4,3,3,3,34,590,20,477
638,34,135,831,964,133,8,8,523,523,0,0.0008169100377820892,0.0009190237925048504,792,805,13,5,4,4,2,14,929,387,899
639,224,224,957,957,0,256,256,963,963,0,0.003948398515946765,0.003948398515946765,943,943,0,-1,2,2,17,26,23,112,644
640,0,102,1,929,928,0,3,1,366,365,0.0,0.00010211375472276115,1,489,488,4,-1,5,2,0,880,731,315
641,408,408,980,980,0,384,384,971,971,0,0.005105687736138058,0.005105687736138058,950,950,0,-1,2,2,23,38,8,111,923
642,97,297,906,981,75,78,78,963,963,0,0.004152626025392287,0.005990673610401988,953,970,17,3,2,2,4,18,445,64,69
643,1,103,333,894,561,9,17,333,401,68,0.0,0.00013615167296368154,1,511,510,4,7,5,9,3,306,626,293
644,6,108,478,943,465,8,8,523,523,0,0.00013615167296368154,0.0006467204465774873,525,756,231,4,4,4,2,1,906,556,179
645,0,101,1,869,868,0,17,1,332,331,0.0,0.0,1,1,0,7,-1,8,17,2,10,709,857
646,0,101,1,921,920,0,3,1,331,330,0.0,0.0,1,1,0,6,-1,7,3,1,577,852,621
647,8,109,546,939,393,10,10,501,501,0,0.00013615167296368154,0.0002382654276864427,520,596,76,5,4,4,3,2,826,697,229
648,3,619,404,996,592,16,56,403,698,295,6.807583648184077e-05,0.0028932230504782326,453,915,462,2,5,3,9,3,177,373,57
649,0,0,1,1,0,0,0,1,1,0,0.0,0.0,1,1,0,-1,-1,-1,2,0,997,951,981
650,0,0,1,1,0,0,0,1,1,0,0.0,0.0,1,1,0,-1,-1,-1,2,0,609,324,928
651,134,340,955,993,38,52,52,967,967,0,0.005956635692161067,0.00888389666088022,960,980,20,3,2,2,3,29,628,142,75
652,88,190,854,945,91,104,104,856,856,0,0.0018720855032506212,0.0019061234214915416,875,876,1,4,2,2,10,13,206,217,755
653,0,206,1,974,973,0,11,1,477,476,0.0,0.0017018959120460194,1,871,870,3,-1,4,4,0,682,979,136
654,8,214,464,947,483,28,38,381,421,40,6.807583648184077e-05,0.0002382654276864427,430,580,150,3,4,4,17,2,94,694,275
655,62,268,845,979,134,52,52,733,733,0,0.001157289220191293,0.0014295925661186562,823,847,24,3,3,3,7,12,658,179,523
656,723,723,995,995,0,256,256,994,994,0,0.014806494434800367,0.014806494434800367,986,986,0,-1,2,2,10,91,293,7,821
657,5,211,484,978,494,4,8,423,521,98,6.807583648184077e-05,0.0004765308553728854,459,700,241,3,5,4,2,3,723,214,338
658,0,0,1,1,0,0,0,1,1,0,0.0,0.0,1,1,0,-1,-1,-1,4,0,824,941,859
659,103,309,913,982,69,50,50,824,824,0,0.001940161339732462,0.002144388849177984,885,899,14,3,3,3,5,19,311,72,223
660,16,222,638,972,334,30,30,690,690,0,0.0006126825283365669,0.0020422750944552232,738,889,151,3,4,4,5,4,452,328,60
661,8,624,484,993,509,31,68,424,589,165,0.0,0.0009190237925048504,1,788,787,2,4,3,15,2,138,602,612
662,7,108,562,951,389,12,12,653,653,0,0.0002042275094455223,0.00030634126416828345,578,631,53,5,4,4,2,3,841,541,487
663,7,7,460,460,0,66,66,474,474,0,6.807583648184077e-05,6.807583648184077e-05,443,443,0,-1,4,4,22,3,55,373,701
664,0,0,1,1,0,0,0,1,1,0,0.0,0.0,1,1,0,-1,-1,-1,3,0,628,542,456
665,0,0,1,1,0,0,0,1,1,0,0.0,0.0,1,1,0,-1,-1,-1,4,0,567,986,668
666,34,240,703,964,261,88,100,695,751,56,0.00034037918240920387,0.001599782157323258,647,867,220,3,3,3,13,4,97,617,171
667,82,698,882,998,116,22,22,707,707,0,0.0011913271384322134,0.0028932230504782326,829,919,90,2,3,3,2,17,769,226,179
668,16,117,812,982,170,12,12,867,867,0,0.001055175465468532,0.0010892133837094523,836,838,2,5,4,4,2,5,775,216,323
669,16,222,505,948,443,114,118,654,668,14,0.00037441710065012424,0.0004084550188910446,648,663,15,3,3,3,21,1,25,727,689
670,66,66,831,831,0,90,90,807,807,0,0.0015317063208414173,0.0015317063208414173,852,852,0,-1,2,2,10,10,355,195,744
671,0,102,1,908,907,0,10,1,384,383,0.0,0.00017018959120460194,1,528,527,4,-1,5,7,1,141,554,904
672,55,157,811,933,122,78,78,815,815,0,0.0010892133837094523,0.0010892133837094523,806,806,0,4,3,3,8,8,317,352,342
673,6,622,408,991,583,42,52,578,652,74,0.0002382654276864427,0.0011232513019503727,585,816,231,2,4,3,9,1,136,711,722
674,0,101,1,945,944,0,2,1,331,330,0.0,3.4037918240920386e-05,1,407,406,5,-1,6,2,0,940,968,964
675,0,102,1,954,953,0,4,1,427,426,0.0,0.00030634126416828345,1,636,635,4,-1,5,2,0,946,932,490
676,4,105,535,974,439,4,4,507,507,0,0.00017018959120460194,0.00017018959120460194,559,559,0,7,5,5,2,3,978,505,181
677,1,1,333,333,0,3,3,333,333,0,3.4037918240920386e-05,3.4037918240920386e-05,409,409,0,-1,6,6,3,1,935,530,709
678,750,1366,995,1000,5,284,284,986,986,0,0.012185574730249497,0.01494264610776405,986,991,5,2,2,2,16,83,72,10,78
679,14,630,540,993,453,52,114,550,847,297,0.00017018959120460194,0.010007147962830594,535,979,444,2,4,3,12,4,96,339,23
680,0,102,1,911,910,0,6,1,356,355,0.0,3.4037918240920386e-05,1,407,406,4,-1,5,5,0,396,725,320
681,0,206,1,956,955,0,19,1,432,431,0.0,0.00013615167296368154,1,512,511,3,-1,4,9,0,339,919,616
682,0,206,1,978,977,0,8,1,512,511,0.0,0.0005786446100956465,1,738,737,3,-1,4,2,0,757,850,422
683,0,206,1,958,957,0,38,1,610,609,0.0,0.002484768031587188,1,908,907,3,-1,4,7,0,366,876,112
684,16,117,550,905,355,34,34,495,495,0,0.00017018959120460194,0.00017018959120460194,532,532,0,6,3,3,11,1,271,337,582
685,0,101,1,912,911,0,3,1,331,330,0.0,0.0,1,1,0,5,-1,6,3,1,737,789,466
686,0,102,1,886,885,0,19,1,390,389,0.0,0.0002042275094455223,1,564,563,4,-1,5,11,0,230,668,681
687,8,110,558,944,386,8,8,508,508,0,0.00017018959120460194,0.0009530617107457708,548,814,266,4,4,4,2,3,939,508,139
688,0,206,1,978,977,0,8,1,518,517,0.0,0.001055175465468532,1,819,818,3,-1,4,2,0,992,200,630
689,98,98,910,910,0,60,60,861,861,0,0.0028591851322373124,0.0028591851322373124,923,923,0,-1,3,3,5,18,294,55,872
690,0,102,1,942,941,0,3,1,372,371,0.0,0.00013615167296368154,1,528,527,4,-1,5,2,0,964,881,408
691,0,102,1,970,969,0,3,1,424,423,0.0,0.0011232513019503727,1,839,838,4,-1,5,2,0,920,886,153
692,0,102,1,904,903,0,6,1,391,390,0.0,0.0009530617107457708,1,808,807,4,-1,5,3,0,731,760,100
693,0,616,1,992,991,0,46,1,505,504,0.0,0.0008509479560230097,1,768,767,2,-1,3,15,0,110,796,154
694,0,206,1,945,944,0,48,1,503,502,0.0,0.0004084550188910446,1,669,668,3,-1,4,14,0,181,726,216
695,0,102,1,932,931,0,4,1,374,373,0.0,6.807583648184077e-05,1,458,457,4,-1,5,3,1,745,539,561
696,23,229,720,977,257,30,30,746,746,0,0.0006126825283365669,0.00088498587426393,738,788,50,3,3,3,4,5,659,619,90
697,2,1642,359,1000,641,13,94,371,851,480,0.00017018959120460194,0.01783586915824228,541,995,454,1,5,2,10,2,427,615,37
698,0,206,1,982,981,0,8,1,518,517,0.0,0.0007488342013002485,1,771,770,3,-1,4,2,0,938,939,82
699,3,3,391,391,0,10,10,350,350,0,3.4037918240920386e-05,3.4037918240920386e-05,393,393,0,-1,5,5,9,5,101,605,768
700,50,50,744,744,0,112,112,651,651,0,0.00030634126416828345,0.00030634126416828345,634,634,0,-1,3,3,19,5,31,636,569
701,66,66,851,851,0,38,38,659,659,0,0.0006467204465774873,0.0006467204465774873,741,741,0,-1,4,4,7,19,416,184,324
702,2,103,363,927,564,10,10,434,434,0,3.4037918240920386e-05,6.807583648184077e-05,400,457,57,5,5,5,5,1,795,873,460
703,39,245,808,977,169,34,34,773,773,0,0.0010211375472276116,0.0011232513019503727,809,828,19,3,3,3,4,11,495,118,545
704,1,1,333,333,0,3,3,333,333,0,0.0,0.0,1,1,0,-1,6,6,3,1,636,590,856
705,110,212,903,963,60,78,78,938,938,0,0.0028591851322373124,0.002927260968719153,922,924,2,4,2,2,4,15,503,92,499
706,0,1640,1,1000,999,0,90,1,869,868,0.0,0.015180911535450491,1,987,986,1,-1,2,9,0,190,877,6
707,30,236,773,974,201,30,30,742,742,0,0.0004765308553728854,0.0014636304843595766,709,861,152,3,3,3,4,9,649,29,296
708,7,213,522,971,449,12,24,483,680,197,3.4037918240920386e-05,0.0028591851322373124,407,917,510,3,4,4,4,5,545,225,88
709,7,7,487,487,0,25,25,453,453,0,6.807583648184077e-05,6.807583648184077e-05,450,450,0,-1,4,4,9,5,327,225,348
710,102,1742,877,1000,123,162,196,835,900,65,0.0013615167296368155,0.008543517478471017,833,971,138,1,3,2,17,12,73,172,338
711,0,101,1,931,930,0,3,1,332,331,0.0,0.0,1,1,0,6,-1,7,3,0,579,657,763
712,16,118,700,956,256,12,12,653,653,0,0.0007828721195411688,0.0012934408931549745,783,843,60,4,4,4,2,4,841,185,92
713,0,101,1,884,883,0,8,1,332,331,0.0,0.0,1,1,0,5,-1,6,8,0,218,921,680
714,6,6,406,406,0,34,34,497,497,0,3.4037918240920386e-05,3.4037918240920386e-05,384,384,0,-1,4,4,12,1,219,238,359
715,0,0,1,1,0,0,0,1,1,0,0.0,0.0,1,1,0,-1,-1,-1,9,0,159,984,709
716,0,101,1,888,887,0,9,1,332,331,0.0,0.0,1,1,0,5,-1,6,9,0,164,965,292
717,0,0,1,1,0,0,0,1,1,0,0.0,0.0,1,1,0,-1,-1,-1,8,1,137,792,977
718,6,622,510,1000,490,12,22,671,839,168,0.00010211375472276115,0.008101024541339052,497,976,479,2,4,3,2,1,998,152,1
719,1,207,332,962,630,5,14,332,449,117,0.0,0.0010211375472276116,1,809,808,3,6,4,5,1,426,603,96
720,15,15,637,637,0,16,16,546,546,0,0.0002382654276864427,0.0002382654276864427,586,586,0,-1,4,4,4,6,550,459,740
721,0,102,1,945,944,0,4,1,386,385,0.0,0.0002042275094455223,1,587,586,4,-1,5,3,3,790,753,795
722,2,103,349,886,537,16,16,372,372,0,3.4037918240920386e-05,6.807583648184077e-05,401,440,39,5,5,5,11,1,139,543,764
723,28,129,787,957,170,22,22,806,806,0,0.0010892133837094523,0.001157289220191293,828,834,6,5,3,3,2,3,816,642,238
724,0,206,1,954,953,0,20,1,417,416,0.0,0.0002723033459273631,1,608,607,3,-1,4,10,0,258,883,487
725,0,102,1,894,893,0,11,1,354,353,0.0,3.4037918240920386e-05,1,397,396,4,-1,5,10,0,152,793,560
726,0,206,1,982,981,0,13,1,701,700,0.0,0.0011913271384322134,1,836,835,3,-1,4,3,0,918,989,440
727,6,212,473,973,500,12,24,497,683,186,0.00017018959120460194,0.006671431975220395,549,969,420,3,4,4,4,2,706,670,30
728,2,103,378,938,560,5,5,414,414,0,0.00013615167296368154,0.00013615167296368154,532,532,0,6,5,5,3,1,871,238,781
729,0,102,1,950,949,0,3,1,387,386,0.0,6.807583648184077e-05,1,449,448,4,-1,5,2,1,809,660,609
730,28,130,736,934,198,32,32,720,720,0,0.0006126825283365669,0.0006126825283365669,743,743,0,4,3,3,5,5,476,221,756
731,38,139,849,970,121,22,22,890,890,0,0.0008509479560230097,0.00088498587426393,800,803,3,5,3,3,2,6,799,658,476
732,4,106,430,924,494,8,8,414,414,0,3.4037918240920386e-05,0.00017018959120460194,399,544,145,4,5,5,4,2,758,298,670
733,82,82,889,889,0,54,54,887,887,0,0.0030974505599237552,0.0030974505599237552,931,931,0,-1,3,3,4,17,652,85,620
734,1,207,332,974,642,3,9,332,479,147,3.4037918240920386e-05,0.00030634126416828345,402,642,240,3,6,4,3,3,774,484,759
735,24,126,708,932,224,30,30,715,715,0,0.0002723033459273631,0.0005105687736138058,624,716,92,4,3,3,4,3,444,173,562
736,88,294,879,975,96,72,72,815,815,0,0.0019061234214915416,0.0026549576227917903,876,910,34,3,3,3,7,17,118,269,224
737,0,0,1,1,0,0,0,1,1,0,0.0,0.0,1,1,0,-1,-1,-1,2,0,890,445,856
738,0,206,1,966,965,0,17,1,434,433,0.0,0.0005446066918547262,1,714,713,3,-1,4,7,0,361,911,475
739,18,119,709,954,245,14,14,608,608,0,0.000442492937131965,0.000442492937131965,691,691,0,5,4,4,3,5,902,182,421
740,197,197,959,959,0,132,132,970,970,0,0.0042547397801150485,0.0042547397801150485,947,947,0,-1,2,2,8,31,286,35,568
741,0,102,1,953,952,0,4,1,425,424,0.0,0.0005446066918547262,1,721,720,4,-1,5,2,0,792,959,219
742,40,141,875,977,102,8,8,602,602,0,0.0012594029749140542,0.0012594029749140542,849,849,0,5,4,4,2,17,898,269,734
743,78,694,829,992,163,162,172,847,866,19,0.0008509479560230097,0.0014295925661186562,774,846,72,2,2,2,16,4,27,328,93
744,0,102,1,911,910,0,4,1,357,356,0.0,0.0,1,1,0,4,-1,5,3,0,778,974,607
745,0,102,1,877,876,0,17,1,354,353,0.0,0.0,1,1,0,4,-1,5,15,0,51,564,623
746,151,151,948,948,0,112,112,990,990,0,0.005786446100956465,0.005786446100956465,966,966,0,-1,2,2,4,15,870,36,571
747,24,230,673,970,297,36,36,673,673,0,0.0004765308553728854,0.0019741992579733825,693,880,187,3,3,3,5,4,349,479,87
748,0,0,1,1,0,0,0,1,1,0,0.0,0.0,1,1,0,-1,-1,-1,19,0,14,990,808
749,0,0,1,1,0,0,0,1,1,0,0.0,0.0,1,1,0,-1,-1,-1,15,0,40,901,871
750,60,266,792,961,169,126,130,724,727,3,0.0004765308553728854,0.0012934408931549745,686,829,143,3,3,3,18,5,64,418,490
751,8,110,533,927,394,16,16,492,492,0,0.00030634126416828345,0.0006126825283365669,638,748,110,4,4,4,4,3,445,121,173
752,0,102,1,948,947,0,4,1,380,379,0.0,0.0005446066918547262,1,721,720,4,-1,5,3,0,768,783,663
753,24,126,733,954,221,20,20,750,750,0,0.00034037918240920387,0.000442492937131965,645,699,54,4,3,3,3,4,710,567,230
754,8,109,480,886,406,66,66,570,570,0,6.807583648184077e-05,6.807583648184077e-05,453,453,0,6,4,4,15,4,95,239,640
755,0,206,1,971,970,0,14,1,555,554,0.0,0.0008509479560230097,1,793,792,3,-1,4,3,0,831,997,658
756,0,206,1,975,974,0,12,1,491,490,0.0,0.0010211375472276116,1,805,804,3,-1,4,4,0,462,868,180
757,27,643,743,997,254,30,40,744,857,113,0.0004765308553728854,0.002110350930937064,687,883,196,2,3,3,4,5,655,274,642
758,3,209,434,976,542,4,10,369,490,121,0.0,0.0004084550188910446,1,681,680,3,5,4,3,2,825,547,551
759,0,206,1,968,967,0,19,1,485,484,0.0,0.00030634126416828345,1,637,636,3,-1,4,7,0,305,860,718
760,24,126,752,944,192,22,22,767,767,0,0.00037441710065012424,0.0004765308553728854,675,714,39,4,3,3,2,3,828,507,380
761,4,106,458,948,490,8,8,467,467,0,3.4037918240920386e-05,0.0002723033459273631,406,622,216,4,5,5,4,3,754,361,528
762,88,88,890,890,0,40,40,747,747,0,0.0012253650566731338,0.0012253650566731338,846,846,0,-1,3,3,5,19,665,59,660
763,22,123,756,960,204,18,18,708,708,0,0.000442492937131965,0.0004765308553728854,699,718,19,5,4,4,3,9,485,191,878
764,68,170,862,954,92,50,50,827,827,0,0.0020422750944552232,0.002280540522141666,890,897,7,4,3,3,5,13,467,42,287
765,16,632,576,997,421,76,86,821,865,44,0.0006126825283365669,0.0014636304843595766,726,840,114,2,3,3,9,2,395,223,440
766,3,105,416,902,486,15,16,423,434,11,0.00010211375472276115,0.00030634126416828345,494,622,128,4,5,5,8,3,449,631,366
767,0,101,1,911,910,0,5,1,329,328,0.0,0.0,1,1,0,5,-1,6,5,0,457,808,364
768,0,101,1,931,930,0,6,1,330,329,0.0,0.0,1,1,0,8,-1,9,6,0,529,856,647
769,36,137,804,950,146,30,30,760,760,0,0.0004765308553728854,0.0004765308553728854,701,701,0,7,3,3,4,11,891,249,582
770,10,111,700,975,275,8,8,657,657,0,0.0005786446100956465,0.0005786446100956465,761,761,0,6,4,4,2,3,813,507,593
771,16,118,533,898,365,116,116,748,748,0,0.0002042275094455223,0.0002382654276864427,552,581,29,4,3,3,15,1,65,553,518
772,0,206,1,952,951,0,28,1,437,436,0.0,0.0002382654276864427,1,591,590,3,-1,4,10,0,285,546,222
773,8,214,505,960,455,24,28,506,552,46,0.0002723033459273631,0.0007147962830593281,608,751,143,3,4,4,6,2,425,524,351
774,38,140,810,953,143,34,34,786,786,0,0.001940161339732462,0.0022465026039007454,885,901,16,4,3,3,4,6,619,397,212
775,2,2,373,373,0,3,3,377,377,0,3.4037918240920386e-05,3.4037918240920386e-05,406,406,0,-1,5,5,2,1,838,558,730
776,5,211,466,976,510,6,14,436,557,121,3.4037918240920386e-05,0.0013955546478777359,415,860,445,3,5,4,3,3,825,580,82
777,6,622,412,991,579,66,96,681,794,113,0.00034037918240920387,0.007147962830593281,632,969,337,2,4,3,11,1,215,404,19
778,0,101,1,943,942,0,2,1,330,329,0.0,3.4037918240920386e-05,1,398,397,5,-1,6,2,0,876,945,373
779,30,236,725,969,244,60,60,783,783,0,0.0010211375472276116,0.002586881786309949,806,905,99,3,3,3,8,6,541,234,91
780,0,0,1,1,0,0,0,1,1,0,0.0,0.0,1,1,0,-1,-1,-1,11,0,271,668,657
781,0,0,1,1,0,0,0,1,1,0,0.0,0.0,1,1,0,-1,-1,-1,8,0,146,674,872
782,62,164,893,972,79,28,28,867,867,0,0.00176997174852786,0.0023486163586235067,888,905,17,4,3,3,3,16,840,78,273
783,0,0,1,1,0,0,0,1,1,0,0.0,0.0,1,1,0,-1,-1,-1,4,0,789,971,877
784,32,238,740,970,230,38,38,659,659,0,0.0002382654276864427,0.004356853534837809,587,950,363,3,4,4,7,8,416,132,21
785,14,14,567,567,0,38,38,597,597,0,0.00030634126416828345,0.00030634126416828345,635,635,0,-1,4,4,7,3,265,378,995
786,36,137,769,939,170,66,66,865,865,0,0.0012934408931549745,0.0012934408931549745,835,835,0,6,3,3,6,4,266,185,540
787,0,102,1,966,965,0,4,1,394,393,0.0,0.00017018959120460194,1,556,555,4,-1,5,3,0,853,629,328
788,20,20,656,656,0,30,30,677,677,0,0.0008169100377820892,0.0008169100377820892,785,785,0,-1,3,3,4,4,500,326,836
789,6,108,481,938,457,18,18,660,660,0,0.00037441710065012424,0.0005446066918547262,668,728,60,4,4,4,3,1,958,474,220
790,0,206,1,980,979,0,12,1,632,631,0.0,0.002110350930937064,1,903,902,3,-1,4,2,0,469,983,13
791,128,229,944,974,30,44,44,854,854,0,0.002382654276864427,0.0024166921951053475,904,905,1,5,3,3,4,28,384,98,646
792,2,208,379,983,604,6,10,453,536,83,6.807583648184077e-05,0.0033357159876101976,438,932,494,3,5,4,3,1,768,360,34
793,86,702,833,994,161,180,180,911,911,0,0.00176997174852786,0.002927260968719153,867,916,49,2,2,2,16,3,72,382,255
794,461,562,991,993,2,94,94,959,959,0,0.009598692943939549,0.009598692943939549,981,981,0,6,2,2,5,75,555,24,861
795,132,338,906,976,70,176,176,877,877,0,0.0016338200755641784,0.0018720855032506212,860,876,16,3,3,3,16,14,26,146,645
796,16,118,587,908,321,74,74,724,724,0,0.00034037918240920387,0.00037441710065012424,653,662,9,4,3,3,11,1,174,667,762
797,6,212,462,970,508,12,16,489,537,48,0.00010211375472276115,0.00037441710065012424,477,657,180,3,4,4,4,1,578,238,566
798,0,0,1,1,0,0,0,1,1,0,0.0,0.0,1,1,0,-1,-1,-1,16,0,60,886,966
799,0,206,1,974,973,0,18,1,671,670,0.0,0.0024507301133462676,1,910,909,3,-1,4,3,0,863,977,234
800,59,161,844,948,104,56,56,814,814,0,0.0013615167296368155,0.0013955546478777359,840,840,0,4,3,3,6,9,402,415,607
801,70,686,855,998,143,56,66,821,871,50,0.0015657442390823377,0.006569318220497634,852,972,120,2,3,3,6,12,275,67,50
802,23,23,772,772,0,14,14,654,654,0,0.00030634126416828345,0.00030634126416828345,649,649,0,-1,4,4,3,7,790,329,845
803,0,102,1,877,876,0,24,1,356,355,0.0,3.4037918240920386e-05,1,402,401,4,-1,5,21,2,12,633,581
804,34,34,738,738,0,52,52,707,707,0,0.001157289220191293,0.001157289220191293,816,816,0,-1,3,3,7,8,366,264,846
805,8,8,565,565,0,12,12,640,640,0,0.00030634126416828345,0.00030634126416828345,636,636,0,-1,4,4,2,2,816,323,665
806,17,17,660,660,0,22,22,695,695,0,0.00010211375472276115,0.00010211375472276115,481,481,0,-1,3,3,4,5,511,225,887
807,0,206,1,948,947,0,23,1,419,418,0.0,0.0002382654276864427,1,584,583,3,-1,4,10,0,240,915,136
808,0,206,1,975,974,0,16,1,582,581,0.0,0.0006467204465774873,1,743,742,3,-1,4,4,0,491,961,179
809,6,6,419,419,0,16,16,430,430,0,6.807583648184077e-05,6.807583648184077e-05,442,442,0,-1,4,4,7,1,416,577,999
810,0,0,1,1,0,0,0,1,1,0,0.0,0.0,1,1,0,-1,-1,-1,8,0,365,367,866
811,204,410,963,986,23,122,122,973,973,0,0.004833384390210695,0.005105687736138058,954,958,4,3,2,2,8,27,371,69,576
812,63,269,856,976,120,34,34,769,769,0,0.0010892133837094523,0.0016338200755641784,822,873,51,3,3,3,4,18,921,148,179
813,222,323,969,983,14,96,96,965,965,0,0.004731270635487933,0.004731270635487933,953,953,0,5,3,3,6,49,455,51,646
814,0,102,1,946,945,0,3,1,372,371,0.0,6.807583648184077e-05,1,445,444,4,-1,5,2,0,618,858,419
815,0,0,1,1,0,0,0,1,1,0,0.0,0.0,1,1,0,-1,-1,-1,2,0,866,744,649
816,8,8,485,485,0,23,23,422,422,0,6.807583648184077e-05,6.807583648184077e-05,442,442,0,-1,4,4,11,3,234,196,872
817,0,102,1,897,896,0,10,1,366,365,0.0,3.4037918240920386e-05,1,407,406,4,-1,5,8,0,449,735,313
818,0,0,1,1,0,0,0,1,1,0,0.0,0.0,1,1,0,-1,-1,-1,19,0,46,740,746
819,10,10,580,580,0,12,12,490,490,0,0.00017018959120460194,0.00017018959120460194,549,549,0,-1,4,4,4,3,631,301,620
820,0,101,1,917,916,0,4,1,331,330,0.0,0.00013615167296368154,1,508,507,5,-1,6,4,0,815,716,443
821,0,102,1,871,870,0,32,1,348,347,0.0,3.4037918240920386e-05,1,395,394,4,-1,5,30,0,7,696,690
822,0,102,1,876,875,0,19,1,361,360,0.0,3.4037918240920386e-05,1,398,397,4,-1,5,16,0,26,794,441
823,490,592,996,997,1,80,80,971,971,0,0.014364001497668403,0.014534191088873005,990,990,0,4,3,3,5,98,580,23,613
824,0,206,1,956,955,0,18,1,429,428,0.0,0.0005786446100956465,1,721,720,3,-1,4,7,0,321,436,161
825,8,110,552,944,392,8,8,503,503,0,0.0,0.0006807583648184077,1,760,759,4,4,4,2,2,747,430,390
826,0,102,1,900,899,0,10,1,372,371,0.0,0.00010211375472276115,1,479,478,4,-1,5,8,1,454,730,505
827,8,110,626,971,345,8,8,644,644,0,0.0002382654276864427,0.0006126825283365669,616,749,133,4,4,4,2,3,884,214,869
828,5,5,455,455,0,9,9,435,435,0,0.0,0.0,1,1,0,-1,5,5,5,5,629,570,429
829,68,684,848,996,148,62,72,785,835,50,0.001157289220191293,0.002280540522141666,825,903,78,2,3,3,7,12,209,179,420
830,18,18,571,571,0,118,118,742,742,0,0.00037441710065012424,0.00037441710065012424,654,654,0,-1,3,3,16,2,151,628,400
831,16,118,656,940,284,12,12,567,567,0,6.807583648184077e-05,0.0002042275094455223,438,572,134,4,4,4,2,5,828,350,700
832,234,440,979,992,13,92,92,989,989,0,0.00793083495013445,0.008951972497362062,975,977,2,3,2,2,4,54,562,28,96
833,2,2,371,371,0,4,4,333,333,0,0.0,0.0,1,1,0,-1,6,6,4,3,619,563,839
834,6,107,484,940,456,9,9,495,495,0,0.00013615167296368154,0.00013615167296368154,531,531,0,6,4,4,3,1,899,506,924
835,0,102,1,908,907,0,6,1,382,381,0.0,0.00037441710065012424,1,659,658,4,-1,5,3,1,704,685,343
836,2,618,358,996,638,6,28,358,678,320,0.0,0.004731270635487933,1,949,948,2,5,3,5,4,551,595,108
837,0,102,1,940,939,0,3,1,364,363,0.0,0.00017018959120460194,1,562,561,4,-1,5,2,0,747,973,474
838,34,34,752,752,0,62,62,809,809,0,0.0005786446100956465,0.0005786446100956465,722,722,0,-1,3,3,7,5,214,252,793
839,8,8,503,503,0,24,24,482,482,0,0.00013615167296368154,0.00013615167296368154,501,501,0,-1,4,4,8,2,325,408,898
840,16,222,680,980,300,22,22,816,816,0,0.0006126825283365669,0.0011232513019503727,737,828,91,3,3,3,2,1,739,869,293
841,6,108,440,920,480,12,12,563,563,0,0.00030634126416828345,0.0004084550188910446,641,696,55,4,4,4,2,1,859,404,370
842,100,100,888,888,0,100,100,926,926,0,0.020933319718166036,0.020933319718166036,992,992,0,-1,1,1,7,4,265,208,865
843,8,214,452,942,490,49,61,433,472,39,0.0002042275094455223,0.0006126825283365669,575,724,149,3,4,4,19,2,31,599,519
844,82,698,888,999,111,60,60,869,869,0,0.0012253650566731338,0.004050512270669526,838,945,107,2,3,3,5,15,616,206,102
845,7,108,551,942,391,9,9,500,500,0,0.00017018959120460194,0.0002042275094455223,557,586,29,5,4,4,3,5,845,476,442
846,96,712,896,998,102,92,92,938,938,0,0.0025188059498281084,0.0046972327172470135,914,954,40,2,3,3,7,12,477,58,65
847,1,1,333,333,0,3,3,333,333,0,0.0,0.0,1,1,0,-1,6,6,3,1,708,640,614
848,6,6,418,418,0,15,15,439,439,0,6.807583648184077e-05,6.807583648184077e-05,442,442,0,-1,4,4,6,1,393,799,539
849,6,6,405,405,0,12,12,389,389,0,6.807583648184077e-05,6.807583648184077e-05,447,447,0,-1,5,5,7,4,246,398,930
850,0,0,1,1,0,0,0,1,1,0,0.0,0.0,1,1,0,-1,-1,-1,4,0,559,713,276
851,40,142,752,927,175,86,86,765,765,0,0.0005105687736138058,0.0007488342013002485,705,754,49,4,3,3,11,5,155,178,362
852,6,6,460,460,0,9,9,470,470,0,3.4037918240920386e-05,3.4037918240920386e-05,406,406,0,-1,4,4,3,2,882,662,400
853,18,119,586,889,303,82,82,661,661,0,0.0004084550188910446,0.0004084550188910446,672,672,0,6,3,3,13,3,41,263,861
854,28,130,633,894,261,108,108,634,634,0,0.0002723033459273631,0.00037441710065012424,605,645,40,4,3,3,19,4,83,617,670
855,19,19,687,687,0,50,50,853,853,0,0.0012253650566731338,0.0012253650566731338,836,836,0,-1,3,3,5,3,533,103,866
856,8,110,504,907,403,17,20,426,439,13,0.00010211375472276115,0.00037441710065012424,482,659,177,4,4,4,8,2,199,547,453
857,42,144,731,911,180,102,102,665,665,0,0.0006807583648184077,0.0006807583648184077,739,739,0,4,3,3,17,6,56,516,298
858,13,13,632,632,0,18,18,669,669,0,0.0002723033459273631,0.0002723033459273631,619,619,0,-1,4,4,3,4,861,339,699
859,28,28,710,710,0,44,44,690,690,0,0.00034037918240920387,0.00034037918240920387,639,639,0,-1,3,3,7,6,359,494,886
860,225,225,966,966,0,118,118,933,933,0,0.004186663943633207,0.004186663943633207,948,948,0,-1,3,3,8,27,244,88,569
861,78,179,885,961,76,56,56,890,890,0,0.0012934408931549745,0.0012934408931549745,844,844,0,7,3,3,5,15,688,92,857
862,58,58,800,800,0,132,132,862,862,0,0.001497668402600497,0.001497668402600497,840,840,0,-1,2,2,13,4,120,207,709
863,25,126,694,919,225,44,44,687,687,0,0.0002382654276864427,0.0002382654276864427,591,591,0,5,3,3,7,7,346,427,781
864,6,6,509,509,0,9,9,534,534,0,6.807583648184077e-05,6.807583648184077e-05,449,449,0,-1,4,4,3,1,984,561,863
865,6,212,424,954,530,18,28,444,517,73,3.4037918240920386e-05,0.0009190237925048504,396,790,394,3,4,4,8,2,508,575,130
866,0,0,1,1,0,0,0,1,1,0,0.0,0.0,1,1,0,-1,-1,-1,10,1,409,913,897
867,0,206,1,974,973,0,22,1,617,616,0.0,0.0028932230504782326,1,920,919,3,-1,4,5,0,744,358,74
868,2,104,360,906,546,9,10,399,415,16,3.4037918240920386e-05,0.00017018959120460194,401,525,124,4,5,5,5,1,173,717,350
869,0,206,1,946,945,0,31,1,451,450,0.0,0.00010211375472276115,1,478,477,3,-1,4,12,0,222,833,465
870,0,102,1,925,924,0,6,1,366,365,0.0,6.807583648184077e-05,1,451,450,4,-1,5,5,0,848,973,285
871,29,131,774,948,174,26,26,748,748,0,0.00037441710065012424,0.000442492937131965,665,698,33,4,3,3,4,9,633,341,791
872,0,0,1,1,0,0,0,1,1,0,0.0,0.0,1,1,0,-1,-1,-1,30,1,7,920,888
873,0,101,1,921,920,0,4,1,332,331,0.0,0.0,1,1,0,6,-1,7,4,1,495,513,595
874,46,1686,772,1000,228,80,166,677,928,251,0.0007828721195411688,0.01684876952925559,770,989,219,1,3,2,12,6,226,376,24
875,0,101,1,896,895,0,11,1,330,329,0.0,0.0,1,1,0,6,-1,7,11,0,176,918,437
876,0,101,1,909,908,0,5,1,330,329,0.0,0.0,1,1,0,5,-1,6,5,0,390,898,734
877,23,229,673,966,293,78,78,789,789,0,0.00037441710065012424,0.0006467204465774873,673,740,67,3,3,3,8,5,225,619,404
878,0,102,1,921,920,0,7,1,385,384,0.0,6.807583648184077e-05,1,452,451,4,-1,5,5,0,612,900,770
879,68,68,876,876,0,64,64,944,944,0,0.002110350930937064,0.002110350930937064,890,890,0,-1,3,3,4,15,945,151,200
880,120,120,914,914,0,62,62,807,807,0,0.00176997174852786,0.00176997174852786,874,874,0,-1,3,3,7,19,335,72,847
881,16,118,789,978,189,8,8,684,684,0,0.0007488342013002485,0.0008509479560230097,780,792,12,4,4,4,2,9,973,245,891
882,100,100,933,933,0,100,100,997,997,0,0.05248646992749923,0.05289492494639028,999,999,0,4,1,1,3,22,568,128,159
883,24,640,626,991,365,52,70,515,579,64,0.0002382654276864427,0.0019061234214915416,570,879,309,2,4,3,14,6,108,258,138
884,0,0,1,1,0,0,0,1,1,0,0.0,0.0,1,1,0,-1,-1,-1,4,0,633,887,774
885,24,126,672,921,249,54,54,762,762,0,0.00034037918240920387,0.00037441710065012424,638,660,22,4,3,3,7,3,170,291,342
886,16,222,579,965,386,50,58,708,764,56,0.00034037918240920387,0.0017018959120460194,648,865,217,3,3,3,7,1,678,420,63
887,28,234,680,961,281,88,88,742,742,0,0.0008169100377820892,0.001157289220191293,770,818,48,3,3,3,12,3,187,382,258
888,7,7,574,574,0,8,8,540,540,0,0.00010211375472276115,0.00010211375472276115,493,493,0,-1,4,4,2,3,469,300,651
889,102,308,889,973,84,84,84,787,787,0,0.0019741992579733825,0.0025188059498281084,886,908,22,3,3,3,9,15,164,151,219
890,206,308,972,981,9,70,70,942,942,0,0.005786446100956465,0.005820484019197386,963,963,0,4,3,3,5,35,376,57,528
891,96,198,911,970,59,44,44,859,859,0,0.0015317063208414173,0.0015657442390823377,859,862,3,4,3,3,4,17,313,60,555
892,46,1686,777,1000,223,62,90,625,773,148,0.0006126825283365669,0.009496579189216788,735,978,243,1,3,2,12,9,375,198,53
893,200,200,936,936,0,320,320,891,891,0,0.0017018959120460194,0.0017018959120460194,868,868,0,-1,3,3,30,20,7,109,884
894,124,740,955,1000,45,38,38,895,895,0,0.0032336022328874367,0.015623404472582456,933,991,58,2,3,3,3,32,835,26,0
895,0,102,1,896,895,0,12,1,396,395,0.0,0.000442492937131965,1,697,696,4,-1,5,7,0,678,824,376
896,0,206,1,969,968,0,13,1,453,452,0.0,0.00034037918240920387,1,657,656,3,-1,4,6,0,764,816,268
897,11,217,631,981,350,8,8,520,520,0,0.0004084550188910446,0.002212464685659825,679,908,229,3,4,4,2,6,999,459,133
898,9,111,557,924,367,14,14,470,470,0,0.00017018959120460194,0.0002382654276864427,539,607,68,4,4,4,5,3,616,93,401
899,19,635,656,996,340,14,24,488,677,189,0.0002042275094455223,0.0016338200755641784,564,866,302,2,4,3,3,8,837,477,145
900,0,206,1,964,963,0,23,1,504,503,0.0,0.0014636304843595766,1,857,856,3,-1,4,8,0,442,952,217
901,0,0,1,1,0,0,0,1,1,0,0.0,0.0,1,1,0,-1,-1,-1,19,1,48,573,672
902,6,6,448,448,0,12,12,464,464,0,0.00010211375472276115,0.00010211375472276115,484,484,0,-1,4,4,4,2,758,719,883
903,0,206,1,952,951,0,36,1,505,504,0.0,0.0004765308553728854,1,674,673,3,-1,4,10,0,256,888,190
904,559,661,994,998,4,88,88,977,977,0,0.014364001497668403,0.014432077334150244,992,992,0,4,2,2,4,118,623,37,567
905,6,6,434,434,0,28,28,595,595,0,0.0002723033459273631,0.0002723033459273631,604,604,0,-1,4,4,6,2,575,160,726
906,178,384,942,981,39,186,186,957,957,0,0.002552843868069029,0.002757071377514551,912,918,6,3,2,2,12,17,226,81,381
907,7,213,464,946,482,42,46,470,481,11,6.807583648184077e-05,0.0002042275094455223,440,556,116,3,4,4,13,3,115,631,460
908,35,35,768,768,0,28,28,683,683,0,0.0005105687736138058,0.0005105687736138058,703,703,0,-1,3,3,3,7,731,134,804
909,31,133,749,936,187,46,46,743,743,0,0.0002042275094455223,0.00030634126416828345,562,628,66,4,3,3,6,6,275,199,409
910,0,102,1,926,925,0,4,1,439,438,0.0,0.0006807583648184077,1,766,765,4,-1,5,2,3,932,746,114
911,0,0,1,1,0,0,0,1,1,0,0.0,0.0,1,1,0,-1,-1,-1,6,0,402,961,900
912,0,102,1,971,970,0,4,1,466,465,0.0,0.0010892133837094523,1,830,829,4,-1,5,2,0,941,358,45
913,0,0,1,1,0,0,0,1,1,0,0.0,0.0,1,1,0,-1,-1,-1,12,0,219,855,909
914,0,0,1,1,0,0,0,1,1,0,0.0,0.0,1,1,0,-1,-1,-1,3,0,564,839,920
915,18,120,703,946,243,20,20,634,634,0,0.00030634126416828345,0.00037441710065012424,638,674,36,4,4,4,4,5,721,182,107
916,145,145,945,945,0,86,86,949,949,0,0.003812246842983083,0.003812246842983083,937,937,0,-1,3,3,6,30,455,39,769
917,156,258,981,994,13,32,32,959,959,0,0.008373327887266415,0.010824058000612683,977,987,10,4,3,3,2,49,959,31,27
918,63,269,845,976,131,44,44,697,697,0,0.0015657442390823377,0.0016338200755641784,861,861,0,3,3,3,7,11,416,166,453
919,62,62,864,864,0,38,38,842,842,0,0.0015317063208414173,0.0015317063208414173,862,862,0,-1,3,3,3,12,484,67,752
920,0,101,1,885,884,0,9,1,331,330,0.0,0.0,1,1,0,5,-1,6,9,0,217,876,788
921,35,35,778,778,0,24,24,629,629,0,0.0009530617107457708,0.0009530617107457708,804,804,0,-1,4,4,4,14,832,175,276
922,0,101,1,883,882,0,15,1,332,331,0.0,0.0,1,1,0,5,-1,6,15,0,95,951,540
923,16,16,682,682,0,14,14,638,638,0,0.00030634126416828345,0.00030634126416828345,643,643,0,-1,4,4,3,6,899,275,984
924,6,212,437,971,534,10,18,446,604,158,6.807583648184077e-05,0.005003573981415297,448,960,512,3,4,4,3,1,927,322,70
925,16,117,690,955,265,8,8,522,522,0,0.00017018959120460194,0.0002723033459273631,544,620,76,5,4,4,2,7,723,188,549
926,0,102,1,920,919,0,3,1,365,364,0.0,0.0002042275094455223,1,565,564,4,-1,5,2,0,909,866,519
927,20,226,648,965,317,84,84,806,806,0,0.0005105687736138058,0.0009870996289866913,713,807,94,3,3,3,9,3,119,268,381
928,2,103,357,905,548,7,7,373,373,0,0.0,6.807583648184077e-05,1,455,454,5,5,5,5,1,501,781,537
929,180,180,970,970,0,38,38,879,879,0,0.00616086320160659,0.00616086320160659,965,965,0,-1,3,3,3,34,615,20,533
930,3,105,410,900,490,10,13,379,414,35,0.0,0.0005786446100956465,1,726,725,4,5,5,7,3,413,563,147
931,0,206,1,941,940,0,43,1,453,452,0.0,0.0005105687736138058,1,693,692,3,-1,4,16,1,151,472,288
932,0,102,1,953,952,0,5,1,443,442,0.0,0.0006467204465774873,1,758,757,4,-1,5,3,0,918,773,415
933,44,44,739,739,0,108,108,724,724,0,0.0008169100377820892,0.0008169100377820892,750,750,0,-1,3,3,16,4,195,40,803
934,3,105,512,978,466,4,4,545,545,0,0.0002042275094455223,0.0007147962830593281,591,780,189,4,5,5,2,2,775,453,139
935,422,523,994,996,2,88,88,987,987,0,0.011777119711358454,0.011777119711358454,987,987,0,5,2,2,4,83,673,10,518
936,11,217,641,982,341,9,9,534,534,0,0.00010211375472276115,0.0005105687736138058,492,720,228,3,4,4,3,6,984,613,482
937,22,124,636,909,273,100,100,835,835,0,0.0009190237925048504,0.0009530617107457708,785,795,10,4,3,3,10,5,256,355,238
938,184,184,938,938,0,198,198,944,944,0,0.0028591851322373124,0.0028591851322373124,919,919,0,-1,2,2,14,21,154,157,859
939,1,617,332,998,666,3,24,332,728,396,0.0,0.006943735321147759,1,972,971,2,7,3,3,1,620,703,24
940,6,6,395,395,0,56,56,495,495,0,0.00010211375472276115,0.00010211375472276115,480,480,0,-1,4,4,16,2,59,532,744
941,0,101,1,922,921,0,3,1,331,330,0.0,0.00010211375472276115,1,492,491,5,-1,6,3,0,588,698,496
942,80,80,844,844,0,84,84,765,765,0,0.0012934408931549745,0.0012934408931549745,821,821,0,-1,3,3,9,12,101,67,348
943,96,198,913,972,59,22,22,851,851,0,0.0020422750944552232,0.0020422750944552232,900,900,0,4,3,3,2,19,932,133,373
944,9,111,564,920,356,15,15,463,463,0,0.0,0.00017018959120460194,1,546,545,4,4,4,6,3,522,580,556
945,0,206,1,968,967,0,16,1,512,511,0.0,0.0002042275094455223,1,580,579,3,-1,4,5,0,669,838,591
946,46,252,770,963,193,58,58,604,604,0,0.0005105687736138058,0.0009870996289866913,705,795,90,3,3,3,12,7,194,115,97
947,27,27,768,768,0,12,12,597,597,0,0.001055175465468532,0.001055175465468532,822,822,0,-1,4,4,2,7,972,399,999
948,21,227,567,938,371,63,67,446,459,13,0.00034037918240920387,0.0004765308553728854,637,682,45,3,4,4,24,6,28,279,319
949,0,101,1,896,895,0,8,1,332,331,0.0,0.0,1,1,0,5,-1,6,8,1,317,554,861
950,0,0,1,1,0,0,0,1,1,0,0.0,0.0,1,1,0,-1,-1,-1,2,0,734,996,898
951,166,782,955,998,43,94,94,977,977,0,0.005173763572619898,0.009224275843289425,962,977,15,2,2,2,5,19,667,133,28
952,6,107,481,936,455,8,8,488,488,0,6.807583648184077e-05,6.807583648184077e-05,469,469,0,5,4,4,3,1,958,530,721
953,166,268,966,982,16,44,44,854,854,0,0.003778208924742163,0.004288777698355968,937,945,8,4,3,3,4,31,403,76,306
954,7,213,477,954,477,41,66,480,599,119,0.00010211375472276115,0.0014295925661186562,475,840,365,3,4,4,15,2,110,408,297
955,0,206,1,975,974,0,10,1,479,478,0.0,0.0002042275094455223,1,560,559,3,-1,4,3,0,901,961,827
956,18,18,629,629,0,40,40,657,657,0,0.00010211375472276115,0.00010211375472276115,474,474,0,-1,3,3,7,2,196,363,975
957,7,108,479,891,412,36,36,479,479,0,6.807583648184077e-05,6.807583648184077e-05,448,448,0,5,4,4,13,3,242,373,430
958,0,0,1,1,0,0,0,1,1,0,0.0,0.0,1,1,0,-1,-1,-1,5,0,766,908,588
959,0,0,1,1,0,0,0,1,1,0,0.0,0.0,1,1,0,-1,-1,-1,4,0,635,819,906
960,6,6,462,462,0,11,11,478,478,0,0.0,0.0,1,1,0,-1,4,4,4,1,578,935,911
961,0,0,1,1,0,0,0,1,1,0,0.0,0.0,1,1,0,-1,-1,-1,4,1,945,747,686
962,1,103,332,953,621,4,5,332,374,42,0.0,0.0004084550188910446,1,674,673,4,6,5,4,1,738,857,351
963,6,212,419,965,546,17,22,438,498,60,0.00013615167296368154,0.0004765308553728854,506,699,193,3,4,4,7,1,141,537,355
964,94,300,873,973,100,84,84,781,781,0,0.0012594029749140542,0.0013615167296368155,834,841,7,3,3,3,9,12,287,163,149
965,0,206,1,980,979,0,9,1,533,532,0.0,0.0014295925661186562,1,859,858,3,-1,4,3,0,984,725,8
966,2,104,376,948,572,6,6,439,439,0,3.4037918240920386e-05,0.0010892133837094523,402,825,423,4,5,5,3,1,718,152,84
967,10,216,581,972,391,11,24,480,682,202,3.4037918240920386e-05,0.007522379931243405,394,975,581,3,4,4,4,3,633,596,0
968,8,624,531,998,467,9,34,451,801,350,6.807583648184077e-05,0.005956635692161067,456,966,510,2,4,3,4,2,593,298,50
969,0,101,1,923,922,0,4,1,331,330,0.0,0.0,1,1,0,5,-1,6,4,0,511,919,662
970,0,102,1,892,891,0,14,1,379,378,0.0,0.00017018959120460194,1,545,544,4,-1,5,9,0,213,888,361
971,7,623,592,1000,408,8,18,589,884,295,0.0,0.0068075836481840775,1,969,968,2,4,3,2,2,788,364,63
972,56,158,861,958,97,22,22,779,779,0,0.002110350930937064,0.0022465026039007454,900,904,4,4,3,3,2,13,990,183,408
973,29,131,802,959,157,18,18,793,793,0,0.0008509479560230097,0.00088498587426393,803,808,5,4,3,3,2,4,757,267,566
974,6,6,421,421,0,18,18,459,459,0,6.807583648184077e-05,6.807583648184077e-05,447,447,0,-1,4,4,7,1,362,360,760
975,6,108,506,945,439,8,8,525,525,0,6.807583648184077e-05,0.0007488342013002485,449,781,332,4,4,4,2,3,820,321,264
976,12,114,542,897,355,54,54,669,669,0,0.0007828721195411688,0.00088498587426393,766,785,19,4,4,4,9,2,319,473,258
977,0,101,1,963,962,0,2,1,331,330,0.0,0.0,1,1,0,5,-1,6,2,0,810,978,364
978,0,616,1,1000,999,0,18,1,862,861,0.0,0.005650294427992784,1,961,960,2,-1,3,2,0,985,900,55
979,0,102,1,955,954,0,4,1,415,414,0.0,0.001599782157323258,1,880,879,4,-1,5,2,0,913,838,108
980,0,102,1,961,960,0,4,1,387,386,0.0,0.00013615167296368154,1,516,515,4,-1,5,3,0,730,758,328
981,23,23,720,720,0,26,26,734,734,0,0.0005105687736138058,0.0005105687736138058,702,702,0,-1,3,3,4,4,735,319,779
982,18,120,672,931,259,26,26,725,725,0,0.0008509479560230097,0.0009870996289866913,796,812,16,4,3,3,4,4,559,239,251
983,2,208,355,961,606,11,18,365,414,49,3.4037918240920386e-05,0.00010211375472276115,399,480,81,3,5,4,9,1,367,437,307
984,103,205,914,967,53,50,50,825,825,0,0.00176997174852786,0.0024507301133462676,868,908,40,4,3,3,5,17,605,79,97
985,0,206,1,964,963,0,16,1,419,418,0.0,0.00017018959120460194,1,529,528,3,-1,4,8,0,431,975,609
986,40,246,777,968,191,76,76,881,881,0,0.0007828721195411688,0.0009190237925048504,773,800,27,3,2,2,6,1,560,553,465
987,16,632,559,993,434,53,61,673,735,62,0.00030634126416828345,0.002586881786309949,625,903,278,2,3,3,9,2,414,532,47
988,2,208,349,936,587,20,60,349,472,123,3.4037918240920386e-05,0.0005446066918547262,396,691,295,3,5,4,19,1,35,590,658
989,8,214,535,975,440,11,19,478,618,140,6.807583648184077e-05,0.0008169100377820892,448,795,347,3,4,4,4,3,682,361,377
990,79,180,912,973,61,28,28,832,832,0,0.0026209197045508697,0.0026209197045508697,921,921,0,6,3,3,3,19,708,135,292
991,0,101,1,936,935,0,2,1,331,330,0.0,3.4037918240920386e-05,1,401,400,5,-1,6,2,0,776,649,739
992,2,104,360,922,562,5,6,360,383,23,0.0,0.00013615167296368154,1,511,510,4,5,5,4,1,550,734,681
993,22,228,769,983,214,20,24,823,836,13,0.0002723033459273631,0.0016678579938050988,622,869,247,3,3,3,3,4,984,380,43
994,0,102,1,925,924,0,8,1,426,425,0.0,0.00037441710065012424,1,663,662,4,-1,5,4,1,633,693,827
995,0,0,1,1,0,0,0,1,1,0,0.0,0.0,1,1,0,-1,-1,-1,5,1,688,738,786
996,497,497,997,997,0,48,48,937,937,0,0.013853432724054596,0.013853432724054596,993,993,0,-1,3,3,3,118,745,37,716
997,26,127,741,940,199,20,20,588,588,0,0.0005446066918547262,0.0005446066918547262,722,722,0,6,4,4,4,9,397,212,861
998,127,127,933,933,0,76,76,915,915,0,0.002757071377514551,0.002757071377514551,916,916,0,-1,3,3,6,22,587,128,980
999,0,102,1,927,926,0,5,1,367,366,0.0,0.0002042275094455223,1,583,582,4,-1,5,4,0,423,801,528
