,FreeNet_pre_score,FreeNet_post_score,FreeNet_pre_rank,FreeNet_post_rank,FreeNet_delta_ranks,Reversed_pre_score,Reversed_post_score,Reversed_pre_rank,Reversed_post_rank,Reversed_delta_ranks,Random_pre_score,Random_post_score,Random_pre_rank,Random_post_rank,Random_delta_ranks,dist_victim_relayer,dist_victim_vilain_pre,dist_victim_vilain_post,out_deg_victim,in_deg_villain,victim,villain,relayer
0,0,0,1,1,0,0,0,1,1,0,0.0,0.0,1,1,0,-1,-1,-1,6,3,345,478,675
1,19,19,747,747,0,22,22,860,860,0,0.0005446066918547262,0.0005446066918547262,725,725,0,-1,3,3,2,3,965,222,235
2,125,741,931,999,68,72,72,892,892,0,0.002110350930937064,0.003369753905851118,890,931,41,2,3,3,7,23,404,106,465
3,12,12,534,534,0,48,48,541,541,0,0.00010211375472276115,0.00010211375472276115,484,484,0,-1,4,4,12,2,106,584,831
4,12,113,503,885,382,44,44,504,504,0,0.00017018959120460194,0.00017018959120460194,534,534,0,6,4,4,12,3,348,631,703
5,0,206,1,966,965,0,18,1,528,527,0.0,0.0011232513019503727,1,816,815,3,-1,4,5,0,284,723,67
6,12,218,650,980,330,12,12,634,634,0,0.0005446066918547262,0.003437829742332959,739,940,201,3,4,4,2,4,681,312,77
7,0,101,1,943,942,0,2,1,331,330,0.0,0.0,1,1,0,7,-1,8,2,0,929,359,671
8,26,26,733,733,0,34,34,751,751,0,0.00017018959120460194,0.00017018959120460194,545,545,0,-1,3,3,4,4,694,86,635
9,0,206,1,966,965,0,16,1,491,490,0.0,0.0014636304843595766,1,850,849,3,-1,4,4,0,540,971,141
10,164,266,948,973,25,64,64,906,906,0,0.0028932230504782326,0.0030293747234419145,929,933,4,4,3,3,4,28,410,44,314
11,118,324,944,986,42,60,60,908,908,0,0.002552843868069029,0.008135062459579971,903,976,73,3,3,3,5,19,602,91,19
12,0,0,1,1,0,0,0,1,1,0,0.0,0.0,1,1,0,-1,-1,-1,12,0,184,488,709
13,0,616,1,992,991,0,66,1,605,604,0.0,0.0015657442390823377,1,854,853,2,-1,3,12,0,175,773,147
14,51,257,841,976,135,28,28,722,722,0,0.0018720855032506212,0.0024166921951053475,885,903,18,3,3,3,3,9,613,277,40
15,58,264,890,987,97,12,12,673,673,0,0.0012253650566731338,0.0033357159876101976,848,932,84,3,4,4,2,19,951,59,26
16,0,206,1,958,957,0,30,1,513,512,0.0,0.0006126825283365669,1,734,733,3,-1,4,9,0,168,254,242
17,42,42,753,753,0,66,66,670,670,0,0.0002042275094455223,0.0002042275094455223,557,557,0,-1,3,3,10,11,105,162,905
18,6,107,537,964,427,4,4,432,432,0,0.00013615167296368154,0.00013615167296368154,530,530,0,6,5,5,2,6,996,459,374
19,25,25,613,613,0,90,90,514,514,0,0.00017018959120460194,0.00017018959120460194,518,518,0,-1,4,4,23,7,4,188,948
20,21,123,721,953,232,10,10,493,493,0,0.00013615167296368154,0.0002382654276864427,535,603,68,4,4,4,3,7,844,188,491
21,2,103,364,935,571,4,4,366,366,0,0.0,0.0,1,1,0,5,5,5,3,1,748,788,799
22,12,218,566,967,401,18,22,520,570,50,0.00013615167296368154,0.0010211375472276116,525,807,282,3,4,4,5,3,338,829,79
23,0,206,1,981,980,0,8,1,547,546,0.0,0.0010892133837094523,1,830,829,3,-1,4,2,0,792,668,96
24,12,12,537,537,0,46,46,617,617,0,0.0006807583648184077,0.0006807583648184077,745,745,0,-1,4,4,9,2,126,473,987
25,92,92,879,879,0,92,92,900,900,0,0.0021784267674189047,0.0021784267674189047,897,897,0,-1,3,3,7,17,472,269,960
26,62,164,830,947,117,106,106,855,855,0,0.0009870996289866913,0.001055175465468532,812,817,5,4,3,3,11,14,176,243,378
27,0,0,1,1,0,0,0,1,1,0,0.0,0.0,1,1,0,-1,-1,-1,5,0,692,988,835
28,25,127,698,924,226,44,44,675,675,0,0.00034037918240920387,0.0009530617107457708,653,804,151,4,3,3,7,4,216,645,387
29,4,4,412,412,0,15,15,415,415,0,0.00017018959120460194,0.00017018959120460194,548,548,0,-1,5,5,8,3,260,646,868
30,8,110,559,951,392,8,8,500,500,0,0.0002382654276864427,0.0005786446100956465,615,738,123,4,4,4,2,3,983,300,473
31,10,10,606,606,0,12,12,520,520,0,0.0,0.0,1,1,0,-1,4,4,4,3,607,526,897
32,0,0,1,1,0,0,0,1,1,0,0.0,0.0,1,1,0,-1,-1,-1,3,0,718,863,941
33,0,206,1,976,975,0,8,1,482,481,0.0,0.0005786446100956465,1,733,732,3,-1,4,2,0,925,889,355
34,0,102,1,914,913,0,9,1,408,407,0.0,0.0002042275094455223,1,578,577,4,-1,5,5,0,538,979,282
35,0,206,1,970,969,0,28,1,620,619,0.0,0.0015317063208414173,1,862,861,3,-1,4,6,0,657,908,45
36,0,0,1,1,0,0,0,1,1,0,0.0,0.0,1,1,0,-1,-1,-1,5,1,478,706,872
37,2,618,360,994,634,4,28,360,682,322,6.807583648184077e-05,0.003982436434187685,441,946,505,2,5,3,3,2,731,615,57
38,6,1646,398,1000,602,21,124,411,897,486,0.0,0.015248987371932332,1,986,985,1,4,2,10,3,189,466,9
39,162,263,968,982,14,62,62,967,967,0,0.007590455767725246,0.007624493685966166,978,978,0,5,2,2,3,31,844,35,373
40,70,172,862,949,87,70,70,886,886,0,0.0014636304843595766,0.001497668402600497,846,848,2,4,2,2,6,8,352,187,401
41,61,267,895,989,94,32,32,948,948,0,0.002280540522141666,0.008645631233193778,906,979,73,3,3,3,2,18,998,148,7
42,87,293,931,989,58,32,32,913,913,0,0.0034037918240920387,0.005582218591510943,932,964,32,3,3,3,2,19,928,135,95
43,0,206,1,952,951,0,44,1,518,517,0.0,0.0009870996289866913,1,797,796,3,-1,4,12,0,187,423,497
44,34,240,776,975,199,38,38,852,852,0,0.001157289220191293,0.0012934408931549745,830,848,18,3,3,3,3,8,703,264,223
45,81,182,899,968,69,40,40,863,863,0,0.0017359338302869397,0.00176997174852786,877,881,4,5,3,3,4,17,573,226,530
46,192,398,965,990,25,120,120,985,985,0,0.005514142755029102,0.006603356138738555,965,971,6,3,2,2,6,27,275,88,630
47,0,102,1,932,931,0,6,1,371,370,0.0,3.4037918240920386e-05,1,405,404,4,-1,5,5,0,580,823,210
48,249,455,968,985,17,112,112,929,929,0,0.004595118962524252,0.004935498144933456,951,957,6,3,2,2,8,38,197,111,162
49,0,101,1,893,892,0,8,1,331,330,0.0,0.0,1,1,0,5,-1,6,8,0,428,907,597
50,0,0,1,1,0,0,0,1,1,0,0.0,0.0,1,1,0,-1,-1,-1,2,0,981,773,971
51,9,9,528,528,0,17,17,454,454,0,3.4037918240920386e-05,3.4037918240920386e-05,392,392,0,-1,4,4,7,3,207,580,675
52,2,2,379,379,0,3,3,382,382,0,3.4037918240920386e-05,3.4037918240920386e-05,419,419,0,-1,5,5,2,1,928,594,728
53,12,12,486,486,0,41,41,433,433,0,0.0002042275094455223,0.0002042275094455223,561,561,0,-1,4,4,17,5,10,231,489
54,38,38,741,741,0,68,68,743,743,0,0.0005446066918547262,0.0005446066918547262,699,699,0,-1,3,3,10,3,527,519,752
55,6,212,443,971,528,20,20,610,610,0,0.0002382654276864427,0.0009530617107457708,590,804,214,3,4,4,4,1,544,891,470
56,34,240,736,971,235,52,56,693,709,16,0.000442492937131965,0.0013274788113958951,687,836,149,3,3,3,8,3,428,677,415
57,65,65,863,863,0,64,64,933,933,0,0.002110350930937064,0.002110350930937064,888,888,0,-1,2,2,5,10,656,405,423
58,18,120,661,934,273,22,22,575,575,0,0.00037441710065012424,0.0005446066918547262,653,715,62,4,4,4,5,10,291,266,690
59,6,108,417,902,485,23,23,480,480,0,0.00013615167296368154,0.00013615167296368154,511,511,0,4,4,4,8,1,440,756,639
60,0,616,1,990,989,0,70,1,647,646,0.0,0.003710133088260322,1,942,941,2,-1,3,12,0,87,668,34
61,6,212,446,972,526,10,14,463,542,79,3.4037918240920386e-05,0.00037441710065012424,413,678,265,3,4,4,3,1,746,555,465
62,0,102,1,916,915,0,5,1,365,364,0.0,3.4037918240920386e-05,1,408,407,4,-1,5,4,0,558,916,755
63,0,0,1,1,0,0,0,1,1,0,0.0,0.0,1,1,0,-1,-1,-1,5,0,616,968,796
64,38,654,704,992,288,132,142,773,799,26,0.0007828721195411688,0.002825147213996392,759,916,157,2,3,3,16,3,151,103,44
65,22,22,630,630,0,41,41,539,539,0,0.0002723033459273631,0.0002723033459273631,600,600,0,-1,3,3,10,3,310,290,912
66,18,120,654,928,274,32,32,704,704,0,0.0007828721195411688,0.0009190237925048504,778,803,25,4,3,3,5,2,773,700,214
67,68,68,844,844,0,72,72,842,842,0,0.0009530617107457708,0.0009530617107457708,802,802,0,-1,3,3,7,9,637,154,740
68,0,0,1,1,0,0,0,1,1,0,0.0,0.0,1,1,0,-1,-1,-1,3,0,680,324,367
69,1,1,332,332,0,2,2,332,332,0,0.0,0.0,1,1,0,-1,6,6,2,1,702,621,901
70,10,216,538,961,423,38,38,609,609,0,0.00013615167296368154,0.0005105687736138058,516,702,186,3,4,4,7,4,340,617,658
71,100,100,902,902,0,100,100,975,975,0,0.030429898907382825,0.030600088498587426,997,997,0,3,1,1,5,7,506,170,494
72,0,101,1,929,928,0,2,1,331,330,0.0,3.4037918240920386e-05,1,407,406,5,-1,6,2,0,880,776,627
73,16,632,580,995,415,40,54,654,761,107,0.0002382654276864427,0.0015317063208414173,587,856,269,2,3,3,7,1,170,553,371
74,6,212,402,959,557,20,24,446,490,44,0.00010211375472276115,0.00017018959120460194,479,542,63,3,4,4,6,1,312,870,853
75,145,247,929,970,41,86,86,818,818,0,0.002212464685659825,0.0023486163586235067,894,898,4,4,3,3,10,27,427,61,584
76,5,107,426,921,495,5,6,385,407,22,0.0,0.00034037918240920387,1,648,647,4,5,5,3,3,726,580,306
77,0,102,1,927,926,0,3,1,369,368,0.0,0.0,1,1,0,4,-1,5,2,0,925,970,342
78,92,298,888,977,89,50,50,790,790,0,0.0018380475850097008,0.0026209197045508697,871,910,39,3,3,3,5,22,506,128,390
79,35,35,785,785,0,40,40,779,779,0,0.0007488342013002485,0.0007488342013002485,764,764,0,-1,3,3,5,6,534,232,324
80,0,0,1,1,0,0,0,1,1,0,0.0,0.0,1,1,0,-1,-1,-1,2,0,906,821,846
81,0,616,1,988,987,0,86,1,492,491,0.0,0.0007828721195411688,1,749,748,2,-1,3,23,0,15,902,338
82,0,102,1,928,927,0,4,1,393,392,0.0,0.00030634126416828345,1,644,643,4,-1,5,2,0,752,945,827
83,39,141,848,965,117,22,22,826,826,0,0.0015317063208414173,0.0019061234214915416,873,891,18,4,3,3,2,9,851,242,46
84,0,0,1,1,0,0,0,1,1,0,0.0,0.0,1,1,0,-1,-1,-1,2,0,469,725,520
85,45,251,881,990,109,18,18,800,800,0,0.001940161339732462,0.0025188059498281084,895,916,21,3,4,4,3,12,852,58,622
86,0,102,1,915,914,0,9,1,407,406,0.0,0.00088498587426393,1,793,792,4,-1,5,5,1,565,738,131
87,2,104,349,887,538,18,19,383,389,6,0.0,0.0,1,1,0,4,5,5,11,1,139,788,679
88,27,233,715,970,255,38,38,705,705,0,0.0005446066918547262,0.0007147962830593281,710,757,47,3,3,3,6,5,446,362,619
89,19,120,683,941,258,24,24,744,744,0,0.0006807583648184077,0.0007828721195411688,746,774,28,5,3,3,3,4,839,319,805
90,0,0,1,1,0,0,0,1,1,0,0.0,0.0,1,1,0,-1,-1,-1,2,0,993,937,839
91,0,102,1,927,926,0,7,1,404,403,0.0,0.0002382654276864427,1,605,604,4,-1,5,4,0,423,445,170
92,6,107,487,947,460,18,18,695,695,0,0.0002042275094455223,0.0002042275094455223,576,576,0,5,4,4,3,1,902,689,411
93,6,6,436,436,0,12,12,559,559,0,0.00010211375472276115,0.00010211375472276115,477,477,0,-1,4,4,2,2,893,325,875
94,6,6,438,438,0,20,20,573,573,0,0.00034037918240920387,0.00034037918240920387,660,660,0,-1,4,4,4,1,444,741,787
95,6,108,386,882,496,32,34,393,406,13,0.0,0.0,1,1,0,4,4,4,18,2,111,320,666
96,12,114,592,934,342,12,12,490,490,0,0.00010211375472276115,0.00017018959120460194,477,537,60,4,4,4,4,4,787,380,646
97,96,96,880,880,0,88,88,878,878,0,0.0018040096667687805,0.0018040096667687805,870,870,0,-1,3,3,8,13,365,42,674
98,32,134,748,938,190,50,50,840,840,0,0.0007488342013002485,0.0009190237925048504,769,801,32,4,3,3,5,5,406,535,631
99,0,206,1,981,980,0,18,1,737,736,0.0,0.0027911092957554717,1,925,924,3,-1,4,3,0,850,372,57
100,0,102,1,916,915,0,7,1,400,399,0.0,0.0004084550188910446,1,682,681,4,-1,5,4,0,513,751,316
101,184,285,947,974,27,162,162,928,928,0,0.0026889955410327104,0.0026889955410327104,917,917,0,6,3,3,12,20,106,38,671
102,0,0,1,1,0,0,0,1,1,0,0.0,0.0,1,1,0,-1,-1,-1,7,0,714,955,330
103,0,0,1,1,0,0,0,1,1,0,0.0,0.0,1,1,0,-1,-1,-1,7,1,331,948,489
104,0,616,1,993,992,0,36,1,605,604,0.0,0.00088498587426393,1,790,789,2,-1,3,7,0,221,758,187
105,11,11,602,602,0,8,8,473,473,0,0.0002042275094455223,0.0002042275094455223,573,573,0,-1,4,4,2,5,828,241,848
106,6,108,460,936,476,12,12,594,594,0,0.0002723033459273631,0.0014636304843595766,603,854,251,4,4,4,2,2,966,550,213
107,13,114,678,964,286,10,10,633,633,0,3.4037918240920386e-05,3.4037918240920386e-05,403,403,0,5,4,4,3,9,918,317,518
108,14,220,554,961,407,36,36,565,565,0,0.0006126825283365669,0.0007488342013002485,728,757,29,3,4,4,8,3,236,507,270
109,0,101,1,898,897,0,8,1,332,331,0.0,0.0,1,1,0,5,-1,6,8,0,443,801,460
110,25,231,678,967,289,54,54,661,661,0,0.00030634126416828345,0.0008509479560230097,628,777,149,3,3,3,8,4,231,557,186
111,16,117,616,925,309,42,42,813,813,0,0.000442492937131965,0.0005105687736138058,678,698,20,5,3,3,5,1,457,404,719
112,22,123,612,897,285,84,84,593,593,0,0.00017018959120460194,0.0002042275094455223,543,563,20,5,3,3,17,4,63,239,605
113,255,461,980,996,16,38,38,891,891,0,0.007692569522448007,0.00888389666088022,972,980,8,3,3,3,3,54,912,19,163
114,0,102,1,894,893,0,16,1,366,365,0.0,0.00017018959120460194,1,537,536,4,-1,5,12,0,93,726,252
115,0,102,1,902,901,0,11,1,388,387,0.0,6.807583648184077e-05,1,447,446,4,-1,5,7,0,400,997,214
116,0,102,1,935,934,0,5,1,398,397,0.0,6.807583648184077e-05,1,465,464,4,-1,5,3,1,530,738,477
117,48,48,835,835,0,66,66,885,885,0,0.001157289220191293,0.001157289220191293,830,830,0,-1,3,3,6,4,657,407,950
118,0,0,1,1,0,0,0,1,1,0,0.0,0.0,1,1,0,-1,-1,-1,3,0,745,930,903
119,0,102,1,964,963,0,4,1,467,466,0.0,0.0012594029749140542,1,855,854,4,-1,5,2,0,865,538,141
120,54,54,816,816,0,74,74,816,816,0,0.0005105687736138058,0.0005105687736138058,720,720,0,-1,3,3,8,4,223,470,564
121,8,624,483,993,510,22,44,401,527,126,6.807583648184077e-05,0.0005105687736138058,442,698,256,2,4,3,11,2,167,547,256
122,7,7,544,544,0,14,14,577,577,0,0.00013615167296368154,0.00013615167296368154,516,516,0,-1,4,4,3,3,670,541,876
123,0,0,1,1,0,0,0,1,1,0,0.0,0.0,1,1,0,-1,-1,-1,3,0,613,934,693
124,100,100,879,879,0,100,100,877,877,0,0.04360257326661901,0.04448755914088294,1000,1000,0,3,1,1,9,157,394,2,193
125,0,0,1,1,0,0,0,1,1,0,0.0,0.0,1,1,0,-1,-1,-1,8,0,142,975,836
126,8,214,517,967,450,13,17,459,503,44,3.4037918240920386e-05,0.0002723033459273631,404,608,204,3,4,4,5,2,667,383,525
127,16,118,607,930,323,38,38,827,827,0,0.0004765308553728854,0.0012594029749140542,700,845,145,4,3,3,3,1,725,720,96
128,0,206,1,979,978,0,12,1,569,568,0.0,0.001055175465468532,1,827,826,3,-1,4,4,1,860,738,261
129,91,91,877,877,0,98,98,880,880,0,0.0026209197045508697,0.0026209197045508697,905,905,0,-1,3,3,8,15,223,151,664
130,32,32,768,768,0,34,34,740,740,0,0.0013955546478777359,0.0013955546478777359,848,848,0,-1,3,3,4,5,917,393,533
131,0,0,1,1,0,0,0,1,1,0,0.0,0.0,1,1,0,-1,-1,-1,2,0,702,228,752
132,20,20,646,646,0,44,44,615,615,0,0.0002382654276864427,0.0002382654276864427,605,605,0,-1,4,4,8,5,186,252,698
133,149,355,920,978,58,108,108,895,895,0,0.0022465026039007454,0.0023486163586235067,888,893,5,3,2,2,9,17,263,79,493
134,0,206,1,976,975,0,18,1,657,656,0.0,0.001497668402600497,1,865,864,3,-1,4,3,0,756,565,53
135,63,164,790,918,128,162,162,793,793,0,0.0007147962830593281,0.0007828721195411688,732,744,12,5,2,2,20,5,70,510,593
136,0,206,1,979,978,0,8,1,549,548,0.0,0.0006467204465774873,1,743,742,3,-1,4,2,1,967,830,318
137,1,103,331,914,583,6,10,331,394,63,3.4037918240920386e-05,0.00013615167296368154,387,517,130,4,6,5,6,1,515,543,307
138,2,2,355,355,0,12,12,371,371,0,0.0,0.0,1,1,0,-1,5,5,9,1,180,530,915
139,0,206,1,971,970,0,11,1,450,449,0.0,0.0007147962830593281,1,766,765,3,-1,4,4,1,544,650,619
140,2,2,380,380,0,5,5,415,415,0,0.0002723033459273631,0.0002723033459273631,629,629,0,-1,5,5,3,1,569,527,838
141,6,108,415,902,487,17,17,439,439,0,0.0,3.4037918240920386e-05,1,411,410,4,4,4,8,1,541,623,537
142,91,91,913,913,0,28,28,801,801,0,0.0018040096667687805,0.0018040096667687805,880,880,0,-1,3,3,3,20,583,71,941
143,0,0,1,1,0,0,0,1,1,0,0.0,0.0,1,1,0,-1,-1,-1,5,0,574,367,794
144,31,31,715,715,0,52,52,628,628,0,0.00030634126416828345,0.00030634126416828345,638,638,0,-1,3,3,9,6,213,486,980
145,5,211,425,961,536,13,18,408,459,51,3.4037918240920386e-05,0.0002382654276864427,409,591,182,3,5,4,7,3,364,580,291
146,0,102,1,867,866,0,22,1,355,354,0.0,0.0,1,1,0,4,-1,5,19,0,19,884,878
147,0,206,1,968,967,0,13,1,430,429,0.0,0.0002042275094455223,1,568,567,3,-1,4,7,0,404,514,586
148,44,146,787,933,146,42,42,685,685,0,0.0008169100377820892,0.0009190237925048504,777,793,16,4,3,3,6,10,425,262,208
149,0,206,1,956,955,0,24,1,474,473,0.0,0.0006126825283365669,1,725,724,3,-1,4,9,0,339,992,245
150,0,102,1,912,911,0,5,1,359,358,0.0,0.00017018959120460194,1,543,542,4,-1,5,4,0,759,740,383
151,6,107,458,941,483,7,7,467,467,0,6.807583648184077e-05,6.807583648184077e-05,446,446,0,5,4,4,2,2,954,342,662
152,0,206,1,964,963,0,12,1,441,440,0.0,0.0002042275094455223,1,556,555,3,-1,4,5,0,501,819,170
153,10,111,718,977,259,12,12,808,808,0,0.0005105687736138058,0.0005446066918547262,740,750,10,6,4,4,2,4,978,622,694
154,8,214,533,974,441,22,26,594,643,49,0.00013615167296368154,0.0004084550188910446,520,680,160,3,4,4,5,3,848,290,328
155,51,153,837,945,108,38,38,814,814,0,0.0008169100377820892,0.0008509479560230097,781,788,7,4,3,3,3,9,731,240,661
156,0,0,1,1,0,0,0,1,1,0,0.0,0.0,1,1,0,-1,-1,-1,2,1,948,693,828
157,0,0,1,1,0,0,0,1,1,0,0.0,0.0,1,1,0,-1,-1,-1,9,0,168,588,833
158,12,12,594,594,0,18,18,624,624,0,0.0008169100377820892,0.0008169100377820892,786,786,0,-1,4,4,3,3,855,209,813
159,6,108,446,920,474,32,32,636,636,0,0.00010211375472276115,0.00013615167296368154,493,519,26,4,4,4,6,1,465,667,599
160,19,225,740,983,243,18,22,829,847,18,0.000442492937131965,0.002144388849177984,680,900,220,3,3,3,2,3,946,704,73
161,66,66,832,832,0,94,94,841,841,0,0.0016338200755641784,0.0016338200755641784,866,866,0,-1,2,2,9,8,217,186,925
162,194,296,942,972,30,200,200,969,969,0,0.004765308553728854,0.005037611899656217,951,959,8,4,2,2,12,22,292,128,236
163,0,0,1,1,0,0,0,1,1,0,0.0,0.0,1,1,0,-1,-1,-1,4,0,832,922,826
164,6,6,443,443,0,20,20,591,591,0,3.4037918240920386e-05,3.4037918240920386e-05,407,407,0,-1,4,4,4,2,566,544,776
165,117,219,937,972,35,44,44,857,857,0,0.0028591851322373124,0.003199564314646516,916,924,8,4,3,3,4,27,545,69,480
166,0,0,1,1,0,0,0,1,1,0,0.0,0.0,1,1,0,-1,-1,-1,16,0,78,796,903
167,6,108,434,914,480,24,24,544,544,0,6.807583648184077e-05,6.807583648184077e-05,442,442,0,4,4,4,6,2,441,544,526
168,1,207,333,963,630,8,32,333,546,213,0.0,0.0011232513019503727,1,812,811,3,6,4,8,1,325,671,78
169,16,16,591,591,0,52,52,710,710,0,0.0004765308553728854,0.0004765308553728854,693,693,0,-1,3,3,7,1,340,759,568
170,9,111,583,942,359,10,10,508,508,0,0.0002042275094455223,0.0004084550188910446,585,684,99,4,4,4,3,3,770,222,727
171,36,138,765,938,173,58,58,772,772,0,0.0006807583648184077,0.001157289220191293,745,817,72,4,3,3,7,5,364,283,461
172,18,119,675,938,263,20,20,622,622,0,0.0004084550188910446,0.0004084550188910446,687,687,0,5,4,4,4,6,885,467,331
173,0,0,1,1,0,0,0,1,1,0,0.0,0.0,1,1,0,-1,-1,-1,3,1,627,742,428
174,0,206,1,966,965,0,13,1,443,442,0.0,0.00013615167296368154,1,516,515,3,-1,4,5,0,377,938,722
175,86,86,849,849,0,126,126,892,892,0,0.0018040096667687805,0.0018040096667687805,868,868,0,-1,3,3,11,13,163,255,803
176,0,206,1,974,973,0,11,1,486,485,0.0,0.0002042275094455223,1,567,566,3,-1,4,4,0,772,822,212
177,0,0,1,1,0,0,0,1,1,0,0.0,0.0,1,1,0,-1,-1,-1,4,0,741,200,908
178,0,102,1,883,882,0,12,1,359,358,0.0,0.0,1,1,0,4,-1,5,10,0,256,276,430
179,51,152,844,957,113,30,30,766,766,0,0.0009530617107457708,0.001157289220191293,812,836,24,5,3,3,4,13,461,340,670
180,53,259,819,974,155,68,72,823,836,13,0.0020763130126961434,0.003199564314646516,897,934,37,3,2,2,7,7,170,371,351
181,46,46,805,805,0,84,84,840,840,0,0.0012594029749140542,0.0012594029749140542,833,833,0,-1,3,3,9,8,177,174,271
182,8,8,530,530,0,13,13,457,457,0,0.00013615167296368154,0.00013615167296368154,525,525,0,-1,4,4,5,2,363,383,587
183,34,135,786,947,161,28,28,792,792,0,0.0007488342013002485,0.0007488342013002485,778,778,0,5,3,3,3,4,620,246,495
184,0,0,1,1,0,0,0,1,1,0,0.0,0.0,1,1,0,-1,-1,-1,5,1,695,874,823
185,176,176,922,922,0,284,284,932,932,0,0.0028591851322373124,0.0028591851322373124,917,917,0,-1,2,2,21,13,54,183,686
186,0,0,1,1,0,0,0,1,1,0,0.0,0.0,1,1,0,-1,-1,-1,11,0,261,372,962
187,6,6,420,420,0,20,20,477,477,0,0.00010211375472276115,0.00010211375472276115,481,481,0,-1,4,4,7,1,340,743,856
188,133,235,962,983,21,38,38,930,930,0,0.0046972327172470135,0.005377991082065421,954,959,5,4,3,3,3,27,916,25,658
189,6,212,387,946,559,64,68,497,504,7,0.0,0.0002042275094455223,1,566,565,3,4,4,18,1,64,416,379
190,0,616,1,997,996,0,32,1,732,731,0.0,0.004356853534837809,1,949,948,2,-1,3,5,3,765,854,14
191,15,117,600,918,318,24,24,524,524,0,0.00030634126416828345,0.000442492937131965,633,692,59,4,4,4,6,5,328,591,523
192,216,316,943,969,26,224,224,891,891,0,0.0021784267674189047,0.0021784267674189047,892,892,0,4,3,3,19,23,89,66,558
193,13,219,727,990,263,12,12,763,763,0,0.00088498587426393,0.0018040096667687805,797,896,99,3,4,4,2,3,865,438,658
194,88,704,912,999,87,50,60,868,920,52,0.002552843868069029,0.003914360597705844,906,938,32,2,3,3,5,21,580,123,427
195,30,130,840,971,131,14,14,684,684,0,0.00088498587426393,0.001055175465468532,804,826,22,4,4,4,3,17,730,131,237
196,4,4,448,448,0,7,7,419,419,0,0.00010211375472276115,0.00010211375472276115,493,493,0,-1,5,5,4,2,679,383,824
197,6,108,402,894,492,38,38,589,589,0,0.0002382654276864427,0.00034037918240920387,595,644,49,4,4,4,7,1,591,711,602
198,0,0,1,1,0,0,0,1,1,0,0.0,0.0,1,1,0,-1,-1,-1,15,0,110,768,835
199,0,206,1,944,943,0,32,1,378,377,0.0,0.0,1,1,0,3,-1,4,21,0,12,892,873
200,20,20,731,731,0,12,12,608,608,0,0.0006467204465774873,0.0006467204465774873,754,754,0,-1,4,4,2,4,924,470,514
201,0,0,1,1,0,0,0,1,1,0,0.0,0.0,1,1,0,-1,-1,-1,3,0,674,970,737
202,0,102,1,943,942,0,3,1,371,370,0.0,6.807583648184077e-05,1,444,443,4,-1,5,2,0,761,930,380
203,22,124,661,916,255,42,42,668,668,0,0.0004765308553728854,0.0004765308553728854,693,693,0,4,3,3,6,3,432,525,560
204,6,6,525,525,0,8,8,562,562,0,0.0002042275094455223,0.0002042275094455223,591,591,0,-1,4,4,2,1,994,809,868
205,2,2,357,357,0,5,5,357,357,0,3.4037918240920386e-05,3.4037918240920386e-05,407,407,0,-1,5,5,4,2,755,292,675
206,22,124,629,907,278,52,52,625,625,0,0.0002723033459273631,0.00037441710065012424,609,654,45,4,3,3,9,2,269,586,532
207,94,195,924,976,52,22,22,792,792,0,0.002552843868069029,0.002586881786309949,911,912,1,6,3,3,2,20,970,43,687
208,2,103,395,962,567,3,3,404,404,0,3.4037918240920386e-05,0.0002042275094455223,414,591,177,5,5,5,2,1,788,552,532
209,49,255,862,982,120,22,22,806,806,0,0.0007147962830593281,0.0019741992579733825,766,893,127,3,3,3,2,14,816,175,49
210,2,104,347,875,528,18,20,347,360,13,0.00010211375472276115,0.0002723033459273631,478,614,136,4,5,5,17,2,210,739,596
211,25,127,750,950,200,12,12,584,584,0,0.0007488342013002485,0.00088498587426393,775,799,24,4,4,4,2,10,429,195,263
212,0,616,1,992,991,0,51,1,508,507,0.0,0.0008169100377820892,1,781,780,2,-1,3,15,0,32,846,242
213,61,61,852,852,0,34,34,750,750,0,0.0011913271384322134,0.0011913271384322134,831,831,0,-1,3,3,4,12,572,99,796
214,62,268,848,978,130,36,36,744,744,0,0.001157289220191293,0.0014295925661186562,830,851,21,3,3,3,5,17,538,226,188
215,6,107,457,929,472,13,13,477,477,0,3.4037918240920386e-05,3.4037918240920386e-05,402,402,0,8,4,4,5,3,435,321,765
216,4,106,419,916,497,8,8,389,389,0,0.00010211375472276115,0.00030634126416828345,473,640,167,4,5,5,5,5,396,476,499
217,1,103,333,882,549,14,22,333,376,43,3.4037918240920386e-05,0.0002382654276864427,394,575,181,4,6,5,14,2,332,656,504
218,6,212,410,955,545,20,34,420,507,87,0.0,0.0009530617107457708,1,795,794,3,4,4,9,1,192,807,255
219,29,131,725,924,199,62,62,793,793,0,0.0005446066918547262,0.0006807583648184077,717,756,39,4,3,3,7,9,637,293,278
220,118,734,919,998,79,122,122,970,970,0,0.005412029000306341,0.014023622315259198,961,987,26,2,2,2,8,14,431,146,37
221,91,91,861,861,0,94,94,850,850,0,0.002382654276864427,0.002382654276864427,894,894,0,-1,3,3,9,14,263,84,436
222,0,616,1,995,994,0,48,1,670,669,0.0,0.004152626025392287,1,943,942,2,-1,3,7,0,209,902,126
223,6,108,467,936,469,18,18,577,577,0,0.00017018959120460194,0.00030634126416828345,552,639,87,4,4,4,5,1,695,711,510
224,0,102,1,929,928,0,4,1,394,393,0.0,0.00010211375472276115,1,495,494,4,-1,5,2,1,643,641,239
225,2,2,352,352,0,14,14,363,363,0,3.4037918240920386e-05,3.4037918240920386e-05,404,404,0,-1,5,5,12,2,143,692,604
226,0,101,1,946,945,0,2,1,331,330,0.0,0.0,1,1,0,5,-1,6,2,3,684,348,893
227,2,208,376,978,602,4,12,423,634,211,3.4037918240920386e-05,0.005684332346233704,409,962,553,3,5,4,2,1,723,762,9
228,36,36,761,761,0,40,40,664,664,0,0.0006807583648184077,0.0006807583648184077,763,763,0,-1,3,3,5,8,238,345,483
229,0,206,1,981,980,0,10,1,535,534,0.0,0.002484768031587188,1,910,909,3,-1,4,3,0,718,965,74
230,267,267,985,985,0,44,44,916,916,0,0.008475441641989176,0.008475441641989176,977,977,0,-1,3,3,4,62,827,70,860
231,29,29,721,721,0,84,84,834,834,0,0.0010211375472276116,0.0010211375472276116,799,799,0,-1,3,3,9,4,289,125,324
232,223,324,984,992,8,32,32,943,943,0,0.007454304094761564,0.007454304094761564,971,971,0,5,3,3,2,62,929,70,321
233,782,988,998,999,1,142,142,984,984,0,0.014261887742945642,0.014704380680077607,986,988,2,3,2,2,8,127,146,11,316
234,95,95,936,936,0,12,12,649,649,0,0.0034037918240920387,0.0034037918240920387,940,940,0,-1,4,4,2,25,838,105,740
235,42,143,800,938,138,62,62,943,943,0,0.0017359338302869397,0.0017359338302869397,876,876,0,5,2,2,3,3,731,541,563
236,24,24,746,746,0,12,12,619,619,0,0.00037441710065012424,0.00037441710065012424,677,677,0,-1,4,4,2,6,750,136,488
237,40,246,695,951,256,172,176,763,774,11,0.0009530617107457708,0.001055175465468532,792,810,18,3,2,2,21,2,54,160,553
238,21,21,701,701,0,16,16,544,544,0,0.00010211375472276115,0.00010211375472276115,485,485,0,-1,4,4,4,5,593,528,916
239,0,101,1,970,969,0,2,1,331,330,0.0,0.0,1,1,0,6,-1,7,2,2,920,752,853
240,128,128,922,922,0,82,82,879,879,0,0.0033016780693692774,0.0033016780693692774,925,925,0,-1,3,3,7,21,335,123,908
241,22,638,709,997,288,50,60,868,920,52,0.0010211375472276116,0.004220701861874128,804,942,138,2,3,3,5,4,580,143,26
242,10,111,644,962,318,12,12,661,661,0,0.00013615167296368154,0.00017018959120460194,539,569,30,5,4,4,2,5,742,688,853
243,0,0,1,1,0,0,0,1,1,0,0.0,0.0,1,1,0,-1,-1,-1,4,0,648,991,546
244,0,101,1,911,910,0,5,1,332,331,0.0,0.0,1,1,0,5,-1,6,5,1,338,948,342
245,0,206,1,977,976,0,8,1,496,495,0.0,0.0024166921951053475,1,911,910,3,-1,4,2,0,907,865,48
246,32,134,659,894,235,102,102,611,611,0,0.0006126825283365669,0.0006807583648184077,725,743,18,4,4,4,19,8,31,386,487
247,50,50,821,821,0,64,64,901,901,0,0.002484768031587188,0.002484768031587188,909,909,0,-1,2,2,5,5,571,252,641
248,177,279,959,980,21,74,74,956,956,0,0.006024711528642908,0.006058749446883829,966,966,0,4,2,2,5,25,476,105,799
249,15,15,547,547,0,42,42,492,492,0,0.0002723033459273631,0.0002723033459273631,601,601,0,-1,4,4,13,6,129,459,685
250,1,207,332,968,636,3,18,332,608,276,0.0,0.00176997174852786,1,870,869,3,6,4,3,3,778,181,203
251,6,6,435,435,0,18,18,561,561,0,0.0005786446100956465,0.0005786446100956465,713,713,0,-1,4,4,3,1,837,404,830
252,9,111,477,882,405,56,56,490,490,0,3.4037918240920386e-05,6.807583648184077e-05,401,448,47,4,4,4,16,3,27,580,156
253,0,616,1,995,994,0,24,1,684,683,0.0,0.0017359338302869397,1,869,868,2,-1,3,3,0,704,831,234
254,6,108,388,881,493,24,25,384,386,2,6.807583648184077e-05,6.807583648184077e-05,443,443,0,4,4,4,14,1,108,896,885
255,42,248,743,957,214,90,90,666,666,0,0.000442492937131965,0.001157289220191293,676,818,142,3,3,3,14,11,21,249,559
256,0,101,1,952,951,0,2,1,331,330,0.0,0.0,1,1,0,6,-1,7,2,0,792,901,717
257,1,103,332,943,611,3,6,332,452,120,3.4037918240920386e-05,0.0007828721195411688,399,777,378,4,6,5,3,2,953,357,106
258,0,206,1,978,977,0,7,1,500,499,0.0,0.0004765308553728854,1,704,703,3,-1,4,2,0,939,818,399
259,6,6,417,417,0,17,17,426,426,0,0.0,0.0,1,1,0,-1,4,4,7,2,216,648,737
260,0,102,1,941,940,0,3,1,380,379,0.0,0.00010211375472276115,1,489,488,4,-1,5,2,0,817,349,392
261,0,101,1,964,963,0,3,1,330,329,0.0,0.0,1,1,0,6,-1,7,3,0,786,254,448
262,13,114,666,956,290,12,12,530,530,0,0.0002723033459273631,0.00034037918240920387,611,646,35,5,4,4,4,6,738,683,761
263,10,10,576,576,0,18,18,653,653,0,0.0007828721195411688,0.0007828721195411688,788,788,0,-1,4,4,3,3,672,268,860
264,52,154,809,938,129,52,52,708,708,0,0.0005446066918547262,0.0005446066918547262,723,723,0,4,3,3,7,11,372,52,361
265,19,121,687,937,250,30,30,743,743,0,0.0009530617107457708,0.002144388849177984,810,895,85,4,3,3,4,3,313,438,397
266,215,215,973,973,0,76,76,903,903,0,0.004322815616596889,0.004322815616596889,950,950,0,-1,3,3,6,27,515,25,969
267,18,18,654,654,0,34,34,738,738,0,0.00017018959120460194,0.00017018959120460194,543,543,0,-1,3,3,4,4,623,149,855
268,24,125,758,955,197,12,12,616,616,0,0.0007828721195411688,0.0009190237925048504,777,798,21,5,4,4,2,8,937,161,550
269,18,120,581,892,311,49,49,533,533,0,0.0002382654276864427,0.0002382654276864427,585,585,0,4,3,3,12,2,52,408,837
270,2,104,386,960,574,4,4,391,391,0,0.0,0.0002723033459273631,1,629,628,4,5,5,3,1,852,503,521
271,16,16,615,615,0,20,20,566,566,0,0.00030634126416828345,0.00030634126416828345,621,621,0,-1,4,4,4,6,832,683,836
272,350,966,976,997,21,320,320,979,979,0,0.005377991082065421,0.008101024541339052,958,969,11,2,2,2,18,30,64,75,76
273,24,125,755,948,193,12,12,588,588,0,0.0006807583648184077,0.0007147962830593281,760,764,4,5,4,4,2,6,598,461,662
274,14,115,667,953,286,8,8,519,519,0,0.000442492937131965,0.000442492937131965,695,695,0,5,4,4,2,4,979,637,714
275,2,104,366,932,566,5,6,368,386,18,0.0,6.807583648184077e-05,1,444,443,4,5,5,4,1,772,734,512
276,82,183,964,989,25,22,22,942,942,0,0.004050512270669526,0.004118588107151367,950,953,3,5,3,3,2,25,973,105,164
277,4,105,482,955,473,4,4,382,382,0,3.4037918240920386e-05,0.0002042275094455223,400,571,171,5,5,5,3,4,875,398,191
278,26,127,776,954,178,12,12,608,608,0,0.0004765308553728854,0.0004765308553728854,702,702,0,5,4,4,2,6,924,46,290
279,0,0,1,1,0,0,0,1,1,0,0.0,0.0,1,1,0,-1,-1,-1,6,0,387,930,990
280,6,6,386,386,0,25,25,419,419,0,0.0,0.0,1,1,0,-1,4,4,11,1,66,449,725
281,142,142,957,957,0,32,32,900,900,0,0.00439089145307873,0.00439089145307873,948,948,0,-1,3,3,2,29,589,142,986
282,19,19,700,700,0,22,22,623,623,0,0.00030634126416828345,0.00030634126416828345,631,631,0,-1,4,4,5,6,685,432,751
283,0,0,1,1,0,0,0,1,1,0,0.0,0.0,1,1,0,-1,-1,-1,4,1,650,660,970
284,36,36,817,817,0,22,22,790,790,0,0.0006467204465774873,0.0006467204465774873,753,753,0,-1,3,3,2,6,880,194,604
285,15,116,621,926,305,18,18,520,520,0,0.00013615167296368154,0.00013615167296368154,532,532,0,6,4,4,5,6,314,459,344
286,296,296,965,965,0,280,280,966,966,0,0.0045270431260424114,0.0045270431260424114,945,945,0,-1,2,2,17,32,24,26,915
287,6,108,461,932,471,16,16,566,566,0,0.00017018959120460194,0.00034037918240920387,544,641,97,4,4,4,4,1,563,958,486
288,0,101,1,960,959,0,2,1,330,329,0.0,0.00017018959120460194,1,542,541,5,-1,6,2,0,950,533,311
289,0,0,1,1,0,0,0,1,1,0,0.0,0.0,1,1,0,-1,-1,-1,6,0,312,701,750
290,0,0,1,1,0,0,0,1,1,0,0.0,0.0,1,1,0,-1,-1,-1,4,0,762,910,745
291,9,111,564,931,367,16,16,541,541,0,0.00017018959120460194,0.0004084550188910446,539,668,129,4,4,4,4,4,545,278,622
292,1,207,333,948,615,16,25,333,381,48,0.0,0.00010211375472276115,1,480,479,3,6,4,16,1,59,703,319
293,0,206,1,946,945,0,42,1,502,501,0.0,0.0005446066918547262,1,715,714,3,-1,4,11,1,66,835,490
294,114,114,899,899,0,102,102,799,799,0,0.0013274788113958951,0.0013274788113958951,832,832,0,-1,3,3,12,17,212,96,961
295,1,1,332,332,0,2,2,332,332,0,0.0,0.0,1,1,0,-1,6,6,2,2,905,764,587
296,6,212,424,962,538,20,36,471,598,127,6.807583648184077e-05,0.0012253650566731338,445,833,388,3,4,4,8,2,158,215,60
297,0,0,1,1,0,0,0,1,1,0,0.0,0.0,1,1,0,-1,-1,-1,11,0,188,812,820
298,0,206,1,957,956,0,34,1,582,581,0.0,0.0005446066918547262,1,716,715,3,-1,4,7,0,343,991,177
299,19,121,657,929,272,41,41,647,647,0,0.0004765308553728854,0.0005786446100956465,691,725,34,4,3,3,8,4,323,278,302
300,30,132,733,930,197,48,48,708,708,0,0.0004765308553728854,0.0005446066918547262,704,724,20,4,3,3,7,9,156,29,720
301,0,102,1,906,905,0,11,1,389,388,0.0,0.00010211375472276115,1,481,480,4,-1,5,7,0,658,826,215
302,5,5,487,487,0,3,3,381,381,0,0.00010211375472276115,0.00010211375472276115,490,490,0,-1,5,5,2,3,817,526,542
303,0,102,1,923,922,0,11,1,424,423,0.0,0.00037441710065012424,1,661,660,4,-1,5,6,1,494,472,413
304,0,0,1,1,0,0,0,1,1,0,0.0,0.0,1,1,0,-1,-1,-1,6,0,556,782,908
305,6,6,507,507,0,6,6,468,468,0,0.0002382654276864427,0.0002382654276864427,614,614,0,-1,5,5,3,3,790,93,963
306,19,19,734,734,0,8,8,522,522,0,0.0004084550188910446,0.0004084550188910446,685,685,0,-1,4,4,2,7,702,115,685
307,38,244,822,981,159,18,18,697,697,0,0.0004765308553728854,0.0018380475850097008,698,875,177,3,4,4,3,13,433,120,73
308,9,9,474,474,0,45,45,472,472,0,0.0002042275094455223,0.0002042275094455223,557,557,0,-1,4,4,16,4,134,319,686
309,0,616,1,997,996,0,25,1,681,680,0.0,0.0020422750944552232,1,890,889,2,-1,3,4,1,711,456,127
310,0,0,1,1,0,0,0,1,1,0,0.0,0.0,1,1,0,-1,-1,-1,12,0,239,932,883
311,0,102,1,881,880,0,16,1,376,375,0.0,0.00010211375472276115,1,486,485,4,-1,5,11,0,279,974,309
312,0,102,1,913,912,0,7,1,394,393,0.0,0.0006467204465774873,1,745,744,4,-1,5,4,0,711,429,296
313,263,263,966,966,0,194,194,951,951,0,0.005105687736138058,0.005105687736138058,954,954,0,-1,3,3,14,29,268,17,902
314,100,100,884,884,0,100,100,926,926,0,0.035025017869907075,0.035025017869907075,1000,1000,0,-1,1,1,8,127,595,11,825
315,0,206,1,970,969,0,14,1,461,460,0.0,0.0007147962830593281,1,752,751,3,-1,4,5,0,561,733,382
316,168,168,969,969,0,38,38,891,891,0,0.003199564314646516,0.003199564314646516,928,928,0,-1,3,3,3,44,903,27,520
317,0,206,1,970,969,0,18,1,544,543,0.0,0.0014636304843595766,1,853,852,3,-1,4,5,3,463,746,297
318,38,38,807,807,0,30,30,769,769,0,0.0010892133837094523,0.0010892133837094523,819,819,0,-1,3,3,4,8,787,177,349
319,14,115,669,957,288,8,8,523,523,0,0.0002723033459273631,0.0002723033459273631,623,623,0,5,4,4,2,5,942,688,444
320,1,103,333,933,600,4,6,333,381,48,0.0,0.00010211375472276115,1,476,475,4,6,5,4,1,581,140,350
321,0,206,1,951,950,0,50,1,569,568,0.0,0.0020082371762143027,1,873,872,3,-1,4,11,0,215,944,35
322,0,206,1,949,948,0,33,1,436,435,0.0,0.0002382654276864427,1,582,581,3,-1,4,13,0,67,483,697
323,0,102,1,939,938,0,5,1,400,399,0.0,0.0002042275094455223,1,564,563,4,-1,5,3,0,628,925,450
324,157,259,916,962,46,230,230,957,957,0,0.003437829742332959,0.003608019333537561,925,927,2,4,2,2,16,17,134,85,474
325,0,102,1,876,875,0,17,1,363,362,0.0,6.807583648184077e-05,1,436,435,4,-1,5,14,1,133,789,534
326,526,526,995,995,0,128,128,994,994,0,0.014329963579427483,0.014329963579427483,991,991,0,-1,2,2,5,91,247,7,920
327,2,618,354,991,637,18,48,376,521,145,0.0,0.0008509479560230097,1,777,776,2,5,3,13,1,90,853,616
328,0,0,1,1,0,0,0,1,1,0,0.0,0.0,1,1,0,-1,-1,-1,3,0,850,826,938
329,41,41,823,823,0,18,18,653,653,0,0.0008509479560230097,0.0008509479560230097,799,799,0,-1,4,4,3,10,672,366,914
330,0,0,1,1,0,0,0,1,1,0,0.0,0.0,1,1,0,-1,-1,-1,11,0,360,445,848
331,8,214,543,973,430,10,24,473,680,207,6.807583648184077e-05,0.0061949011198475104,462,966,504,3,4,4,4,3,619,585,19
332,25,231,650,955,305,76,80,590,601,11,0.0004084550188910446,0.0007828721195411688,671,765,94,3,3,3,15,7,0,427,247
333,0,0,1,1,0,0,0,1,1,0,0.0,0.0,1,1,0,-1,-1,-1,12,0,194,604,705
334,0,616,1,998,997,0,18,1,773,772,0.0,0.005684332346233704,1,963,962,2,-1,3,2,0,761,922,75
335,941,1043,999,1000,1,120,120,982,982,0,0.019878144252697506,0.019912182170938427,993,993,0,4,2,2,6,157,498,2,300
336,24,125,742,939,197,30,30,699,699,0,0.0007147962830593281,0.0007488342013002485,756,766,10,5,3,3,6,6,594,447,607
337,6,212,459,972,513,8,24,438,702,264,6.807583648184077e-05,0.004595118962524252,453,952,499,3,5,4,4,3,543,214,16
338,0,102,1,906,905,0,8,1,380,379,0.0,0.00017018959120460194,1,548,547,4,-1,5,5,0,392,632,350
339,0,0,1,1,0,0,0,1,1,0,0.0,0.0,1,1,0,-1,-1,-1,6,1,295,962,920
340,19,225,766,989,223,19,19,865,865,0,0.0012253650566731338,0.0018720855032506212,837,889,52,3,3,3,3,3,786,411,340
341,2,2,362,362,0,6,6,393,393,0,3.4037918240920386e-05,3.4037918240920386e-05,418,418,0,-1,5,5,3,1,613,601,984
342,0,102,1,926,925,0,5,1,380,379,0.0,0.0005786446100956465,1,741,740,4,-1,5,3,0,864,938,299
343,56,262,797,961,164,152,152,905,905,0,0.001599782157323258,0.0019741992579733825,853,880,27,3,2,2,13,7,91,224,90
344,0,0,1,1,0,0,0,1,1,0,0.0,0.0,1,1,0,-1,-1,-1,21,0,2,826,970
345,16,16,614,614,0,36,36,736,736,0,0.0009530617107457708,0.0009530617107457708,797,797,0,-1,3,3,5,1,692,612,951
346,0,206,1,951,950,0,18,1,405,404,0.0,0.000442492937131965,1,685,684,3,-1,4,9,0,123,963,188
347,0,206,1,951,950,0,54,1,510,509,0.0,0.0005105687736138058,1,708,707,3,-1,4,15,2,32,775,295
348,0,206,1,968,967,0,10,1,439,438,0.0,0.00030634126416828345,1,635,634,3,-1,4,4,0,949,833,700
349,0,206,1,948,947,0,21,1,397,396,0.0,6.807583648184077e-05,1,439,438,3,-1,4,11,0,163,865,468
350,34,650,695,994,299,124,134,804,832,28,0.00037441710065012424,0.0014636304843595766,653,845,192,2,3,3,14,5,154,619,387
351,124,226,905,960,55,136,136,890,890,0,0.002995336805200994,0.0030634126416828346,922,924,2,4,2,2,12,14,187,84,466
352,0,0,1,1,0,0,0,1,1,0,0.0,0.0,1,1,0,-1,-1,-1,17,1,56,828,359
353,84,186,823,928,105,188,188,809,809,0,0.0008509479560230097,0.00088498587426393,765,770,5,4,3,3,22,11,22,83,601
354,36,242,770,973,203,46,46,737,737,0,0.0005105687736138058,0.0009530617107457708,709,797,88,3,3,3,6,5,549,182,187
355,2,208,377,979,602,3,12,381,654,273,6.807583648184077e-05,0.0012934408931549745,458,848,390,3,5,4,2,1,817,734,255
356,74,176,834,935,101,134,134,823,823,0,0.0010211375472276116,0.0010892133837094523,798,807,9,4,3,3,14,14,121,243,549
357,0,0,1,1,0,0,0,1,1,0,0.0,0.0,1,1,0,-1,-1,-1,9,0,388,819,934
358,0,0,1,1,0,0,0,1,1,0,0.0,0.0,1,1,0,-1,-1,-1,4,1,762,742,673
359,0,0,1,1,0,0,0,1,1,0,0.0,0.0,1,1,0,-1,-1,-1,4,0,741,200,999
360,4,106,454,935,481,6,6,402,402,0,6.807583648184077e-05,0.00037441710065012424,449,680,231,4,5,5,4,5,827,464,121
361,0,102,1,978,977,0,4,1,544,543,0.0,0.0026209197045508697,1,915,914,4,-1,5,2,0,775,990,33
362,0,102,1,921,920,0,7,1,401,400,0.0,0.00037441710065012424,1,673,672,4,-1,5,4,0,280,801,267
363,0,616,1,1000,999,0,22,1,867,866,0.0,0.006977773239388679,1,972,971,2,-1,3,2,0,806,971,70
364,0,101,1,929,928,0,3,1,331,330,0.0,0.0,1,1,0,5,-1,6,3,1,712,874,563
365,54,156,861,961,100,18,18,675,675,0,0.0013274788113958951,0.001940161339732462,841,880,39,4,4,4,3,19,628,59,139
366,15,117,663,944,281,14,14,589,589,0,0.0002042275094455223,0.0004765308553728854,583,707,124,4,4,4,3,4,863,557,610
367,0,206,1,959,958,0,20,1,421,420,0.0,0.0004084550188910446,1,675,674,3,-1,4,9,1,422,568,40
368,16,222,564,955,391,100,100,816,816,0,0.00037441710065012424,0.0005786446100956465,654,713,59,3,3,3,10,2,310,493,510
369,0,206,1,978,977,0,10,1,518,517,0.0,0.0008169100377820892,1,795,794,3,-1,4,3,0,642,324,403
370,0,0,1,1,0,0,0,1,1,0,0.0,0.0,1,1,0,-1,-1,-1,16,0,60,894,800
371,34,34,764,764,0,40,40,777,777,0,0.00034037918240920387,0.00034037918240920387,639,639,0,-1,3,3,5,5,487,338,426
372,0,102,1,918,917,0,7,1,384,383,0.0,0.00030634126416828345,1,643,642,4,-1,5,4,0,736,367,406
373,52,154,843,954,111,52,52,954,954,0,0.002825147213996392,0.003165526396405596,913,925,12,4,2,2,3,4,836,326,759
374,9,9,597,597,0,11,11,527,527,0,6.807583648184077e-05,6.807583648184077e-05,459,459,0,-1,4,4,4,4,480,581,823
375,112,318,920,981,61,84,84,954,954,0,0.0028591851322373124,0.0038462847612240037,917,942,25,3,2,2,5,18,406,171,345
376,21,123,686,940,254,30,30,676,676,0,0.0002382654276864427,0.00037441710065012424,595,658,63,4,4,4,5,7,326,176,260
377,40,40,746,746,0,74,74,748,748,0,0.001157289220191293,0.001157289220191293,811,811,0,-1,3,3,9,4,381,185,907
378,4,210,421,968,547,9,13,413,453,40,0.00010211375472276115,0.0002382654276864427,487,596,109,3,5,4,5,3,692,585,555
379,0,0,1,1,0,0,0,1,1,0,0.0,0.0,1,1,0,-1,-1,-1,11,1,271,747,517
380,0,0,1,1,0,0,0,1,1,0,0.0,0.0,1,1,0,-1,-1,-1,4,0,671,844,949
381,0,206,1,967,966,0,11,1,442,441,0.0,0.0002723033459273631,1,609,608,3,-1,4,5,0,524,574,188
382,3,3,449,449,0,4,4,443,443,0,3.4037918240920386e-05,3.4037918240920386e-05,399,399,0,-1,5,5,2,3,876,761,993
383,0,0,1,1,0,0,0,1,1,0,0.0,0.0,1,1,0,-1,-1,-1,15,0,104,894,925
384,0,206,1,972,971,0,16,1,535,534,0.0,0.0005786446100956465,1,731,730,3,-1,4,4,0,397,866,303
385,0,0,1,1,0,0,0,1,1,0,0.0,0.0,1,1,0,-1,-1,-1,7,0,171,515,783
386,0,616,1,990,989,0,43,1,526,525,0.0,0.0009530617107457708,1,802,801,2,-1,3,11,0,307,940,185
387,44,250,774,964,190,102,102,841,841,0,0.0007828721195411688,0.0009870996289866913,760,791,31,3,3,3,11,5,155,338,323
388,13,115,533,895,362,50,50,526,526,0,0.00013615167296368154,0.0002382654276864427,510,587,77,4,4,4,13,5,90,710,278
389,45,45,848,848,0,22,22,773,773,0,0.0008509479560230097,0.0008509479560230097,798,798,0,-1,3,3,2,13,598,120,660
390,6,108,458,927,469,17,18,530,542,12,3.4037918240920386e-05,0.00013615167296368154,405,529,124,4,4,4,5,1,456,360,468
391,88,188,874,957,83,64,64,763,763,0,0.0012594029749140542,0.0014295925661186562,833,848,15,4,3,3,9,19,177,59,149
392,23,125,746,951,205,22,22,779,779,0,0.00037441710065012424,0.0013955546478777359,679,859,180,4,3,3,2,4,904,220,180
393,22,124,656,921,265,34,34,635,635,0,0.0002382654276864427,0.0005105687736138058,580,711,131,4,3,3,6,3,393,496,315
394,34,240,802,978,176,24,24,759,759,0,0.0005105687736138058,0.00088498587426393,726,801,75,3,3,3,3,11,588,52,216
395,29,29,762,762,0,20,20,610,610,0,0.0005786446100956465,0.0005786446100956465,725,725,0,-1,4,4,4,8,659,177,732
396,130,232,894,959,65,192,192,888,888,0,0.0021784267674189047,0.0022465026039007454,897,900,3,4,3,3,17,19,23,144,311
397,2,104,350,888,538,11,15,361,389,28,0.0,0.0,1,1,0,4,5,5,9,2,414,292,654
398,38,139,740,920,180,66,66,678,678,0,0.000442492937131965,0.000442492937131965,683,683,0,6,3,3,10,8,99,90,344
399,78,180,835,941,106,104,104,810,810,0,0.0020082371762143027,0.002144388849177984,878,885,7,4,2,2,12,10,96,272,231
400,0,0,1,1,0,0,0,1,1,0,0.0,0.0,1,1,0,-1,-1,-1,3,1,756,920,961
401,0,0,1,1,0,0,0,1,1,0,0.0,0.0,1,1,0,-1,-1,-1,4,0,753,996,358
402,1,1,331,331,0,3,3,331,331,0,0.0,0.0,1,1,0,-1,6,6,3,1,856,763,757
403,6,6,384,384,0,40,40,418,418,0,3.4037918240920386e-05,3.4037918240920386e-05,401,401,0,-1,4,4,17,1,56,552,548
404,0,0,1,1,0,0,0,1,1,0,0.0,0.0,1,1,0,-1,-1,-1,5,0,727,927,997
405,0,0,1,1,0,0,0,1,1,0,0.0,0.0,1,1,0,-1,-1,-1,3,0,869,766,431
406,360,360,973,973,0,410,410,980,980,0,0.004765308553728854,0.004765308553728854,950,950,0,-1,2,2,23,25,15,105,715
407,2,104,383,945,562,4,5,387,422,35,0.0,0.00013615167296368154,1,535,534,4,5,5,3,1,790,530,420
408,51,152,859,966,107,34,34,837,837,0,0.0009190237925048504,0.0009190237925048504,798,798,0,6,3,3,4,12,603,99,344
409,50,152,854,954,100,18,18,734,734,0,0.0012253650566731338,0.0017018959120460194,848,874,26,4,3,3,2,11,932,97,273
410,12,12,522,522,0,46,46,517,517,0,0.0,0.0,1,1,0,-1,4,4,13,3,242,829,746
411,8,8,584,584,0,8,8,571,571,0,0.0004765308553728854,0.0004765308553728854,724,724,0,-1,4,4,2,4,995,319,855
412,28,129,642,893,251,98,98,649,649,0,0.00010211375472276115,0.00010211375472276115,472,472,0,5,3,3,17,4,80,202,543
413,1,1,332,332,0,3,3,332,332,0,0.0,0.0,1,1,0,-1,6,6,3,3,927,181,941
414,0,0,1,1,0,0,0,1,1,0,0.0,0.0,1,1,0,-1,-1,-1,3,0,819,675,833
415,36,242,785,978,193,26,26,646,646,0,0.000442492937131965,0.0009190237925048504,679,795,116,3,4,4,5,11,765,52,121
416,34,34,790,790,0,28,28,737,737,0,0.0006807583648184077,0.0006807583648184077,759,759,0,-1,3,3,3,8,680,186,951
417,0,102,1,913,912,0,7,1,360,359,0.0,6.807583648184077e-05,1,452,451,4,-1,5,6,0,522,651,710
418,522,624,988,990,2,256,256,987,987,0,0.009530617107457708,0.009530617107457708,974,974,0,4,2,2,13,59,160,5,690
419,8,110,486,893,407,28,28,453,453,0,0.0,3.4037918240920386e-05,1,396,395,4,4,4,10,2,189,298,679
420,0,0,1,1,0,0,0,1,1,0,0.0,0.0,1,1,0,-1,-1,-1,11,1,155,529,824
421,0,102,1,901,900,0,10,1,404,403,0.0,0.00013615167296368154,1,518,517,4,-1,5,5,0,408,201,501
422,27,27,780,780,0,22,22,773,773,0,0.0008169100377820892,0.0008169100377820892,789,789,0,-1,3,3,2,6,598,192,672
423,0,616,1,998,997,0,34,1,779,778,0.0,0.0045270431260424114,1,958,957,2,-1,3,4,0,735,702,33
424,14,14,667,667,0,10,10,528,528,0,0.0004765308553728854,0.0004765308553728854,704,704,0,-1,4,4,3,3,693,616,624
425,13,13,623,623,0,18,18,545,545,0,6.807583648184077e-05,6.807583648184077e-05,447,447,0,-1,4,4,5,4,580,332,733
426,34,240,680,955,275,86,86,644,644,0,0.0005446066918547262,0.0005446066918547262,709,709,0,3,3,3,14,6,122,275,342
427,1,103,333,937,604,2,4,333,403,70,3.4037918240920386e-05,0.0002042275094455223,399,584,185,4,7,5,2,1,904,437,891
428,39,245,795,975,180,36,36,722,722,0,0.0010892133837094523,0.0017018959120460194,821,868,47,3,3,3,5,8,294,161,125
429,26,232,759,981,222,14,14,607,607,0,0.0005786446100956465,0.0009870996289866913,732,811,79,3,4,4,3,10,676,272,310
430,63,63,865,865,0,46,46,848,848,0,0.0009870996289866913,0.0009870996289866913,805,805,0,-1,3,3,5,9,456,294,992
431,98,200,835,932,97,228,228,828,828,0,0.0012253650566731338,0.0012253650566731338,825,825,0,4,3,3,23,13,15,335,481
432,13,114,661,952,291,8,8,519,519,0,0.0002042275094455223,0.00030634126416828345,584,642,58,5,4,4,2,5,919,310,435
433,6,6,396,396,0,46,46,524,524,0,0.00017018959120460194,0.00017018959120460194,548,548,0,-1,4,4,11,1,162,809,372
434,18,119,613,905,292,44,44,631,631,0,0.0004084550188910446,0.000442492937131965,670,679,9,5,4,4,8,3,236,653,694
435,32,32,729,729,0,44,44,635,635,0,0.0004765308553728854,0.0004765308553728854,693,693,0,-1,4,4,8,11,260,52,941
436,369,575,995,999,4,56,56,991,991,0,0.014704380680077607,0.015453214881377854,993,994,1,3,2,2,2,83,702,10,482
437,18,120,544,880,336,80,80,503,503,0,0.00010211375472276115,0.00030634126416828345,480,609,129,4,3,3,23,2,43,244,121
438,4,106,444,933,489,8,8,427,427,0,3.4037918240920386e-05,0.00017018959120460194,394,541,147,4,5,5,4,2,633,383,688
439,0,206,1,975,974,0,10,1,503,502,0.0,0.0007828721195411688,1,775,774,3,-1,4,3,0,745,783,224
440,2,104,380,964,584,6,6,459,459,0,0.00030634126416828345,0.0005446066918547262,636,715,79,4,5,5,3,1,786,500,589
441,0,0,1,1,0,0,0,1,1,0,0.0,0.0,1,1,0,-1,-1,-1,2,1,889,920,502
442,0,0,1,1,0,0,0,1,1,0,0.0,0.0,1,1,0,-1,-1,-1,25,3,17,746,994
443,16,16,671,671,0,19,19,771,771,0,0.0005446066918547262,0.0005446066918547262,715,715,0,-1,3,3,3,1,823,394,624
444,28,130,752,939,187,28,28,737,737,0,0.0005786446100956465,0.0007488342013002485,734,778,44,4,3,3,3,5,737,221,688
445,28,234,756,978,222,46,46,831,831,0,0.0004765308553728854,0.001055175465468532,709,813,104,3,3,3,6,5,486,221,224
446,40,142,768,933,165,52,52,758,758,0,0.0005105687736138058,0.0005105687736138058,708,708,0,4,3,3,6,9,432,211,416
447,289,391,980,988,8,94,94,971,971,0,0.008135062459579971,0.008305252050784574,976,976,0,4,2,2,5,49,502,31,110
448,135,135,927,927,0,92,92,894,894,0,0.0030974505599237552,0.0030974505599237552,927,927,0,-1,3,3,7,24,678,119,818
449,8,8,460,460,0,37,37,425,425,0,3.4037918240920386e-05,3.4037918240920386e-05,393,393,0,-1,4,4,16,3,145,585,725
450,0,206,1,958,957,0,24,1,471,470,0.0,0.0002042275094455223,1,560,559,3,-1,4,8,0,350,886,371
451,10,112,578,927,349,14,14,489,489,0,0.00013615167296368154,0.0012934408931549745,519,847,328,4,4,4,5,6,720,392,68
452,0,102,1,926,925,0,10,1,454,453,0.0,0.0004084550188910446,1,674,673,4,-1,5,5,0,376,635,272
453,2,2,363,363,0,8,8,333,333,0,0.0,0.0,1,1,0,-1,6,6,8,5,318,605,892
454,6,108,447,928,481,12,12,485,485,0,0.00010211375472276115,0.00017018959120460194,493,558,65,4,4,4,4,1,885,810,528
455,6,108,402,894,492,44,44,527,527,0,6.807583648184077e-05,6.807583648184077e-05,442,442,0,4,4,4,12,2,222,384,421
456,1,103,333,928,595,4,8,333,439,106,0.0,0.0007147962830593281,1,763,762,4,6,5,4,1,461,736,120
457,75,177,887,962,75,40,40,857,857,0,0.0013274788113958951,0.002280540522141666,848,900,52,4,3,3,4,10,969,366,91
458,16,222,595,968,373,32,38,573,616,43,3.4037918240920386e-05,0.0005786446100956465,395,719,324,3,3,3,8,1,371,577,327
459,0,102,1,924,923,0,7,1,396,395,0.0,0.00010211375472276115,1,488,487,4,-1,5,4,0,475,996,625
460,0,206,1,959,958,0,26,1,502,501,0.0,0.0005105687736138058,1,697,696,3,-1,4,7,0,346,881,120
461,44,250,842,978,136,22,22,767,767,0,0.0006807583648184077,0.001940161339732462,762,891,129,3,3,3,2,10,828,262,109
462,26,232,697,967,270,36,40,594,625,31,0.0006126825283365669,0.0017359338302869397,722,865,143,3,4,4,8,10,521,272,117
463,0,101,1,932,931,0,3,1,330,329,0.0,0.00013615167296368154,1,519,518,5,-1,6,3,3,856,348,659
464,0,206,1,956,955,0,14,1,402,401,0.0,3.4037918240920386e-05,1,402,401,3,-1,4,8,0,418,802,576
465,6,6,513,513,0,14,14,615,615,0,6.807583648184077e-05,6.807583648184077e-05,453,453,0,-1,4,4,3,1,798,609,816
466,2,2,386,386,0,4,4,447,447,0,0.00017018959120460194,0.00017018959120460194,560,560,0,-1,5,5,2,3,914,309,723
467,2,208,366,976,610,6,10,421,491,70,3.4037918240920386e-05,0.0007488342013002485,405,765,360,3,5,4,3,2,712,719,218
468,0,101,1,893,892,0,9,1,332,331,0.0,3.4037918240920386e-05,1,389,388,5,-1,6,9,0,316,851,748
469,153,359,964,989,25,22,22,790,790,0,0.003914360597705844,0.004833384390210695,946,959,13,3,3,3,2,31,880,76,377
470,0,102,1,934,933,0,7,1,411,410,0.0,0.000442492937131965,1,711,710,4,-1,5,4,1,728,472,267
471,8,214,629,990,361,8,12,615,765,150,0.00037441710065012424,0.003948398515946765,689,954,265,3,4,4,2,3,866,121,25
472,0,206,1,969,968,0,9,1,436,435,0.0,6.807583648184077e-05,1,443,442,3,-1,4,3,0,892,950,891
473,2,2,352,352,0,8,8,387,387,0,0.0,0.0,1,1,0,-1,5,5,4,1,503,421,735
474,6,622,413,995,582,18,50,433,685,252,0.0,0.003914360597705844,1,943,942,2,4,3,8,3,282,578,20
475,0,0,1,1,0,0,0,1,1,0,0.0,0.0,1,1,0,-1,-1,-1,2,0,960,254,766
476,4,210,447,978,531,4,8,427,501,74,3.4037918240920386e-05,0.0009870996289866913,398,810,412,3,5,4,2,2,739,602,390
477,9,111,560,935,375,10,10,470,470,0,0.00010211375472276115,0.0002042275094455223,487,564,77,4,4,4,3,4,484,398,711
478,156,258,963,978,15,38,38,909,909,0,0.004935498144933456,0.005105687736138058,961,961,0,4,3,3,3,29,882,142,507
479,6,6,415,415,0,14,14,441,441,0,6.807583648184077e-05,6.807583648184077e-05,445,445,0,-1,4,4,5,2,546,325,993
480,280,486,973,988,15,186,186,957,957,0,0.004220701861874128,0.0045270431260424114,948,952,4,3,2,2,12,38,187,111,159
481,0,101,1,893,892,0,9,1,331,330,0.0,0.0,1,1,0,5,-1,6,9,0,245,200,896
482,19,121,652,923,271,20,20,565,565,0,0.0002382654276864427,0.0005105687736138058,590,704,114,4,4,4,4,7,391,371,90
483,0,616,1,999,998,0,18,1,796,795,0.0,0.0034718676605738795,1,936,935,2,-1,3,2,0,232,994,183
484,8,110,573,945,372,7,8,513,518,5,0.0002382654276864427,0.00037441710065012424,602,680,78,4,4,4,2,3,977,646,291
485,0,206,1,975,974,0,10,1,523,522,0.0,0.00037441710065012424,1,672,671,3,-1,4,3,0,523,834,480
486,8,8,556,556,0,9,9,492,492,0,0.0,0.0,1,1,0,-1,4,4,3,2,823,602,923
487,12,12,490,490,0,72,72,604,604,0,0.0002723033459273631,0.0002723033459273631,589,589,0,-1,4,4,14,4,268,346,358
488,0,0,1,1,0,0,0,1,1,0,0.0,0.0,1,1,0,-1,-1,-1,2,1,993,814,608
489,34,34,710,710,0,106,106,745,745,0,0.0006467204465774873,0.0006467204465774873,732,732,0,-1,3,3,14,4,332,479,946
490,2,208,352,948,596,20,29,352,376,24,0.0,0.00013615167296368154,1,511,510,3,5,4,19,1,38,621,527
491,0,102,1,922,921,0,6,1,406,405,0.0,0.0007828721195411688,1,775,774,4,-1,5,3,0,585,914,67
492,55,55,841,841,0,44,44,807,807,0,0.0015317063208414173,0.0015317063208414173,856,856,0,-1,3,3,4,9,572,277,881
493,18,18,544,544,0,71,71,486,486,0,6.807583648184077e-05,6.807583648184077e-05,446,446,0,-1,3,3,23,3,43,441,949
494,49,665,753,990,237,114,154,669,769,100,0.001055175465468532,0.0034718676605738795,798,929,131,2,2,2,20,4,70,645,133
495,43,144,833,960,127,18,18,679,679,0,0.0012934408931549745,0.0013615167296368155,842,846,4,5,4,4,3,14,716,84,829
496,8,110,569,947,378,8,8,506,506,0,3.4037918240920386e-05,0.0007828721195411688,402,776,374,4,4,4,2,3,937,300,113
497,17,223,662,975,313,12,20,485,594,109,0.0002723033459273631,0.0018380475850097008,613,878,265,3,4,4,4,6,559,279,128
498,6,108,427,913,486,10,11,428,431,3,3.4037918240920386e-05,0.0004765308553728854,402,707,305,4,4,4,4,2,516,575,467
499,1,1,333,333,0,3,3,333,333,0,0.0,0.0,1,1,0,-1,8,8,3,1,535,765,830
500,0,0,1,1,0,0,0,1,1,0,0.0,0.0,1,1,0,-1,-1,-1,2,2,944,633,784
501,6,6,485,485,0,14,14,588,588,0,0.00013615167296368154,0.00013615167296368154,527,527,0,-1,4,4,3,1,770,711,271
502,16,16,636,636,0,20,20,597,597,0,0.00034037918240920387,0.00034037918240920387,642,642,0,-1,4,4,4,9,735,29,941
503,7,213,514,966,452,13,30,415,590,175,0.00010211375472276115,0.001497668402600497,476,848,372,3,4,4,7,2,482,694,42
504,13,114,609,933,324,16,16,477,477,0,0.00034037918240920387,0.00034037918240920387,662,662,0,5,4,4,6,7,657,170,748
505,8,8,513,513,0,13,13,430,430,0,6.807583648184077e-05,6.807583648184077e-05,442,442,0,-1,4,4,6,5,369,401,963
506,0,0,1,1,0,0,0,1,1,0,0.0,0.0,1,1,0,-1,-1,-1,12,0,194,502,632
507,167,269,950,974,24,86,86,925,925,0,0.003199564314646516,0.0032336022328874367,932,933,1,4,3,3,6,30,498,65,526
508,140,346,931,980,49,54,54,853,853,0,0.002586881786309949,0.003199564314646516,915,928,13,3,3,3,4,17,493,79,190
509,61,162,834,943,109,46,46,732,732,0,0.001599782157323258,0.0017359338302869397,858,866,8,5,3,3,6,15,328,62,314
510,36,242,734,963,229,110,110,869,869,0,0.0010211375472276116,0.0017018959120460194,805,861,56,3,3,3,10,6,82,471,192
511,8,214,585,980,395,9,18,542,755,213,0.00010211375472276115,0.005514142755029102,500,963,463,3,4,4,3,2,911,599,5
512,0,102,1,918,917,0,7,1,400,399,0.0,0.00034037918240920387,1,662,661,4,-1,5,4,0,969,502,551
513,23,124,673,918,245,78,78,789,789,0,0.0010211375472276116,0.001157289220191293,804,815,11,5,3,3,8,3,225,438,552
514,0,0,1,1,0,0,0,1,1,0,0.0,0.0,1,1,0,-1,-1,-1,2,0,865,201,910
515,16,16,591,591,0,74,74,783,783,0,0.0002042275094455223,0.0002042275094455223,570,570,0,-1,3,3,9,1,289,655,992
516,12,12,552,552,0,22,22,481,481,0,0.00010211375472276115,0.00010211375472276115,484,484,0,-1,4,4,7,2,400,425,894
517,2,2,344,344,0,34,34,366,366,0,0.0,0.0,1,1,0,-1,5,5,25,1,17,593,804
518,0,101,1,896,895,0,9,1,332,331,0.0,0.0,1,1,0,5,-1,6,9,1,177,641,449
519,0,0,1,1,0,0,0,1,1,0,0.0,0.0,1,1,0,-1,-1,-1,3,0,726,900,950
520,0,102,1,936,935,0,5,1,391,390,0.0,0.0006126825283365669,1,745,744,4,-1,5,3,0,676,880,343
521,16,117,641,935,294,28,28,731,731,0,0.0002723033459273631,0.00030634126416828345,628,643,15,5,3,3,3,1,819,168,360
522,15,15,634,634,0,18,18,624,624,0,0.0002723033459273631,0.0002723033459273631,612,612,0,-1,4,4,3,5,554,454,573
523,4,106,479,954,475,4,4,455,455,0,6.807583648184077e-05,0.000442492937131965,463,708,245,4,5,5,2,3,868,496,178
524,0,206,1,959,958,0,23,1,481,480,0.0,0.0005446066918547262,1,709,708,3,-1,4,8,0,595,884,49
525,0,206,1,937,936,0,64,1,456,455,0.0,0.0004765308553728854,1,679,678,3,-1,4,21,0,54,986,134
526,0,102,1,883,882,0,16,1,352,351,0.0,6.807583648184077e-05,1,452,451,4,-1,5,15,0,95,864,829
527,150,356,932,981,49,114,114,913,913,0,0.00176997174852786,0.002280540522141666,873,903,30,3,3,3,9,23,136,117,461
528,28,28,709,709,0,56,56,763,763,0,0.0008169100377820892,0.0008169100377820892,786,786,0,-1,3,3,6,4,368,336,920
529,12,114,557,918,361,19,19,488,488,0,0.00010211375472276115,0.0002382654276864427,485,598,113,4,4,4,6,3,98,829,556
530,122,738,940,999,59,44,54,872,913,41,0.003165526396405596,0.005786446100956465,917,965,48,2,3,3,4,20,787,38,451
531,4,210,415,967,552,10,32,396,629,233,0.00010211375472276115,0.0026549576227917903,485,913,428,3,5,4,6,5,526,464,41
532,0,102,1,956,955,0,5,1,444,443,0.0,0.00013615167296368154,1,512,511,4,-1,5,3,0,877,729,689
533,0,206,1,963,962,0,19,1,450,449,0.0,0.0002382654276864427,1,579,578,3,-1,4,8,0,454,918,316
534,0,206,1,960,959,0,42,1,628,627,0.0,0.0048674223084516155,1,953,952,3,-1,4,7,0,678,488,70
535,24,24,817,817,0,22,22,892,892,0,0.0010211375472276116,0.0010211375472276116,824,824,0,-1,3,3,2,4,997,336,919
536,0,616,1,990,989,0,98,1,601,600,0.0,0.0013274788113958951,1,836,835,2,-1,3,19,0,48,973,68
537,0,0,1,1,0,0,0,1,1,0,0.0,0.0,1,1,0,-1,-1,-1,9,0,101,698,824
538,46,46,819,819,0,64,64,938,938,0,0.0026549576227917903,0.0026549576227917903,919,919,0,-1,2,2,5,4,421,143,850
539,28,129,617,890,273,118,118,618,618,0,0.00037441710065012424,0.00037441710065012424,650,650,0,5,3,3,24,3,28,301,265
540,0,0,1,1,0,0,0,1,1,0,0.0,0.0,1,1,0,-1,-1,-1,4,0,513,847,925
541,7,7,561,561,0,10,10,538,538,0,0.00010211375472276115,0.00010211375472276115,480,480,0,-1,4,4,3,2,576,408,254
542,37,37,813,813,0,48,48,920,920,0,0.002212464685659825,0.002212464685659825,893,893,0,-1,3,3,3,5,855,393,979
543,53,53,875,875,0,18,18,665,665,0,0.0017018959120460194,0.0017018959120460194,885,885,0,-1,4,4,3,15,732,53,934
544,0,0,1,1,0,0,0,1,1,0,0.0,0.0,1,1,0,-1,-1,-1,2,1,596,513,963
545,14,14,573,573,0,42,42,634,634,0,0.00017018959120460194,0.00017018959120460194,542,542,0,-1,4,4,7,3,321,222,994
546,16,16,622,622,0,24,24,708,708,0,0.0005105687736138058,0.0005105687736138058,727,727,0,-1,3,3,3,2,471,160,822
547,119,119,949,949,0,46,46,972,972,0,0.005241839409101739,0.005241839409101739,956,956,0,-1,2,2,2,26,970,112,583
548,6,6,438,438,0,10,10,448,448,0,6.807583648184077e-05,6.807583648184077e-05,453,453,0,-1,4,4,4,1,783,577,894
549,12,628,552,996,444,30,48,547,713,166,0.0,0.0020763130126961434,1,885,884,2,4,3,7,2,398,298,38
550,6,6,491,491,0,4,4,401,401,0,0.0002723033459273631,0.0002723033459273631,619,619,0,-1,5,5,2,5,992,487,725
551,30,132,666,901,235,92,92,619,619,0,0.00037441710065012424,0.00037441710065012424,654,655,1,4,3,3,17,6,10,435,532
552,0,206,1,979,978,0,10,1,548,547,0.0,0.0011232513019503727,1,833,832,3,-1,4,3,0,840,959,66
553,7,7,522,522,0,14,14,492,492,0,0.00010211375472276115,0.00010211375472276115,479,479,0,-1,4,4,5,2,765,408,801
554,13,115,700,964,264,12,12,746,746,0,0.00030634126416828345,0.00037441710065012424,652,674,22,4,4,4,2,4,799,407,107
555,0,206,1,950,949,0,35,1,460,459,0.0,0.0006126825283365669,1,719,718,3,-1,4,12,0,87,517,264
556,8,8,491,491,0,23,23,482,482,0,0.0002723033459273631,0.0002723033459273631,595,595,0,-1,4,4,8,2,415,22,356
557,0,102,1,944,943,0,4,1,400,399,0.0,0.00037441710065012424,1,672,671,4,-1,5,2,0,992,695,396
558,2,103,364,921,557,9,9,397,397,0,3.4037918240920386e-05,3.4037918240920386e-05,399,399,0,6,5,5,5,1,691,416,437
559,14,220,570,968,398,36,36,622,622,0,0.0002723033459273631,0.0009190237925048504,612,798,186,3,4,4,8,6,309,247,143
560,0,206,1,945,944,0,42,1,432,431,0.0,0.0002382654276864427,1,581,580,3,-1,4,18,1,34,806,381
561,0,102,1,944,943,0,4,1,435,434,0.0,0.0005446066918547262,1,728,727,4,-1,5,2,0,929,884,186
562,0,616,1,996,995,0,26,1,686,685,0.0,0.0019741992579733825,1,887,886,2,-1,3,4,0,759,914,82
563,5,106,552,971,419,3,3,421,421,0,0.0002042275094455223,0.0002382654276864427,583,602,19,5,5,5,2,4,813,315,353
564,0,101,1,943,942,0,3,1,329,328,0.0,3.4037918240920386e-05,1,404,403,5,-1,6,3,2,902,271,878
565,7,7,507,507,0,5,5,370,370,0,0.00010211375472276115,0.00010211375472276115,477,477,0,-1,5,5,3,4,725,208,729
566,100,100,922,922,0,100,100,991,991,0,0.0392457197317812,0.0392457197317812,999,999,0,4,1,1,4,24,635,129,425
567,0,102,1,876,875,0,15,1,346,345,0.0,0.0,1,1,0,4,-1,5,14,0,121,686,476
568,0,102,1,907,906,0,5,1,357,356,0.0,3.4037918240920386e-05,1,400,399,4,-1,5,4,0,516,872,419
569,0,0,1,1,0,0,0,1,1,0,0.0,0.0,1,1,0,-1,-1,-1,5,0,691,910,849
570,89,705,876,997,121,72,72,836,836,0,0.001157289220191293,0.00439089145307873,825,948,123,2,3,3,7,15,209,219,27
571,28,130,667,907,240,112,112,827,827,0,0.0007488342013002485,0.0008169100377820892,752,769,17,4,3,3,12,3,44,642,279
572,106,207,945,978,33,32,32,919,919,0,0.0030974505599237552,0.0030974505599237552,925,925,0,5,3,3,2,17,937,81,555
573,0,0,1,1,0,0,0,1,1,0,0.0,0.0,1,1,0,-1,-1,-1,11,0,234,798,823
574,0,206,1,958,957,0,28,1,552,551,0.0,0.0018720855032506212,1,869,868,3,-1,4,6,0,425,954,108
575,0,0,1,1,0,0,0,1,1,0,0.0,0.0,1,1,0,-1,-1,-1,4,1,384,742,933
576,21,21,668,668,0,23,23,526,526,0,0.0002723033459273631,0.0002723033459273631,613,613,0,-1,4,4,6,6,518,279,782
577,30,30,726,726,0,38,38,630,630,0,0.0006807583648184077,0.0006807583648184077,745,745,0,-1,4,4,7,7,364,134,849
578,0,0,1,1,0,0,0,1,1,0,0.0,0.0,1,1,0,-1,-1,-1,4,0,572,984,917
579,22,22,788,788,0,12,12,707,707,0,0.0005786446100956465,0.0005786446100956465,747,747,0,-1,4,4,2,7,994,396,457
580,12,218,618,977,359,14,14,558,558,0,0.0002042275094455223,0.0013615167296368155,577,857,280,3,4,4,3,4,825,149,147
581,0,0,1,1,0,0,0,1,1,0,0.0,0.0,1,1,0,-1,-1,-1,5,0,546,569,804
582,12,218,638,979,341,10,10,530,530,0,6.807583648184077e-05,0.0013274788113958951,451,850,399,3,4,4,3,2,797,634,153
583,1,103,331,975,644,2,4,331,514,183,0.0,0.001599782157323258,1,876,875,4,6,5,2,1,956,558,15
584,0,102,1,908,907,0,6,1,356,355,0.0,6.807583648184077e-05,1,464,463,4,-1,5,5,1,479,660,627
585,0,101,1,943,942,0,3,1,329,328,0.0,0.0,1,1,0,6,-1,7,3,0,674,436,931
586,0,101,1,915,914,0,4,1,332,331,0.0,0.0,1,1,0,6,-1,7,4,0,304,773,924
587,100,201,871,949,78,114,114,877,877,0,0.002552843868069029,0.002552843868069029,907,907,0,5,2,2,10,13,189,183,662
588,2,208,369,973,604,6,10,407,472,65,6.807583648184077e-05,0.0002382654276864427,455,603,148,3,5,4,3,2,585,532,341
589,135,237,937,973,36,86,86,930,930,0,0.003608019333537561,0.003812246842983083,934,937,3,4,2,2,7,20,305,95,182
590,97,713,854,994,140,200,214,920,938,18,0.002484768031587188,0.006875659484665918,903,964,61,2,2,2,16,4,145,125,16
591,4,4,471,471,0,3,3,376,376,0,0.0,0.0,1,1,0,-1,5,5,2,2,977,298,889
592,12,1652,579,1000,421,32,70,649,913,264,0.00030634126416828345,0.018040096667687803,635,993,358,1,4,2,6,3,664,610,50
593,232,334,957,975,18,218,218,954,954,0,0.00445896728956057,0.0045270431260424114,948,949,1,4,2,2,14,31,198,102,576
594,0,616,1,988,987,0,74,1,544,543,0.0,0.0017359338302869397,1,870,869,2,-1,3,15,0,77,757,83
595,287,493,976,986,10,124,124,926,926,0,0.003642057251778481,0.004935498144933456,937,960,23,3,3,3,9,35,277,57,84
596,16,118,607,920,313,36,36,700,700,0,0.0002042275094455223,0.0004084550188910446,578,683,105,4,3,3,5,1,479,720,107
597,74,175,857,950,93,88,88,881,881,0,0.0019741992579733825,0.0019741992579733825,874,874,0,5,2,2,8,7,488,389,764
598,0,102,1,936,935,0,4,1,371,370,0.0,0.00010211375472276115,1,490,489,4,-1,5,3,2,683,752,785
599,44,250,833,978,145,32,32,894,894,0,0.0006126825283365669,0.0010211375472276116,746,822,76,3,3,3,2,6,763,377,336
600,42,42,849,849,0,12,12,631,631,0,0.0009870996289866913,0.0009870996289866913,815,815,0,-1,4,4,2,19,625,59,804
601,6,107,482,942,460,14,14,594,594,0,6.807583648184077e-05,0.00017018959120460194,444,557,113,5,4,4,3,1,590,609,384
602,6,6,456,456,0,16,16,537,537,0,0.00017018959120460194,0.00017018959120460194,543,543,0,-1,4,4,4,1,403,840,811
603,100,100,926,926,0,100,100,997,997,0,0.05146533238027162,0.05146533238027162,998,998,0,-1,1,1,3,22,670,116,629
604,0,0,1,1,0,0,0,1,1,0,0.0,0.0,1,1,0,-1,-1,-1,7,0,196,903,923
605,6,6,442,442,0,18,18,502,502,0,0.0,0.0,1,1,0,-1,4,4,5,1,382,964,784
606,0,0,1,1,0,0,0,1,1,0,0.0,0.0,1,1,0,-1,-1,-1,4,0,504,981,920
607,123,123,917,917,0,84,84,866,866,0,0.002280540522141666,0.002280540522141666,901,901,0,-1,3,3,8,19,443,72,792
608,6,108,386,886,500,33,33,463,463,0,6.807583648184077e-05,0.00013615167296368154,448,517,69,4,4,4,11,2,66,648,485
609,16,16,566,566,0,36,36,528,528,0,0.00037441710065012424,0.00037441710065012424,668,668,0,-1,3,3,9,2,213,550,930
610,5,621,422,995,573,7,30,380,679,299,0.00010211375472276115,0.0020082371762143027,481,888,407,2,5,3,4,3,540,534,84
611,235,851,966,998,32,142,142,973,973,0,0.006092787365124749,0.011164437183021887,965,978,13,2,2,2,8,29,301,17,75
612,6,6,444,444,0,14,14,465,465,0,0.00010211375472276115,0.00010211375472276115,489,489,0,-1,4,4,5,1,464,527,979
613,0,0,1,1,0,0,0,1,1,0,0.0,0.0,1,1,0,-1,-1,-1,4,0,721,715,892
614,0,206,1,956,955,0,38,1,551,550,0.0,0.0007828721195411688,1,776,775,3,-1,4,9,0,803,819,179
615,16,118,552,889,337,116,116,772,772,0,0.0002042275094455223,0.0002382654276864427,581,597,16,4,3,3,14,1,198,667,350
616,8,624,488,994,506,37,47,480,563,83,0.00010211375472276115,0.000442492937131965,474,680,206,2,4,3,11,2,139,791,558
617,24,230,690,970,280,36,36,633,633,0,0.0004765308553728854,0.0006467204465774873,701,741,40,3,3,3,7,3,413,93,577
618,11,11,596,596,0,16,16,539,539,0,0.00013615167296368154,0.00013615167296368154,519,519,0,-1,4,4,4,5,475,350,565
619,28,644,705,995,290,64,74,750,803,53,0.000442492937131965,0.0009530617107457708,682,801,119,2,3,3,9,4,278,545,617
620,54,156,851,951,100,44,44,852,852,0,0.001157289220191293,0.0014295925661186562,837,862,25,4,3,3,4,15,709,62,317
621,22,22,670,670,0,40,40,651,651,0,0.0005105687736138058,0.0005105687736138058,709,709,0,-1,3,3,7,3,637,121,356
622,0,101,1,946,945,0,2,1,331,330,0.0,0.0,1,1,0,8,-1,9,2,0,684,926,448
623,6,108,432,924,492,28,28,609,609,0,0.00013615167296368154,0.0002042275094455223,519,570,51,4,4,4,6,1,373,666,682
624,0,102,1,925,924,0,6,1,361,360,0.0,3.4037918240920386e-05,1,406,405,4,-1,5,5,0,908,836,93
625,0,0,1,1,0,0,0,1,1,0,0.0,0.0,1,1,0,-1,-1,-1,14,0,203,864,971
626,0,0,1,1,0,0,0,1,1,0,0.0,0.0,1,1,0,-1,-1,-1,23,0,15,798,568
627,0,0,1,1,0,0,0,1,1,0,0.0,0.0,1,1,0,-1,-1,-1,2,0,757,877,961
628,6,108,379,878,499,82,82,584,584,0,3.4037918240920386e-05,0.00010211375472276115,393,491,98,4,4,4,17,1,23,110,447
629,88,294,855,972,117,100,100,832,832,0,0.0015657442390823377,0.002144388849177984,864,894,30,3,3,3,10,17,205,269,299
630,0,0,1,1,0,0,0,1,1,0,0.0,0.0,1,1,0,-1,-1,-1,10,0,256,978,803
631,238,444,972,988,16,54,54,890,890,0,0.004186663943633207,0.005173763572619898,946,961,15,3,3,3,4,31,391,76,185
632,403,505,991,997,6,88,88,988,988,0,0.0160318594914735,0.016372238673882704,990,990,0,4,2,2,4,85,607,0,591
633,13,219,547,959,412,28,38,446,511,65,0.00017018959120460194,0.0005105687736138058,537,702,165,3,4,4,11,3,224,580,40
634,0,102,1,893,892,0,17,1,414,413,0.0,0.0007488342013002485,1,765,764,4,-1,5,9,0,289,901,67
635,0,102,1,916,915,0,5,1,358,357,0.0,0.00030634126416828345,1,633,632,4,-1,5,4,0,513,358,500
636,0,102,1,921,920,0,8,1,425,424,0.0,0.00037441710065012424,1,665,664,4,-1,5,4,0,787,819,120
637,0,102,1,898,897,0,8,1,351,350,0.0,0.00013615167296368154,1,506,505,4,-1,5,7,0,472,988,416
638,0,616,1,992,991,0,77,1,499,498,0.0,0.0009190237925048504,1,779,778,2,-1,3,22,0,33,668,273
639,1,103,333,935,602,3,5,333,399,66,0.0,0.0002042275094455223,1,584,583,4,7,5,3,1,770,469,237
640,1,207,333,953,620,7,30,333,522,189,0.0,0.0016338200755641784,1,860,859,3,6,4,7,3,296,708,112
641,0,0,1,1,0,0,0,1,1,0,0.0,0.0,1,1,0,-1,-1,-1,15,0,51,833,502
642,0,206,1,966,965,0,16,1,439,438,0.0,0.0002042275094455223,1,554,553,3,-1,4,6,0,514,925,300
643,9,111,590,941,351,14,14,601,601,0,0.0002723033459273631,0.0008169100377820892,612,790,178,4,4,4,3,6,640,406,185
644,241,241,978,978,0,54,54,936,936,0,0.005514142755029102,0.005514142755029102,965,965,0,-1,3,3,4,49,573,51,554
645,0,102,1,874,873,0,28,1,375,374,0.0,3.4037918240920386e-05,1,382,381,4,-1,5,20,1,70,705,607
646,64,64,793,793,0,194,194,825,825,0,0.0004765308553728854,0.0004765308553728854,680,680,0,-1,2,2,19,6,14,379,942
647,2,104,344,888,544,21,21,397,397,0,3.4037918240920386e-05,0.0002382654276864427,396,585,189,4,5,5,12,1,187,807,322
648,0,102,1,936,935,0,6,1,424,423,0.0,0.0010892133837094523,1,816,815,4,-1,5,3,0,863,790,146
649,2,2,352,352,0,9,9,352,352,0,3.4037918240920386e-05,3.4037918240920386e-05,402,402,0,-1,5,5,8,1,411,893,564
650,69,69,908,908,0,22,22,832,832,0,0.0025188059498281084,0.0025188059498281084,918,918,0,-1,3,3,2,18,681,55,892
651,264,880,958,996,38,316,316,973,973,0,0.0038462847612240037,0.005207801490860819,938,951,13,2,2,2,19,19,36,133,106
652,0,206,1,961,960,0,26,1,487,486,0.0,0.0016338200755641784,1,859,858,3,-1,4,9,0,177,856,98
653,6,212,425,965,540,44,44,645,645,0,0.0005446066918547262,0.0020422750944552232,717,879,162,3,4,4,8,2,454,160,157
654,0,102,1,943,942,0,5,1,400,399,0.0,0.00017018959120460194,1,556,555,4,-1,5,3,0,862,926,459
655,9,215,533,966,433,16,21,431,473,42,6.807583648184077e-05,0.0005786446100956465,439,721,282,3,4,4,7,4,359,567,353
656,0,102,1,922,921,0,4,1,365,364,0.0,0.00017018959120460194,1,536,535,4,-1,5,3,0,855,698,451
657,12,218,592,973,381,36,36,722,722,0,0.0007147962830593281,0.0012253650566731338,766,838,72,3,4,4,6,3,657,209,113
658,0,0,1,1,0,0,0,1,1,0,0.0,0.0,1,1,0,-1,-1,-1,10,0,105,726,997
659,2,208,362,966,604,6,11,362,442,80,0.0,0.0002042275094455223,1,562,561,3,5,4,5,1,667,540,384
660,0,206,1,958,957,0,23,1,503,502,0.0,0.00034037918240920387,1,644,643,3,-1,4,6,0,425,533,194
661,43,43,838,838,0,42,42,967,967,0,0.004561081044283332,0.004561081044283332,949,949,0,-1,2,2,2,5,689,722,205
662,2,208,345,939,594,29,47,371,419,48,0.0,0.0002723033459273631,1,592,591,3,5,4,19,3,19,578,275
663,0,206,1,937,936,0,48,1,419,418,0.0,0.0002723033459273631,1,609,608,3,-1,4,21,0,54,758,637
664,0,206,1,969,968,0,22,1,573,572,0.0,0.0009190237925048504,1,798,797,3,-1,4,5,0,662,489,99
665,118,220,933,971,38,40,40,778,778,0,0.0026209197045508697,0.0026889955410327104,913,916,3,4,3,3,5,27,644,61,562
666,0,101,1,956,955,0,2,1,331,330,0.0,0.00010211375472276115,1,484,483,5,-1,6,2,0,751,228,401
667,163,163,960,960,0,68,68,956,956,0,0.005241839409101739,0.005241839409101739,968,968,0,-1,2,2,4,30,784,39,911
668,0,0,1,1,0,0,0,1,1,0,0.0,0.0,1,1,0,-1,-1,-1,19,0,38,737,367
669,22,22,623,623,0,49,49,556,556,0,0.0002382654276864427,0.0002382654276864427,583,583,0,-1,3,3,12,5,184,231,847
670,0,616,1,994,993,0,54,1,676,675,0.0,0.0045270431260424114,1,951,950,2,-1,3,8,0,186,745,34
671,72,72,872,872,0,18,18,623,623,0,0.0015317063208414173,0.0015317063208414173,857,857,0,-1,4,4,3,16,645,78,976
672,0,616,1,992,991,0,34,1,568,567,0.0,0.0012934408931549745,1,841,840,2,-1,3,8,0,260,445,83
673,10,112,590,941,351,14,14,553,553,0,0.0002042275094455223,0.0002042275094455223,571,571,0,4,4,4,3,5,791,241,416
674,0,206,1,951,950,0,46,1,475,474,0.0,0.00030634126416828345,1,620,619,3,-1,4,15,0,32,943,178
675,16,16,494,494,0,88,88,557,557,0,0.0002382654276864427,0.0002382654276864427,595,595,0,-1,3,3,19,1,31,527,783
676,102,102,908,908,0,40,40,776,776,0,0.0026209197045508697,0.0026209197045508697,909,909,0,-1,3,3,5,26,412,108,705
677,102,718,904,996,92,82,92,877,912,35,0.002484768031587188,0.004663194799006093,916,952,36,2,2,2,7,14,170,146,141
678,22,228,691,972,281,28,32,666,721,55,6.807583648184077e-05,0.0006807583648184077,454,752,298,3,3,3,5,2,326,244,683
679,398,500,996,999,3,32,32,917,917,0,0.014840532353041287,0.01592974573675074,994,995,1,4,3,3,2,98,625,23,174
680,0,101,1,931,930,0,3,1,330,329,0.0,0.0002382654276864427,1,604,603,5,-1,6,3,0,844,388,516
681,12,218,605,975,370,18,18,613,613,0,0.00010211375472276115,0.0006467204465774873,495,747,252,3,4,4,3,2,651,468,550
682,0,102,1,875,874,0,25,1,386,385,0.0,0.00013615167296368154,1,513,512,4,-1,5,14,0,108,702,90
683,4,4,428,428,0,9,9,402,402,0,0.00013615167296368154,0.00013615167296368154,511,511,0,-1,5,5,5,3,656,290,600
684,0,102,1,933,932,0,6,1,437,436,0.0,0.00034037918240920387,1,658,657,4,-1,5,3,0,857,200,169
685,0,206,1,959,958,0,15,1,442,441,0.0,0.0004084550188910446,1,666,665,3,-1,4,6,0,419,990,363
686,16,1656,535,1000,465,82,120,642,791,149,0.00010211375472276115,0.008951972497362062,484,971,487,1,3,2,14,1,108,609,810
687,0,206,1,942,941,0,36,1,414,413,0.0,0.00030634126416828345,1,623,622,3,-1,4,18,0,86,877,252
688,16,16,610,610,0,28,28,549,549,0,0.0002042275094455223,0.0002042275094455223,570,570,0,-1,3,3,7,1,336,666,883
689,0,0,1,1,0,0,0,1,1,0,0.0,0.0,1,1,0,-1,-1,-1,6,0,378,793,908
690,116,116,943,943,0,38,38,897,897,0,0.0026209197045508697,0.0026209197045508697,908,908,0,-1,3,3,3,20,288,38,818
691,0,0,1,1,0,0,0,1,1,0,0.0,0.0,1,1,0,-1,-1,-1,12,0,44,517,587
692,10,10,744,744,0,8,8,753,753,0,0.0007147962830593281,0.0007147962830593281,779,779,0,-1,4,4,2,7,955,170,772
693,19,225,742,980,238,8,8,512,512,0,0.00034037918240920387,0.0008169100377820892,662,789,127,3,4,4,2,8,910,132,589
694,166,166,946,946,0,134,134,940,940,0,0.003778208924742163,0.003778208924742163,942,942,0,-1,2,2,10,20,293,94,753
695,0,206,1,971,970,0,16,1,465,464,0.0,0.0006467204465774873,1,743,742,3,-1,4,6,0,515,897,226
696,6,108,424,916,492,23,23,484,484,0,0.00013615167296368154,0.0008169100377820892,520,779,259,4,4,4,8,2,158,691,299
697,0,0,1,1,0,0,0,1,1,0,0.0,0.0,1,1,0,-1,-1,-1,9,0,394,914,933
698,0,102,1,945,944,0,5,1,406,405,0.0,0.00037441710065012424,1,669,668,4,-1,5,3,0,867,733,257
699,2,104,365,919,554,8,8,412,412,0,3.4037918240920386e-05,3.4037918240920386e-05,410,410,0,4,5,5,4,1,460,552,477
700,34,34,720,720,0,70,70,705,705,0,0.0006126825283365669,0.0006126825283365669,727,727,0,-1,3,3,10,6,82,234,849
701,36,138,755,929,174,56,56,765,765,0,0.0004084550188910446,0.0005105687736138058,666,700,34,4,3,3,8,4,521,557,677
702,8,214,589,982,393,8,8,550,550,0,0.0,0.001055175465468532,1,819,818,3,4,4,2,2,967,549,304
703,2,2,362,362,0,5,5,380,380,0,3.4037918240920386e-05,3.4037918240920386e-05,418,418,0,-1,5,5,3,1,613,734,818
704,0,616,1,994,993,0,32,1,561,560,0.0,0.0014636304843595766,1,842,841,2,-1,3,7,0,450,921,304
705,0,0,1,1,0,0,0,1,1,0,0.0,0.0,1,1,0,-1,-1,-1,11,0,139,858,538
706,0,206,1,944,943,0,34,1,382,381,0.0,3.4037918240920386e-05,1,402,401,3,-1,4,21,0,12,776,659
707,1,207,333,969,636,4,11,333,456,123,0.0,0.0007488342013002485,1,773,772,3,6,4,4,2,504,582,658
708,1,1,331,331,0,8,8,331,331,0,0.0,0.0,1,1,0,-1,8,8,8,1,201,647,990
709,0,102,1,916,915,0,6,1,361,360,0.0,0.0002723033459273631,1,612,611,4,-1,5,5,1,561,962,229
710,139,241,913,960,47,162,162,924,924,0,0.001940161339732462,0.001940161339732462,876,876,0,4,2,2,13,15,228,206,402
711,2,103,356,891,535,13,13,369,369,0,0.0,0.00010211375472276115,1,474,473,5,5,5,9,1,123,896,464
712,32,648,777,997,220,32,36,727,745,18,0.0004765308553728854,0.0027911092957554717,699,911,212,2,3,3,5,5,604,636,133
713,232,334,962,976,14,190,190,973,973,0,0.0045270431260424114,0.004561081044283332,952,953,1,4,2,2,11,20,139,71,594
714,0,102,1,938,937,0,5,1,402,401,0.0,0.0002382654276864427,1,602,601,4,-1,5,3,0,888,678,759
715,302,403,978,983,5,170,170,963,963,0,0.004152626025392287,0.004152626025392287,950,950,0,5,2,2,11,44,176,27,734
716,0,101,1,888,887,0,13,1,331,330,0.0,0.0,1,1,0,5,-1,6,13,0,242,324,717
717,6,6,441,441,0,18,18,498,498,0,0.0,0.0,1,1,0,-1,4,4,5,1,407,870,729
718,8,110,552,943,391,8,8,489,489,0,0.00013615167296368154,0.00013615167296368154,516,516,0,4,4,4,2,2,596,491,623
719,0,101,1,922,921,0,4,1,332,331,0.0,3.4037918240920386e-05,1,404,403,5,-1,6,4,0,543,784,585
720,2,104,376,946,570,4,4,427,427,0,3.4037918240920386e-05,0.00017018959120460194,399,554,155,4,5,5,2,1,998,421,316
721,537,639,996,997,1,72,72,966,966,0,0.016338200755641786,0.016338200755641786,993,993,0,4,2,2,3,98,680,23,807
722,14,115,575,921,346,34,34,597,597,0,0.00017018959120460194,0.00017018959120460194,529,529,0,5,4,4,7,3,141,507,292
723,18,120,694,949,255,8,8,483,483,0,0.00013615167296368154,0.0002723033459273631,524,625,101,4,4,4,2,3,925,378,567
724,0,206,1,973,972,0,20,1,604,603,0.0,0.0016338200755641784,1,860,859,3,-1,4,4,1,767,814,66
725,0,206,1,950,949,0,28,1,455,454,0.0,0.0005446066918547262,1,715,714,3,-1,4,10,0,206,977,150
726,142,348,902,974,72,240,240,884,884,0,0.0013274788113958951,0.0017359338302869397,833,862,29,3,2,2,23,11,30,162,366
727,0,0,1,1,0,0,0,1,1,0,0.0,0.0,1,1,0,-1,-1,-1,7,0,182,877,632
728,0,206,1,949,948,0,18,1,409,408,0.0,0.0002723033459273631,1,614,613,3,-1,4,8,0,483,959,645
729,123,123,926,926,0,76,76,883,883,0,0.002280540522141666,0.002280540522141666,901,901,0,-1,3,3,6,23,624,106,854
730,19,19,621,621,0,37,37,522,522,0,0.0002382654276864427,0.0002382654276864427,589,589,0,-1,4,4,11,4,333,208,923
731,16,118,639,937,298,16,16,541,541,0,0.0002042275094455223,0.0007828721195411688,561,774,213,4,4,4,4,7,545,188,130
732,0,616,1,993,992,0,80,1,622,621,0.0,0.0021784267674189047,1,891,890,2,-1,3,14,1,154,806,109
733,116,217,901,956,55,110,110,858,858,0,0.002110350930937064,0.002110350930937064,889,889,0,5,3,3,10,19,125,297,460
734,18,18,618,618,0,48,48,681,681,0,0.0002723033459273631,0.0002723033459273631,595,595,0,-1,3,3,7,3,182,263,985
735,0,101,1,936,935,0,3,1,332,331,0.0,0.0,1,1,0,5,-1,6,3,1,683,738,781
736,24,230,698,972,274,52,52,796,796,0,0.0012253650566731338,0.0021784267674189047,828,894,66,3,3,3,7,4,404,281,139
737,109,210,941,974,33,32,32,903,903,0,0.0026889955410327104,0.002757071377514551,922,925,3,5,3,3,2,26,598,127,449
738,22,228,669,968,299,34,34,588,588,0,0.00037441710065012424,0.0012934408931549745,652,845,193,3,4,4,7,11,361,249,116
739,0,206,1,975,974,0,8,1,504,503,0.0,0.0011913271384322134,1,842,841,3,-1,4,2,0,896,992,82
740,186,287,959,975,16,106,106,962,962,0,0.004833384390210695,0.004833384390210695,958,958,0,5,2,2,7,28,413,41,648
741,22,228,546,945,399,87,87,496,496,0,0.00010211375472276115,0.00013615167296368154,468,501,33,3,3,3,23,3,15,290,762
742,8,8,580,580,0,6,6,468,468,0,0.00030634126416828345,0.00030634126416828345,636,636,0,-1,5,5,3,6,840,368,960
743,42,658,748,992,244,80,80,647,647,0,0.0004084550188910446,0.0016678579938050988,667,862,195,2,3,3,13,9,67,191,612
744,0,206,1,977,976,0,8,1,499,498,0.0,0.0008509479560230097,1,793,792,3,-1,4,2,0,983,884,438
745,9,215,562,973,411,14,18,552,646,94,0.00013615167296368154,0.0008169100377820892,521,785,264,3,4,4,3,5,842,710,131
746,0,616,1,986,985,0,166,1,627,626,0.0,0.0018040096667687805,1,870,869,2,-1,3,35,0,20,836,104
747,0,101,1,949,948,0,2,1,332,331,0.0,3.4037918240920386e-05,1,404,403,5,-1,6,2,0,809,903,586
748,0,102,1,896,895,0,7,1,355,354,0.0,3.4037918240920386e-05,1,405,404,4,-1,5,6,0,393,881,837
749,193,399,946,981,35,112,112,907,907,0,0.0031314884781646754,0.003369753905851118,929,935,6,3,2,2,8,22,370,203,634
750,17,119,734,966,232,24,24,878,878,0,0.0009190237925048504,0.0012594029749140542,801,842,41,4,3,3,3,3,918,559,90
751,4,106,497,968,471,4,4,523,523,0,0.00034037918240920387,0.0004084550188910446,669,694,25,4,5,5,2,2,933,524,248
752,0,101,1,911,910,0,3,1,332,331,0.0,0.0,1,1,0,5,-1,6,3,2,459,684,530
753,23,124,780,960,180,12,12,670,670,0,0.0004084550188910446,0.000442492937131965,669,679,10,5,4,4,2,9,946,212,373
754,29,235,756,976,220,18,18,608,608,0,0.000442492937131965,0.0012253650566731338,682,836,154,3,4,4,3,11,989,52,327
755,6,6,407,407,0,18,18,417,417,0,0.00010211375472276115,0.00010211375472276115,482,482,0,-1,4,4,8,1,434,594,769
756,0,102,1,904,903,0,8,1,369,368,0.0,3.4037918240920386e-05,1,405,404,4,-1,5,6,0,345,678,567
757,0,102,1,869,868,0,22,1,361,360,0.0,6.807583648184077e-05,1,448,447,4,-1,5,19,0,48,923,550
758,100,201,862,947,85,108,108,829,829,0,0.0011232513019503727,0.0011232513019503727,811,811,0,6,3,3,12,12,183,179,469
759,12,12,532,532,0,28,28,483,483,0,0.00030634126416828345,0.00030634126416828345,618,618,0,-1,4,4,10,2,437,584,830
760,18,119,712,952,240,14,14,623,623,0,0.0006126825283365669,0.0006126825283365669,750,750,0,5,4,4,3,8,888,204,893
761,8,109,560,952,392,8,8,509,509,0,6.807583648184077e-05,0.00013615167296368154,449,525,76,5,4,4,2,4,232,442,771
762,137,343,939,982,43,44,44,820,820,0,0.0026889955410327104,0.0030634126416828346,911,920,9,3,3,3,4,28,235,44,288
763,0,0,1,1,0,0,0,1,1,0,0.0,0.0,1,1,0,-1,-1,-1,8,0,308,897,768
764,6,107,422,915,493,14,14,422,422,0,0.0,0.0,1,1,0,5,4,4,7,1,361,743,298
765,0,102,1,887,886,0,10,1,382,381,0.0,0.00010211375472276115,1,488,487,4,-1,5,6,0,378,859,486
766,2,2,364,364,0,6,6,366,366,0,3.4037918240920386e-05,3.4037918240920386e-05,415,415,0,-1,5,5,5,1,601,924,966
767,0,0,1,1,0,0,0,1,1,0,0.0,0.0,1,1,0,-1,-1,-1,2,0,761,836,349
768,43,659,758,995,237,82,92,657,703,46,0.0007147962830593281,0.0012594029749140542,748,829,81,2,3,3,14,7,47,134,52
769,89,89,875,875,0,88,88,835,835,0,0.001157289220191293,0.001157289220191293,820,820,0,-1,3,3,8,17,186,213,517
770,0,101,1,939,938,0,2,1,329,328,0.0,3.4037918240920386e-05,1,394,393,5,-1,6,2,0,938,826,231
771,168,269,935,970,35,184,184,972,972,0,0.0037441710065012424,0.0037441710065012424,938,938,0,8,2,2,10,19,240,135,647
772,9,625,571,998,427,16,30,540,742,202,0.00017018959120460194,0.005650294427992784,546,961,415,2,4,3,4,6,735,392,22
773,48,150,857,967,110,22,22,806,806,0,0.0015657442390823377,0.00176997174852786,869,885,16,4,3,3,2,13,816,335,536
774,20,226,641,957,316,38,42,544,568,24,6.807583648184077e-05,0.00088498587426393,442,792,350,3,4,4,9,6,202,424,130
775,20,122,729,953,224,14,14,623,623,0,0.0009190237925048504,0.0015317063208414173,806,868,62,4,4,4,3,9,888,415,175
776,0,102,1,882,881,0,14,1,373,372,0.0,0.00017018959120460194,1,539,538,4,-1,5,10,0,310,276,691
777,23,23,651,651,0,50,50,645,645,0,0.00037441710065012424,0.00037441710065012424,650,650,0,-1,3,3,8,3,358,458,814
778,0,101,1,936,935,0,3,1,331,330,0.0,0.00010211375472276115,1,487,486,5,-1,6,3,0,568,735,584
779,15,15,679,679,0,12,12,610,610,0,0.00030634126416828345,0.00030634126416828345,647,647,0,-1,4,4,2,4,948,557,929
780,16,222,525,946,421,68,72,543,559,16,0.00017018959120460194,0.00030634126416828345,533,624,91,3,3,3,17,1,210,452,260
781,4,210,422,967,545,12,20,385,475,90,3.4037918240920386e-05,0.00017018959120460194,408,546,138,3,5,4,8,2,449,430,655
782,52,153,849,965,116,50,50,941,941,0,0.002484768031587188,0.002484768031587188,914,914,0,6,2,2,4,4,491,233,861
783,25,231,696,966,270,46,46,672,672,0,0.0005105687736138058,0.00088498587426393,705,789,84,3,3,3,8,5,365,487,432
784,22,123,664,920,256,64,64,777,777,0,0.0002042275094455223,0.00030634126416828345,568,637,69,5,3,3,8,2,257,827,862
785,6,108,430,910,480,20,20,493,493,0,3.4037918240920386e-05,0.00013615167296368154,395,510,115,4,4,4,6,2,387,648,164
786,8,214,537,973,436,12,12,481,481,0,0.0002382654276864427,0.0006126825283365669,576,739,163,3,4,4,4,3,424,795,125
787,2,208,372,976,604,4,8,425,509,84,0.0002042275094455223,0.0010892133837094523,587,825,238,3,5,4,2,1,964,840,175
788,0,0,1,1,0,0,0,1,1,0,0.0,0.0,1,1,0,-1,-1,-1,2,0,926,883,699
789,22,124,692,926,234,34,34,683,683,0,0.0005446066918547262,0.0005446066918547262,725,725,0,4,3,3,6,4,402,380,935
790,0,0,1,1,0,0,0,1,1,0,0.0,0.0,1,1,0,-1,-1,-1,2,0,941,968,847
791,28,130,614,884,270,126,126,655,655,0,0.0005446066918547262,0.0006126825283365669,693,715,22,4,3,3,21,3,74,236,722
792,10,112,513,902,389,48,48,597,597,0,0.00017018959120460194,0.0005446066918547262,525,704,179,4,4,4,10,4,169,287,770
793,0,0,1,1,0,0,0,1,1,0,0.0,0.0,1,1,0,-1,-1,-1,5,0,695,758,834
794,8,214,476,951,475,35,35,466,466,0,0.00010211375472276115,0.0002382654276864427,484,582,98,3,4,4,12,2,143,549,215
795,6,622,427,993,566,19,36,473,601,128,0.0,0.0011232513019503727,1,820,819,2,4,3,7,1,466,530,470
796,0,0,1,1,0,0,0,1,1,0,0.0,0.0,1,1,0,-1,-1,-1,2,0,283,686,880
797,128,334,910,979,69,142,142,898,898,0,0.002484768031587188,0.0033357159876101976,904,931,27,3,3,3,12,19,187,91,326
798,0,616,1,998,997,0,22,1,652,651,0.0,0.007386228258279724,1,973,972,2,-1,3,4,0,784,818,497
799,0,0,1,1,0,0,0,1,1,0,0.0,0.0,1,1,0,-1,-1,-1,4,0,539,834,515
800,9,111,590,947,357,12,12,599,599,0,0.0002382654276864427,0.0014295925661186562,601,857,256,4,4,4,2,4,886,339,98
801,12,12,583,583,0,12,12,463,463,0,0.0004765308553728854,0.0004765308553728854,690,690,0,-1,4,4,4,3,741,795,880
802,34,34,764,764,0,40,40,748,748,0,0.0005786446100956465,0.0005786446100956465,735,735,0,-1,3,3,5,6,311,461,897
803,22,124,722,949,227,14,14,573,573,0,0.0004765308553728854,0.0005105687736138058,702,715,13,4,4,4,3,5,756,418,711
804,0,102,1,934,933,0,5,1,371,370,0.0,0.00013615167296368154,1,522,521,4,-1,5,4,0,610,959,840
805,39,140,879,978,99,12,12,759,759,0,0.001940161339732462,0.0020422750944552232,894,900,6,5,4,4,2,15,782,153,291
806,6,6,448,448,0,16,16,484,484,0,0.0002723033459273631,0.0002723033459273631,605,605,0,-1,4,4,6,1,494,869,546
807,1,1,333,333,0,3,3,333,333,0,0.00010211375472276115,0.00010211375472276115,488,488,0,-1,6,6,3,2,288,739,970
808,6,6,456,456,0,22,22,631,631,0,0.00010211375472276115,0.00010211375472276115,485,485,0,-1,4,4,5,1,727,891,674
809,2,2,355,355,0,11,11,398,398,0,3.4037918240920386e-05,3.4037918240920386e-05,395,395,0,-1,5,5,6,1,255,360,901
810,2,618,350,991,641,13,50,374,640,266,6.807583648184077e-05,0.002825147213996392,436,925,489,2,5,3,8,3,483,755,76
811,90,90,838,838,0,180,180,868,868,0,0.0017359338302869397,0.0017359338302869397,871,871,0,-1,2,2,15,8,77,186,944
812,1,1,333,333,0,3,3,333,333,0,0.0,0.0,1,1,0,-1,7,7,3,2,704,448,733
813,14,116,632,945,313,18,18,646,646,0,0.0002042275094455223,0.0002723033459273631,575,615,40,4,4,4,3,5,579,241,631
814,119,220,944,977,33,32,32,888,888,0,0.002280540522141666,0.002314578440382586,912,912,0,5,3,3,2,20,846,95,935
815,0,102,1,939,938,0,3,1,374,373,0.0,0.00034037918240920387,1,657,656,4,-1,5,2,0,976,372,376
816,6,6,389,389,0,52,52,454,454,0,6.807583648184077e-05,6.807583648184077e-05,450,450,0,-1,4,4,21,2,2,419,766
817,2,103,399,964,565,3,3,411,411,0,6.807583648184077e-05,0.00013615167296368154,458,535,77,5,5,5,2,1,865,609,749
818,54,156,819,936,117,58,58,769,769,0,0.0006807583648184077,0.0007828721195411688,740,754,14,4,3,3,7,7,525,422,437
819,0,102,1,928,927,0,7,1,387,386,0.0,3.4037918240920386e-05,1,414,413,4,-1,5,5,0,601,833,93
820,6,108,405,904,499,22,22,436,436,0,3.4037918240920386e-05,0.00010211375472276115,409,489,80,4,4,4,9,1,803,935,110
821,0,102,1,896,895,0,14,1,408,407,0.0,0.0002723033459273631,1,612,611,4,-1,5,7,0,118,629,211
822,0,102,1,895,894,0,13,1,394,393,0.0,3.4037918240920386e-05,1,397,396,4,-1,5,8,0,488,801,718
823,2,104,368,943,575,7,8,415,444,29,3.4037918240920386e-05,0.0006126825283365669,400,740,340,4,5,5,4,1,794,506,559
824,0,0,1,1,0,0,0,1,1,0,0.0,0.0,1,1,0,-1,-1,-1,6,1,630,852,635
825,0,206,1,978,977,0,9,1,525,524,0.0,0.0006126825283365669,1,740,739,3,-1,4,3,0,600,737,170
826,6,212,523,984,461,8,12,548,680,132,0.0002723033459273631,0.0019061234214915416,621,893,272,3,4,4,2,1,830,797,95
827,0,101,1,879,878,0,15,1,332,331,0.0,3.4037918240920386e-05,1,398,397,5,-1,6,15,0,65,980,755
828,62,268,838,978,140,62,62,809,809,0,0.0010211375472276116,0.0017359338302869397,807,864,57,3,3,3,7,13,336,256,83
829,0,206,1,977,976,0,12,1,605,604,0.0,0.001497668402600497,1,864,863,3,-1,4,2,0,907,922,304
830,4,210,471,978,507,4,8,423,521,98,0.00013615167296368154,0.006262976956329351,516,967,451,3,5,4,2,4,723,567,1
831,0,616,1,990,989,0,54,1,659,658,0.0,0.0018720855032506212,1,880,879,2,-1,3,9,0,316,848,82
832,6,108,438,920,482,15,15,503,503,0,0.00017018959120460194,0.0002042275094455223,546,577,31,4,4,4,4,1,444,840,799
833,266,472,975,990,15,120,120,982,982,0,0.006262976956329351,0.006603356138738555,965,967,2,3,2,2,7,49,207,51,645
834,6,6,404,404,0,26,26,464,464,0,0.0002382654276864427,0.0002382654276864427,586,586,0,-1,4,4,9,1,191,527,947
835,145,1745,934,1000,66,100,100,938,938,0,0.0042547397801150485,0.018074134585928724,954,992,38,1,2,2,6,23,368,122,115
836,190,291,973,984,11,72,72,987,987,0,0.0088498587426393,0.00888389666088022,982,982,0,5,2,2,3,30,745,75,679
837,2,2,362,362,0,11,11,421,421,0,3.4037918240920386e-05,3.4037918240920386e-05,405,405,0,-1,5,5,6,2,764,690,898
838,0,0,1,1,0,0,0,1,1,0,0.0,0.0,1,1,0,-1,-1,-1,3,0,639,826,821
839,0,102,1,923,922,0,9,1,406,405,0.0,6.807583648184077e-05,1,450,449,4,-1,5,6,3,594,882,727
840,8,8,532,532,0,18,18,615,615,0,0.00013615167296368154,0.00013615167296368154,519,519,0,-1,4,4,3,3,592,536,860
841,0,206,1,959,958,0,34,1,568,567,0.0,0.002927260968719153,1,923,922,3,-1,4,7,2,417,752,28
842,207,309,971,982,11,78,78,961,961,0,0.004935498144933456,0.005173763572619898,960,963,3,4,2,2,4,37,652,74,869
843,24,230,718,975,257,14,14,539,539,0,0.0005446066918547262,0.0021784267674189047,710,888,178,3,4,4,3,4,989,40,73
844,0,102,1,960,959,0,3,1,395,394,0.0,0.0004084550188910446,1,686,685,4,-1,5,2,3,847,882,622
845,0,0,1,1,0,0,0,1,1,0,0.0,0.0,1,1,0,-1,-1,-1,3,0,743,740,796
846,52,154,839,950,111,44,44,835,835,0,0.0019061234214915416,0.0019741992579733825,881,886,5,4,3,3,4,6,444,397,311
847,2,104,351,894,543,14,15,388,394,6,3.4037918240920386e-05,0.00013615167296368154,407,513,106,4,5,5,8,3,357,578,505
848,2,2,375,375,0,6,6,444,444,0,6.807583648184077e-05,6.807583648184077e-05,449,449,0,-1,5,5,3,1,862,869,974
849,40,40,816,816,0,46,46,952,952,0,0.00176997174852786,0.00176997174852786,874,874,0,-1,2,2,2,1,905,553,987
850,108,314,909,978,69,62,62,790,790,0,0.0012253650566731338,0.0014295925661186562,826,848,22,3,3,3,7,20,343,109,334
851,12,114,518,907,389,33,33,479,479,0,0.00010211375472276115,0.00013615167296368154,484,511,27,4,4,4,12,2,93,499,807
852,0,0,1,1,0,0,0,1,1,0,0.0,0.0,1,1,0,-1,-1,-1,3,2,864,271,996
853,0,102,1,934,933,0,4,1,426,425,0.0,0.0004765308553728854,1,703,702,4,-1,5,2,0,739,657,312
854,24,126,761,962,201,20,20,793,793,0,0.0004765308553728854,0.0006807583648184077,703,764,61,4,3,3,3,4,879,233,541
855,0,206,1,947,946,0,28,1,405,404,0.0,0.0002042275094455223,1,569,568,3,-1,4,14,1,121,641,391
856,35,136,781,944,163,32,32,669,669,0,0.0008169100377820892,0.0008169100377820892,787,787,0,5,4,4,6,14,373,387,781
857,38,140,784,938,154,50,50,806,806,0,0.0006126825283365669,0.0008169100377820892,743,781,38,4,3,3,5,4,501,288,287
858,0,101,1,890,889,0,6,1,328,327,0.0,0.0,1,1,0,5,-1,6,6,0,514,802,893
859,0,102,1,914,913,0,5,1,355,354,0.0,0.0,1,1,0,4,-1,5,4,0,539,860,576
860,19,19,719,719,0,12,12,662,662,0,0.0005105687736138058,0.0005105687736138058,723,723,0,-1,4,4,2,9,938,191,678
861,270,372,972,981,9,102,102,929,929,0,0.005616256509751864,0.005854521937438306,962,964,2,4,3,3,7,49,321,51,447
862,20,636,663,995,332,20,34,543,728,185,0.00030634126416828345,0.008577555396711936,628,980,352,2,4,3,4,4,671,210,0
863,38,140,788,945,157,28,28,725,725,0,0.0009870996289866913,0.0010211375472276116,816,821,5,4,3,3,3,6,687,467,442
864,107,313,930,983,53,44,44,856,856,0,0.002212464685659825,0.0025188059498281084,891,916,25,3,3,3,4,17,735,79,490
865,40,40,787,787,0,42,42,682,682,0,0.0013274788113958951,0.0013274788113958951,850,850,0,-1,4,4,7,12,361,100,513
866,0,206,1,963,962,0,18,1,454,453,0.0,0.0004084550188910446,1,679,678,3,-1,4,8,1,318,705,187
867,727,727,995,995,0,264,264,988,988,0,0.013819394805813677,0.013819394805813677,986,986,0,-1,2,2,12,92,116,30,635
868,108,314,921,982,61,38,38,851,851,0,0.002484768031587188,0.0030974505599237552,908,927,19,3,3,3,3,20,930,94,185
869,72,1712,873,1000,127,44,78,835,961,126,0.0018380475850097008,0.02889819258654141,880,996,116,1,3,2,4,18,444,64,7
870,16,16,507,507,0,83,83,526,526,0,0.00017018959120460194,0.00017018959120460194,539,539,0,-1,3,3,21,1,12,840,746
871,0,101,1,872,871,0,19,1,332,331,0.0,0.0,1,1,0,6,-1,7,19,1,83,539,140
872,141,241,938,972,34,96,96,948,948,0,0.0036760951700194017,0.0036760951700194017,938,938,0,4,2,2,7,22,482,203,196
873,9,111,580,939,359,8,8,489,489,0,3.4037918240920386e-05,0.00013615167296368154,402,516,114,4,4,4,3,3,748,580,512
874,0,206,1,951,950,0,20,1,431,430,0.0,0.0004765308553728854,1,697,696,3,-1,4,9,0,249,757,46
875,2,103,353,889,536,14,14,377,377,0,0.0,0.0,1,1,0,5,5,5,9,1,269,896,590
876,1,207,332,980,648,2,8,332,522,190,0.0,0.001055175465468532,1,824,823,3,6,4,2,1,942,734,95
877,16,16,615,615,0,34,34,733,733,0,0.00030634126416828345,0.00030634126416828345,641,641,0,-1,3,3,4,1,235,80,982
878,72,174,865,959,94,34,34,778,778,0,0.0008509479560230097,0.0009530617107457708,778,791,13,4,3,3,4,12,783,159,156
879,0,102,1,925,924,0,6,1,406,405,0.0,0.00017018959120460194,1,547,546,4,-1,5,3,0,869,943,237
880,26,26,723,723,0,40,40,757,757,0,0.0005446066918547262,0.0005446066918547262,712,712,0,-1,3,3,5,5,464,165,914
881,22,22,618,618,0,134,134,833,833,0,0.0007828721195411688,0.0007828721195411688,768,768,0,-1,3,3,14,4,154,143,794
882,8,8,509,509,0,24,24,611,611,0,0.00030634126416828345,0.00030634126416828345,627,627,0,-1,4,4,4,2,540,628,732
883,6,212,390,954,564,24,28,406,428,22,3.4037918240920386e-05,0.0002042275094455223,394,562,168,3,4,4,12,1,212,639,110
884,0,616,1,997,996,0,30,1,761,760,0.0,0.006297014874570271,1,969,968,2,-1,3,4,0,573,629,12
885,98,200,933,978,45,32,32,947,947,0,0.003778208924742163,0.0038462847612240037,938,938,0,4,3,3,2,20,757,38,688
886,0,102,1,940,939,0,4,1,413,412,0.0,0.00010211375472276115,1,491,490,4,-1,5,2,0,820,600,545
887,112,112,893,893,0,192,192,946,946,0,0.0032336022328874367,0.0032336022328874367,935,935,0,-1,2,2,13,12,97,100,728
888,86,292,849,970,121,118,118,818,818,0,0.0013955546478777359,0.0028932230504782326,837,914,77,3,3,3,13,12,91,179,55
889,0,0,1,1,0,0,0,1,1,0,0.0,0.0,1,1,0,-1,-1,-1,2,0,977,732,685
890,0,101,1,927,926,0,3,1,332,331,0.0,0.0,1,1,0,5,-1,6,3,0,680,511,321
891,0,0,1,1,0,0,0,1,1,0,0.0,0.0,1,1,0,-1,-1,-1,8,0,350,426,740
892,18,120,631,916,285,28,28,540,540,0,0.0002382654276864427,0.0005105687736138058,600,709,109,4,4,4,8,8,541,521,404
893,0,102,1,902,901,0,12,1,358,357,0.0,0.0,1,1,0,4,-1,5,11,0,261,488,756
894,21,21,703,703,0,24,24,682,682,0,0.0004084550188910446,0.0004084550188910446,671,671,0,-1,4,4,4,6,458,4,620
895,4,210,437,973,536,10,18,444,553,109,3.4037918240920386e-05,0.0006126825283365669,402,740,338,3,5,4,5,2,435,599,266
896,12,114,475,880,405,47,47,430,430,0,0.00013615167296368154,0.00013615167296368154,502,502,0,4,4,4,20,5,61,231,639
897,42,248,736,959,223,108,108,724,724,0,0.0005446066918547262,0.0006807583648184077,702,731,29,3,3,3,15,8,65,521,550
898,0,206,1,959,958,0,15,1,390,389,0.0,3.4037918240920386e-05,1,401,400,3,-1,4,8,0,244,733,870
899,4,105,457,939,482,6,6,427,427,0,0.0002382654276864427,0.0002382654276864427,614,614,0,5,5,5,3,4,732,270,373
900,241,341,975,984,9,60,60,896,896,0,0.004629156880765172,0.006535280302256714,948,968,20,4,3,3,5,45,691,77,108
901,2,208,387,986,599,3,12,396,719,323,0.0,0.0024507301133462676,1,918,917,3,5,4,2,1,847,531,112
902,0,206,1,956,955,0,42,1,582,581,0.0,0.0007488342013002485,1,755,754,3,-1,4,9,0,306,713,64
903,0,101,1,965,964,0,2,1,332,331,0.0,0.0002042275094455223,1,587,586,5,-1,6,2,0,873,994,270
904,2,208,349,970,621,9,20,387,499,112,0.0,0.00017018959120460194,1,542,541,3,5,4,6,1,341,734,110
905,18,120,704,957,253,8,8,522,522,0,0.0004084550188910446,0.0005105687736138058,692,731,39,4,4,4,2,4,957,233,394
906,2,208,360,969,609,4,10,361,445,84,3.4037918240920386e-05,0.0007147962830593281,408,757,349,3,5,4,3,1,927,601,207
907,2,208,368,974,606,4,10,370,474,104,0.0,0.0006126825283365669,1,741,740,3,5,4,3,1,651,140,405
908,3,3,449,449,0,6,6,427,427,0,3.4037918240920386e-05,3.4037918240920386e-05,408,408,0,-1,5,5,3,5,958,225,856
909,94,196,872,956,84,108,108,915,915,0,0.0016678579938050988,0.0018380475850097008,862,874,12,4,3,3,8,17,197,213,279
910,196,298,966,980,14,110,110,985,985,0,0.006467204465774873,0.006671431975220395,962,962,0,4,2,2,6,28,661,41,328
911,7,213,547,979,432,8,12,488,579,91,0.0002382654276864427,0.0013615167296368155,602,851,249,3,4,4,2,2,586,724,183
912,0,0,1,1,0,0,0,1,1,0,0.0,0.0,1,1,0,-1,-1,-1,2,1,609,920,660
913,88,88,865,865,0,84,84,826,826,0,0.0015657442390823377,0.0015657442390823377,864,864,0,-1,3,3,9,14,330,146,859
914,70,276,840,973,133,128,128,936,936,0,0.0021784267674189047,0.002280540522141666,892,896,4,3,2,2,9,6,217,471,720
915,6,107,447,928,481,20,20,622,622,0,0.00037441710065012424,0.00037441710065012424,676,676,0,6,4,4,4,3,885,285,374
916,0,206,1,950,949,0,23,1,400,399,0.0,0.0002723033459273631,1,610,609,3,-1,4,13,0,228,865,452
917,0,0,1,1,0,0,0,1,1,0,0.0,0.0,1,1,0,-1,-1,-1,19,0,38,839,740
918,0,206,1,950,949,0,43,1,495,494,0.0,0.0014295925661186562,1,842,841,3,-1,4,12,0,87,978,171
919,12,12,576,576,0,22,22,564,564,0,0.0002042275094455223,0.0002042275094455223,580,580,0,-1,4,4,5,4,766,346,784
920,6,108,471,939,468,8,8,502,502,0,0.00010211375472276115,0.0002382654276864427,487,597,110,4,4,4,2,1,739,711,504
921,0,102,1,931,930,0,4,1,395,394,0.0,0.000442492937131965,1,693,692,4,-1,5,2,0,966,866,90
922,7,213,514,969,455,8,8,438,438,0,3.4037918240920386e-05,0.0004765308553728854,415,687,272,3,4,4,2,2,769,430,575
923,6,108,399,889,490,42,42,457,457,0,0.00013615167296368154,0.0002382654276864427,506,587,81,4,4,4,16,4,78,512,260
924,0,101,1,956,955,0,2,1,331,330,0.0,0.00010211375472276115,1,483,482,5,-1,6,2,3,995,753,369
925,14,14,480,480,0,92,92,523,523,0,0.0002382654276864427,0.0002382654276864427,579,579,0,-1,4,4,22,6,18,392,330
926,0,0,1,1,0,0,0,1,1,0,0.0,0.0,1,1,0,-1,-1,-1,3,0,826,733,850
927,10,10,550,550,0,14,14,523,523,0,0.00010211375472276115,0.00010211375472276115,488,488,0,-1,4,4,3,3,927,596,800
928,73,689,901,1000,99,38,38,888,888,0,0.0020763130126961434,0.004765308553728854,896,951,55,2,3,3,3,27,958,304,73
929,2,2,366,366,0,8,8,429,429,0,6.807583648184077e-05,6.807583648184077e-05,439,439,0,-1,5,5,4,1,578,416,684
930,14,14,646,646,0,12,12,628,628,0,0.00037441710065012424,0.00037441710065012424,666,666,0,-1,4,4,2,3,939,616,713
931,16,222,624,973,349,22,26,680,718,38,0.0004084550188910446,0.0007828721195411688,685,776,91,3,3,3,4,2,740,652,341
932,0,0,1,1,0,0,0,1,1,0,0.0,0.0,1,1,0,-1,-1,-1,3,0,856,784,988
933,150,766,912,995,83,182,192,874,891,17,0.0018380475850097008,0.009156200006807584,877,972,95,2,3,3,17,16,73,78,1
934,6,107,457,923,466,12,12,549,549,0,0.0002042275094455223,0.0002042275094455223,565,565,0,5,4,4,2,1,909,689,878
935,0,0,1,1,0,0,0,1,1,0,0.0,0.0,1,1,0,-1,-1,-1,12,0,212,604,921
936,6,107,493,940,447,12,12,616,616,0,0.0002042275094455223,0.0002723033459273631,576,621,45,5,4,4,2,1,734,168,592
937,17,119,675,939,264,28,28,776,776,0,0.0002382654276864427,0.0002723033459273631,595,622,27,4,3,3,3,2,935,323,322
938,84,84,910,910,0,38,38,869,869,0,0.00176997174852786,0.00176997174852786,885,885,0,-1,3,3,3,20,825,49,946
939,32,32,689,689,0,88,88,733,733,0,0.0005446066918547262,0.0005446066918547262,713,713,0,-1,3,3,12,2,292,473,973
940,16,16,592,592,0,34,34,579,579,0,0.00017018959120460194,0.00017018959120460194,552,552,0,-1,4,4,7,5,714,350,426
941,0,0,1,1,0,0,0,1,1,0,0.0,0.0,1,1,0,-1,-1,-1,19,1,148,841,766
942,17,119,651,924,273,36,36,737,737,0,0.0002382654276864427,0.0004084550188910446,595,682,87,4,3,3,5,3,290,541,371
943,1,103,332,940,608,2,3,332,372,40,0.0,0.00010211375472276115,1,497,496,4,6,5,2,1,881,671,322
944,0,206,1,984,983,0,8,1,570,569,0.0,0.0016338200755641784,1,873,872,3,-1,4,2,0,950,514,95
945,0,0,1,1,0,0,0,1,1,0,0.0,0.0,1,1,0,-1,-1,-1,13,0,129,992,638
946,20,122,660,924,264,40,40,626,626,0,0.0002723033459273631,0.0002723033459273631,608,608,0,4,4,4,8,6,158,107,791
947,0,0,1,1,0,0,0,1,1,0,0.0,0.0,1,1,0,-1,-1,-1,6,0,341,644,539
948,2,103,354,914,560,5,5,375,375,0,0.0,0.0,1,1,0,6,5,5,3,1,459,530,721
949,163,163,946,946,0,106,106,963,963,0,0.0036760951700194017,0.0036760951700194017,943,943,0,-1,2,2,7,23,324,117,823
950,30,30,776,776,0,26,26,659,659,0,0.0006467204465774873,0.0006467204465774873,738,738,0,-1,4,4,5,6,580,46,760
951,449,551,983,989,6,158,158,975,975,0,0.010041185881071514,0.010449640899962559,978,979,1,4,2,2,9,62,263,70,759
952,0,206,1,958,957,0,19,1,447,446,0.0,0.0002382654276864427,1,590,589,3,-1,4,8,0,488,839,29
953,7,7,567,567,0,8,8,531,531,0,0.00013615167296368154,0.00013615167296368154,523,523,0,-1,4,4,2,3,851,631,767
954,69,171,851,952,101,68,68,811,811,0,0.0009530617107457708,0.001497668402600497,792,849,57,4,3,3,8,14,454,175,329
955,9,110,614,959,345,12,12,570,570,0,0.00010211375472276115,0.00010211375472276115,494,494,0,5,4,4,4,3,860,311,639
956,0,0,1,1,0,0,0,1,1,0,0.0,0.0,1,1,0,-1,-1,-1,15,0,95,953,538
957,0,102,1,895,894,0,15,1,400,399,0.0,0.00010211375472276115,1,488,487,4,-1,5,8,0,225,768,453
958,22,22,630,630,0,64,64,632,632,0,0.0002042275094455223,0.0002042275094455223,565,565,0,-1,3,3,11,4,188,346,725
959,16,118,561,899,338,48,48,598,598,0,0.00017018959120460194,0.0002042275094455223,534,559,25,4,3,3,9,1,164,666,325
960,35,136,811,959,148,12,12,584,584,0,0.0009190237925048504,0.0009190237925048504,806,806,0,6,4,4,2,14,429,175,663
961,19,225,726,982,256,8,8,513,513,0,0.0004765308553728854,0.0009190237925048504,696,799,103,3,4,4,2,8,960,204,243
962,6,108,437,916,479,18,18,497,497,0,6.807583648184077e-05,0.00010211375472276115,453,493,40,4,4,4,5,1,528,238,762
963,2,104,350,880,530,24,25,380,384,4,3.4037918240920386e-05,6.807583648184077e-05,399,451,52,4,5,5,15,2,107,615,585
964,30,236,779,976,197,16,20,563,623,60,0.0004084550188910446,0.0012594029749140542,682,843,161,3,4,4,4,13,633,256,179
965,6,107,628,980,352,12,12,869,869,0,0.0005105687736138058,0.0005446066918547262,729,741,12,6,4,4,2,1,955,439,714
966,7,7,579,579,0,8,8,564,564,0,0.00010211375472276115,0.00010211375472276115,482,482,0,-1,4,4,2,2,890,363,649
967,14,115,656,950,294,8,8,502,502,0,0.00030634126416828345,0.00034037918240920387,639,658,19,5,4,4,2,3,980,536,842
968,2,104,368,925,557,5,5,368,368,0,3.4037918240920386e-05,3.4037918240920386e-05,405,405,0,4,5,5,4,1,543,540,935
969,1,103,333,925,592,3,5,333,382,49,3.4037918240920386e-05,0.00030634126416828345,409,622,213,4,6,5,3,1,577,893,376
970,0,206,1,979,978,0,8,1,518,517,0.0,0.0002382654276864427,1,621,620,3,-1,4,2,0,802,324,617
971,26,642,689,995,306,38,52,594,692,98,0.0005786446100956465,0.0030634126416828346,733,929,196,2,4,3,7,7,331,303,94
972,0,206,1,953,952,0,22,1,453,452,0.0,0.00037441710065012424,1,655,654,3,-1,4,7,1,296,660,159
973,2,2,361,361,0,4,4,362,362,0,3.4037918240920386e-05,3.4037918240920386e-05,407,407,0,-1,5,5,3,3,471,708,922
974,0,102,1,904,903,0,10,1,354,353,0.0,0.0,1,1,0,4,-1,5,9,0,180,564,935
975,4,106,496,962,466,6,6,497,497,0,0.0005105687736138058,0.0006467204465774873,713,744,31,4,5,5,3,3,852,209,501
976,16,16,752,752,0,8,8,599,599,0,0.0005786446100956465,0.0005786446100956465,751,751,0,-1,4,4,2,4,805,470,629
977,14,630,544,991,447,40,88,573,833,260,0.0002042275094455223,0.013036522686272508,575,983,408,2,4,3,8,3,483,458,3
978,32,134,783,947,164,34,34,771,771,0,0.0006467204465774873,0.0008509479560230097,754,785,31,4,3,3,4,6,424,192,477
979,96,198,915,970,55,40,40,794,794,0,0.002280540522141666,0.002484768031587188,899,909,10,4,3,3,5,23,601,66,132
980,272,272,986,986,0,22,22,838,838,0,0.006841621566424997,0.006841621566424997,969,969,0,-1,3,3,2,81,988,32,863
981,4,4,424,424,0,5,5,383,383,0,0.00010211375472276115,0.00010211375472276115,489,489,0,-1,5,5,3,2,687,694,803
982,0,0,1,1,0,0,0,1,1,0,0.0,0.0,1,1,0,-1,-1,-1,17,0,112,324,983
983,18,18,675,675,0,21,21,680,680,0,0.0007147962830593281,0.0007147962830593281,766,766,0,-1,3,3,4,3,885,761,894
984,0,0,1,1,0,0,0,1,1,0,0.0,0.0,1,1,0,-1,-1,-1,4,0,887,894,938
985,0,0,1,1,0,0,0,1,1,0,0.0,0.0,1,1,0,-1,-1,-1,3,0,613,916,945
986,0,102,1,883,882,0,13,1,351,350,0.0,3.4037918240920386e-05,1,402,401,4,-1,5,12,1,44,830,449
987,4,210,384,944,560,33,56,400,479,79,0.0,0.0007147962830593281,1,741,740,3,5,4,18,2,86,602,269
988,14,630,593,997,404,20,30,554,701,147,0.00030634126416828345,0.002484768031587188,625,903,278,2,4,3,4,3,717,653,151
989,0,0,1,1,0,0,0,1,1,0,0.0,0.0,1,1,0,-1,-1,-1,7,0,372,826,489
990,0,102,1,937,936,0,3,1,366,365,0.0,0.00010211375472276115,1,486,485,4,-1,5,2,1,598,554,391
991,4,106,468,951,483,3,3,378,378,0,3.4037918240920386e-05,3.4037918240920386e-05,402,402,0,4,5,5,2,2,851,599,300
992,0,0,1,1,0,0,0,1,1,0,0.0,0.0,1,1,0,-1,-1,-1,4,0,736,801,874
993,0,206,1,947,946,0,28,1,384,383,0.0,0.00010211375472276115,1,484,483,3,-1,4,17,2,39,271,385
994,34,136,715,918,203,66,66,700,700,0,0.00030634126416828345,0.000442492937131965,620,665,45,4,3,3,10,8,256,286,452
995,16,222,537,950,413,76,76,644,644,0,6.807583648184077e-05,0.0002723033459273631,436,600,164,3,3,3,13,1,91,667,121
996,115,115,881,881,0,248,248,892,892,0,0.0013955546478777359,0.0013955546478777359,844,844,0,-1,2,2,22,15,33,137,669
997,0,0,1,1,0,0,0,1,1,0,0.0,0.0,1,1,0,-1,-1,-1,18,0,69,909,864
998,2,104,359,914,555,8,10,390,427,37,6.807583648184077e-05,0.000442492937131965,440,688,248,4,5,5,5,1,284,771,245
999,0,102,1,938,937,0,6,1,452,451,0.0,0.0002382654276864427,1,607,606,4,-1,5,3,0,871,600,101
