,FreeNet_pre_score,FreeNet_post_score,FreeNet_pre_rank,FreeNet_post_rank,FreeNet_delta_ranks,Reversed_pre_score,Reversed_post_score,Reversed_pre_rank,Reversed_post_rank,Reversed_delta_ranks,Random_pre_score,Random_post_score,Random_pre_rank,Random_post_rank,Random_delta_ranks,dist_victim_relayer,dist_victim_vilain_pre,dist_victim_vilain_post,out_deg_victim,in_deg_villain,victim,villain,relayer
0,34,136,815,962,147,20,20,788,788,0,0.0005786446100956465,0.0005786446100956465,743,743,0,4,3,3,3,6,871,136,720
1,0,206,1,984,983,0,8,1,533,532,0.0,0.0007488342013002485,1,772,771,3,-1,4,3,0,877,906,391
2,24,125,655,912,257,52,52,599,599,0,0.00017018959120460194,0.0002042275094455223,548,567,19,5,3,3,11,3,333,378,761
3,0,206,1,954,953,0,22,1,413,412,0.0,0.0002723033459273631,1,603,602,3,-1,4,10,0,105,588,591
4,87,87,859,859,0,84,84,711,711,0,0.00088498587426393,0.00088498587426393,783,783,0,-1,3,3,12,16,222,113,757
5,10,112,511,896,385,50,50,573,573,0,0.0002382654276864427,0.0004765308553728854,576,689,113,4,4,4,11,4,233,287,525
6,0,0,1,1,0,0,0,1,1,0,0.0,0.0,1,1,0,-1,-1,-1,3,1,608,948,753
7,24,125,722,940,218,24,24,650,650,0,0.0004084550188910446,0.0004084550188910446,680,680,0,5,4,4,4,6,652,432,321
8,0,206,1,964,963,0,24,1,525,524,0.0,0.0005786446100956465,1,734,733,3,-1,4,6,0,387,907,306
9,0,0,1,1,0,0,0,1,1,0,0.0,0.0,1,1,0,-1,-1,-1,12,0,219,877,858
10,0,102,1,923,922,0,11,1,423,422,0.0,0.00030634126416828345,1,642,641,4,-1,5,6,1,657,529,246
11,124,724,923,996,73,90,90,864,864,0,0.002723033459273631,0.003165526396405596,911,924,13,2,3,3,9,20,278,94,490
12,0,102,1,886,885,0,19,1,382,381,0.0,0.00017018959120460194,1,530,529,4,-1,5,12,0,187,993,505
13,24,125,795,966,171,12,12,661,661,0,0.0012253650566731338,0.0012594029749140542,841,842,1,5,4,4,2,8,742,186,311
14,0,102,1,897,896,0,11,1,373,372,0.0,0.00017018959120460194,1,544,543,4,-1,5,8,0,383,620,652
15,8,214,498,960,462,15,24,450,534,84,6.807583648184077e-05,0.0009190237925048504,447,791,344,3,4,4,6,2,536,680,277
16,16,118,554,900,346,56,56,659,659,0,0.0002042275094455223,0.0002723033459273631,561,602,41,4,3,3,9,1,277,711,523
17,82,698,836,995,159,156,156,855,855,0,0.0009190237925048504,0.0026889955410327104,798,910,112,2,2,2,15,11,37,52,335
18,22,638,591,989,398,53,104,494,694,200,0.0002382654276864427,0.0030293747234419145,569,919,350,2,3,3,16,2,132,499,27
19,83,83,892,892,0,28,28,732,732,0,0.001940161339732462,0.001940161339732462,881,881,0,-1,3,3,3,25,490,47,989
20,1,1,331,331,0,2,2,331,331,0,3.4037918240920386e-05,3.4037918240920386e-05,409,409,0,-1,6,6,2,1,872,878,838
21,7,7,532,532,0,8,8,482,482,0,0.00010211375472276115,0.00010211375472276115,480,480,0,-1,4,4,2,3,954,196,801
22,84,84,861,861,0,134,134,937,937,0,0.0018720855032506212,0.0018720855032506212,879,879,0,-1,2,2,9,8,164,174,997
23,150,356,902,974,72,282,282,915,915,0,0.0014295925661186562,0.0015657442390823377,845,855,10,3,2,2,23,14,4,146,384
24,6,6,410,410,0,20,20,467,467,0,6.807583648184077e-05,6.807583648184077e-05,443,443,0,-1,4,4,6,1,157,756,910
25,20,636,632,992,360,44,76,538,727,189,0.00013615167296368154,0.003710133088260322,514,944,430,2,4,3,10,4,189,210,76
26,69,69,910,910,0,24,24,822,822,0,0.002552843868069029,0.002552843868069029,915,915,0,-1,3,3,3,19,796,72,587
27,0,101,1,894,893,0,4,1,331,330,0.0,0.0,1,1,0,7,-1,8,4,0,503,783,344
28,6,622,382,988,606,78,96,582,635,53,0.00017018959120460194,0.001055175465468532,527,795,268,2,4,3,17,1,80,561,189
29,0,101,1,910,909,0,5,1,332,331,0.0,0.0,1,1,0,5,-1,6,5,0,667,909,761
30,75,75,849,849,0,94,94,841,841,0,0.0012934408931549745,0.0012934408931549745,844,844,0,-1,3,3,9,14,217,139,752
31,38,140,771,937,166,42,42,705,705,0,0.0009530617107457708,0.001055175465468532,797,809,12,4,3,3,6,7,341,396,379
32,6,212,388,945,557,62,70,515,544,29,0.00013615167296368154,0.0009530617107457708,514,801,287,3,4,4,17,2,24,532,559
33,4,4,433,433,0,8,8,412,412,0,0.0002723033459273631,0.0002723033459273631,613,613,0,-1,5,5,5,5,727,231,867
34,89,295,934,989,55,22,22,832,832,0,0.0021784267674189047,0.004186663943633207,904,951,47,3,3,3,2,27,681,61,35
35,17,118,733,957,224,12,12,720,720,0,0.0004765308553728854,0.0006467204465774873,715,756,41,5,4,4,2,5,851,283,389
36,1,1,333,333,0,13,13,333,333,0,0.0,0.0,1,1,0,-1,6,6,13,2,160,692,715
37,2,208,350,944,594,21,31,367,396,29,3.4037918240920386e-05,0.0006467204465774873,400,735,335,3,5,4,16,1,42,743,284
38,6,108,437,926,489,18,18,624,624,0,0.0002042275094455223,0.0002723033459273631,565,611,46,4,4,4,3,1,554,809,334
39,461,667,984,991,7,414,414,983,983,0,0.008373327887266415,0.008509479560230097,967,969,2,3,2,2,22,34,18,20,724
40,0,101,1,904,903,0,5,1,332,331,0.0,3.4037918240920386e-05,1,403,402,5,-1,6,5,0,599,483,334
41,209,209,974,974,0,32,32,900,900,0,0.005990673610401988,0.005990673610401988,969,969,0,-1,3,3,2,50,589,33,860
42,206,206,954,954,0,140,140,928,928,0,0.003778208924742163,0.003778208924742163,940,940,0,-1,3,3,10,25,75,105,849
43,0,102,1,936,935,0,6,1,452,451,0.0,0.0008169100377820892,1,795,794,4,-1,5,3,0,683,898,148
44,1,1,333,333,0,6,6,333,333,0,0.0,0.0,1,1,0,-1,6,6,6,1,369,671,712
45,30,131,747,939,192,38,38,725,725,0,0.0002723033459273631,0.0002723033459273631,612,612,0,5,3,3,6,5,237,178,578
46,6,6,465,465,0,12,12,518,518,0,6.807583648184077e-05,6.807583648184077e-05,450,450,0,-1,4,4,4,1,603,152,803
47,0,102,1,907,906,0,10,1,370,369,0.0,0.0002382654276864427,1,589,588,4,-1,5,8,0,442,838,710
48,74,176,835,939,104,116,116,864,864,0,0.001599782157323258,0.0016338200755641784,856,857,1,4,2,2,11,5,139,418,618
49,26,232,729,972,243,32,32,644,644,0,0.000442492937131965,0.0006467204465774873,691,736,45,3,4,4,6,6,405,46,239
50,2,104,370,943,573,5,7,371,418,47,0.0,0.0002382654276864427,1,591,590,4,5,5,4,1,789,924,667
51,0,102,1,974,973,0,3,1,437,436,0.0,0.00017018959120460194,1,559,558,4,-1,5,2,0,944,851,310
52,0,0,1,1,0,0,0,1,1,0,0.0,0.0,1,1,0,-1,-1,-1,6,0,419,644,938
53,134,750,928,997,69,132,132,958,958,0,0.0030293747234419145,0.00439089145307873,927,953,26,2,2,2,8,14,225,68,78
54,2,2,362,362,0,11,11,424,424,0,6.807583648184077e-05,6.807583648184077e-05,458,458,0,-1,5,5,6,1,657,931,200
55,0,102,1,869,868,0,29,1,384,383,0.0,0.00010211375472276115,1,473,472,4,-1,5,17,0,94,909,447
56,0,206,1,971,970,0,10,1,458,457,0.0,0.0006807583648184077,1,757,756,3,-1,4,4,0,945,786,272
57,2,618,368,997,629,8,26,438,753,315,3.4037918240920386e-05,0.002382654276864427,405,897,492,2,5,3,4,2,543,690,189
58,10,10,596,596,0,16,16,583,583,0,0.0002042275094455223,0.0002042275094455223,582,582,0,-1,4,4,4,4,491,230,839
59,0,206,1,940,939,0,35,1,410,409,0.0,0.0002042275094455223,1,557,556,3,-1,4,18,0,111,533,479
60,3,104,400,899,499,14,14,397,397,0,0.0,0.0,1,1,0,5,5,5,8,3,142,373,605
61,0,0,1,1,0,0,0,1,1,0,0.0,0.0,1,1,0,-1,-1,-1,4,0,385,952,902
62,2,104,355,904,549,9,12,377,408,31,3.4037918240920386e-05,0.0002382654276864427,398,576,178,4,5,5,6,2,470,764,557
63,28,644,783,998,215,28,38,794,895,101,0.0013615167296368155,0.003710133088260322,855,937,82,2,3,3,3,7,729,224,759
64,35,137,760,933,173,62,62,772,772,0,0.0004084550188910446,0.0004084550188910446,675,675,0,4,3,3,7,6,118,467,506
65,0,206,1,968,967,0,15,1,525,524,0.0,0.0013615167296368155,1,856,855,3,-1,4,4,0,949,915,61
66,2,618,348,989,641,22,156,354,769,415,6.807583648184077e-05,0.006331052792811192,431,960,529,2,5,3,20,3,70,708,9
67,41,41,791,791,0,40,40,717,717,0,0.0004084550188910446,0.0004084550188910446,669,669,0,-1,3,3,5,11,347,249,517
68,18,120,609,910,301,80,80,794,794,0,0.0005446066918547262,0.0007147962830593281,724,760,36,4,3,3,9,2,803,323,496
69,6,212,368,935,567,52,59,416,438,22,0.0,6.807583648184077e-05,1,451,450,3,4,4,22,1,18,618,628
70,0,206,1,964,963,0,40,1,610,609,0.0,0.004799346471969774,1,953,952,3,-1,4,8,0,137,754,5
71,6,622,396,990,594,52,88,521,660,139,0.00010211375472276115,0.002484768031587188,489,907,418,2,4,3,14,1,21,370,81
72,0,206,1,967,966,0,19,1,480,479,0.0,0.0004765308553728854,1,690,689,3,-1,4,6,0,556,820,150
73,0,102,1,926,925,0,6,1,386,385,0.0,6.807583648184077e-05,1,447,446,4,-1,5,4,0,682,923,188
74,16,632,527,991,464,58,80,544,636,92,0.0006467204465774873,0.00176997174852786,724,862,138,2,3,3,14,2,181,805,147
75,32,134,742,932,190,40,40,735,735,0,0.0005446066918547262,0.0007828721195411688,716,763,47,4,3,3,5,5,492,273,351
76,38,244,722,964,242,110,110,883,883,0,0.0009190237925048504,0.0012934408931549745,776,828,52,3,3,3,10,3,109,382,256
77,8,8,443,443,0,55,55,430,430,0,0.0,0.0,1,1,0,-1,4,4,23,5,4,401,457
78,4,210,498,987,489,6,10,480,591,111,0.00010211375472276115,0.0009190237925048504,504,805,301,3,5,4,3,4,853,443,134
79,6,6,445,445,0,26,26,616,616,0,6.807583648184077e-05,6.807583648184077e-05,455,455,0,-1,4,4,5,2,314,223,775
80,48,48,800,800,0,84,84,851,851,0,0.0018380475850097008,0.0018380475850097008,872,872,0,-1,2,2,9,3,395,390,911
81,0,0,1,1,0,0,0,1,1,0,0.0,0.0,1,1,0,-1,-1,-1,7,0,265,945,910
82,8,8,567,567,0,8,8,590,590,0,0.0002382654276864427,0.0002382654276864427,616,616,0,-1,4,4,2,3,283,541,356
83,119,119,928,928,0,60,60,876,876,0,0.0026549576227917903,0.0026549576227917903,915,915,0,-1,3,3,5,20,605,43,746
84,34,240,755,969,214,52,52,792,792,0,0.0004084550188910446,0.00088498587426393,667,786,119,3,3,3,6,4,419,479,470
85,0,102,1,956,955,0,4,1,385,384,0.0,0.0,1,1,0,4,-1,5,3,0,877,998,639
86,2,208,362,964,602,6,14,363,462,99,0.0,0.00034037918240920387,1,645,644,3,5,4,5,2,531,292,247
87,22,123,690,933,243,34,34,692,692,0,0.00034037918240920387,0.00034037918240920387,642,642,0,5,3,3,6,2,373,425,935
88,3,209,451,977,526,4,8,406,499,93,3.4037918240920386e-05,0.0010892133837094523,408,834,426,3,5,4,2,2,779,244,138
89,6,6,399,399,0,28,28,455,455,0,3.4037918240920386e-05,3.4037918240920386e-05,391,391,0,-1,4,4,10,1,82,935,673
90,38,244,726,956,230,106,106,769,769,0,0.0004765308553728854,0.0006126825283365669,701,732,31,3,3,3,14,4,47,545,452
91,6,108,500,950,450,6,6,450,450,0,6.807583648184077e-05,0.00030634126416828345,454,651,197,4,5,5,3,3,569,677,368
92,126,126,919,919,0,50,50,771,771,0,0.00176997174852786,0.00176997174852786,872,872,0,-1,3,3,5,19,719,59,812
93,0,206,1,957,956,0,24,1,475,474,0.0,0.0006467204465774873,1,749,748,3,-1,4,8,0,142,778,52
94,66,168,828,933,105,106,106,802,802,0,0.001497668402600497,0.001497668402600497,856,856,0,4,3,3,11,14,227,190,443
95,42,658,760,991,231,68,102,690,831,141,0.00088498587426393,0.008066986623098132,784,972,188,2,3,3,11,8,234,186,1
96,2,104,379,952,573,4,4,413,413,0,0.0,0.0002382654276864427,1,612,611,4,5,5,2,1,681,837,249
97,30,131,852,972,120,12,12,755,755,0,0.00088498587426393,0.00088498587426393,805,805,0,6,4,4,2,15,987,219,656
98,10,216,548,962,414,18,28,433,525,92,0.00017018959120460194,0.0012594029749140542,535,829,294,3,4,4,8,4,286,398,146
99,6,6,421,421,0,44,44,623,623,0,0.00013615167296368154,0.00013615167296368154,518,518,0,-1,4,4,8,1,428,282,946
100,12,218,492,950,458,43,52,461,491,30,0.0002382654276864427,0.0009870996289866913,587,791,204,3,4,4,14,5,133,231,312
101,0,0,1,1,0,0,0,1,1,0,0.0,0.0,1,1,0,-1,-1,-1,3,0,716,324,358
102,27,233,791,983,192,22,22,837,837,0,0.001497668402600497,0.002144388849177984,865,899,34,3,3,3,2,5,906,393,226
103,12,114,635,951,316,12,12,597,597,0,0.00037441710065012424,0.0005446066918547262,659,725,66,4,4,4,2,5,771,308,248
104,71,173,894,972,78,28,28,806,806,0,0.001940161339732462,0.0022465026039007454,887,899,12,4,3,3,3,20,814,71,482
105,24,126,725,940,215,24,24,646,646,0,0.0002382654276864427,0.0004084550188910446,597,686,89,4,4,4,4,5,397,178,191
106,69,171,907,972,65,28,28,831,831,0,0.0019061234214915416,0.002144388849177984,889,898,9,4,3,3,3,19,642,297,115
107,0,102,1,896,895,0,14,1,400,399,0.0,0.00010211375472276115,1,474,473,4,-1,5,8,0,508,910,869
108,0,0,1,1,0,0,0,1,1,0,0.0,0.0,1,1,0,-1,-1,-1,6,0,266,855,833
109,116,217,888,953,65,164,164,883,883,0,0.0013955546478777359,0.0014295925661186562,846,847,1,5,3,3,14,13,198,261,781
110,0,0,1,1,0,0,0,1,1,0,0.0,0.0,1,1,0,-1,-1,-1,2,0,948,916,740
111,8,109,498,906,408,20,20,471,471,0,0.00013615167296368154,0.00013615167296368154,501,501,0,5,4,4,6,2,514,22,344
112,37,138,880,978,98,8,8,657,657,0,0.0022465026039007454,0.002280540522141666,896,899,3,5,4,4,2,20,813,94,385
113,0,101,1,904,903,0,6,1,332,331,0.0,0.0,1,1,0,5,-1,6,6,1,556,830,764
114,6,622,392,991,599,36,50,426,495,69,3.4037918240920386e-05,0.000442492937131965,389,678,289,2,4,3,16,1,72,618,333
115,4,210,423,970,547,7,12,388,454,66,0.0,0.0005105687736138058,1,717,716,3,5,4,4,3,445,411,439
116,0,101,1,893,892,0,9,1,332,331,0.0,0.0,1,1,0,5,-1,6,9,0,289,968,763
117,6,212,473,974,501,15,24,541,718,177,6.807583648184077e-05,0.007352190340038803,446,971,525,3,4,4,4,2,581,544,10
118,62,163,797,925,128,114,114,704,704,0,0.000442492937131965,0.000442492937131965,678,678,0,5,3,3,17,11,6,316,656
119,8,8,576,576,0,8,8,520,520,0,6.807583648184077e-05,6.807583648184077e-05,449,449,0,-1,4,4,2,2,947,468,894
120,149,355,920,978,58,186,186,944,944,0,0.0026209197045508697,0.003199564314646516,911,930,19,3,2,2,12,15,239,53,482
121,0,616,1,994,993,0,56,1,654,653,0.0,0.001940161339732462,1,879,878,2,-1,3,9,0,217,745,123
122,31,647,800,999,199,22,22,792,792,0,0.0007828721195411688,0.00527587732734266,779,959,180,2,3,3,2,5,894,165,127
123,0,0,1,1,0,0,0,1,1,0,0.0,0.0,1,1,0,-1,-1,-1,5,0,502,542,955
124,66,682,845,996,151,74,84,803,840,37,0.0018040096667687805,0.002757071377514551,864,914,50,2,3,3,9,13,190,42,326
125,8,214,541,974,433,14,18,512,578,66,0.0002382654276864427,0.0025188059498281084,597,915,318,3,4,4,5,2,727,22,74
126,2,104,350,900,550,12,15,377,398,21,3.4037918240920386e-05,0.0002723033459273631,405,606,201,4,5,5,8,1,199,734,516
127,16,222,623,973,350,24,28,630,685,55,0.0002723033459273631,0.00088498587426393,599,790,191,3,3,3,5,2,656,648,52
128,158,259,982,993,11,32,32,971,971,0,0.0068075836481840775,0.006841621566424997,968,968,0,5,3,3,2,50,782,33,410
129,0,101,1,915,914,0,4,1,331,330,0.0,3.4037918240920386e-05,1,402,401,6,-1,7,4,3,513,348,708
130,0,101,1,897,896,0,7,1,332,331,0.0,0.0,1,1,0,6,-1,7,7,0,413,886,621
131,2,208,365,965,600,6,16,373,507,134,0.0,0.0019741992579733825,1,895,894,3,5,4,4,1,532,853,69
132,14,116,647,945,298,18,18,652,652,0,0.0002382654276864427,0.0006126825283365669,601,752,151,4,4,4,3,3,729,268,525
133,0,616,1,998,997,0,26,1,785,784,0.0,0.0053439531638245,1,957,956,2,-1,3,4,0,728,974,133
134,230,230,967,967,0,116,116,964,964,0,0.004356853534837809,0.004356853534837809,952,952,0,-1,2,2,7,44,320,27,760
135,6,6,470,470,0,8,8,494,494,0,0.00010211375472276115,0.00010211375472276115,494,494,0,-1,4,4,2,2,609,714,777
136,8,109,535,933,398,14,14,569,569,0,0.00017018959120460194,0.00030634126416828345,546,638,92,5,4,4,3,2,337,363,384
137,16,118,690,954,264,8,8,510,510,0,0.00034037918240920387,0.0010211375472276116,665,820,155,4,4,4,2,7,964,115,184
138,0,0,1,1,0,0,0,1,1,0,0.0,0.0,1,1,0,-1,-1,-1,7,0,296,963,254
139,26,642,661,988,327,74,130,610,809,199,0.00037441710065012424,0.007386228258279724,654,967,313,2,3,3,15,4,102,380,7
140,0,0,1,1,0,0,0,1,1,0,0.0,0.0,1,1,0,-1,-1,-1,9,1,306,830,713
141,18,224,607,957,350,40,44,529,559,30,0.0002382654276864427,0.0007488342013002485,588,761,173,3,4,4,10,3,82,385,143
142,6,108,460,929,469,20,20,598,598,0,0.00034037918240920387,0.000442492937131965,652,696,44,4,4,4,4,1,619,667,518
143,0,206,1,975,974,0,18,1,576,575,0.0,0.0022465026039007454,1,895,894,3,-1,4,5,0,695,638,65
144,12,12,698,698,0,8,8,602,602,0,0.0012594029749140542,0.0012594029749140542,849,849,0,-1,4,4,2,3,898,559,890
145,8,110,554,937,383,10,10,505,505,0,0.00010211375472276115,0.0005786446100956465,492,743,251,4,4,4,3,2,774,586,535
146,166,268,932,968,36,150,150,944,944,0,0.0027911092957554717,0.0029612988869600733,912,919,7,4,2,2,11,19,234,144,617
147,0,0,1,1,0,0,0,1,1,0,0.0,0.0,1,1,0,-1,-1,-1,6,0,764,811,533
148,74,74,907,907,0,12,12,631,631,0,0.0019061234214915416,0.0019061234214915416,898,898,0,-1,4,4,2,21,894,157,672
149,0,102,1,948,947,0,6,1,438,437,0.0,0.0013955546478777359,1,853,852,4,-1,5,3,0,718,978,153
150,2,2,354,354,0,14,14,390,390,0,0.0,0.0,1,1,0,-1,5,5,8,1,303,807,979
151,58,160,821,942,121,72,72,823,823,0,0.0009530617107457708,0.0010892133837094523,801,817,16,4,3,3,7,9,265,343,404
152,0,102,1,913,912,0,9,1,388,387,0.0,0.00017018959120460194,1,550,549,4,-1,5,6,0,405,825,504
153,17,17,642,642,0,12,12,473,473,0,0.0002723033459273631,0.0002723033459273631,617,617,0,-1,4,4,4,6,921,516,923
154,18,224,628,965,337,40,40,626,626,0,0.0005105687736138058,0.0006807583648184077,701,744,43,3,4,4,8,5,521,283,346
155,0,0,1,1,0,0,0,1,1,0,0.0,0.0,1,1,0,-1,-1,-1,3,0,912,973,979
156,240,446,972,988,16,94,94,959,959,0,0.006637394056979475,0.006977773239388679,971,972,1,3,2,2,5,54,555,28,333
157,0,102,1,911,910,0,7,1,357,356,0.0,3.4037918240920386e-05,1,403,402,4,-1,5,6,0,587,833,441
158,10,10,645,645,0,8,8,564,564,0,0.0006126825283365669,0.0006126825283365669,746,746,0,-1,4,4,2,4,890,336,356
159,59,161,905,976,71,22,22,877,877,0,0.0026209197045508697,0.0030634126416828346,917,932,15,4,3,3,2,12,996,104,630
160,6,6,414,414,0,24,24,483,483,0,0.0,0.0,1,1,0,-1,4,4,8,2,308,714,854
161,9,111,565,934,369,18,18,625,625,0,0.00017018959120460194,0.0002042275094455223,548,579,31,4,4,4,3,4,869,287,596
162,8,110,574,943,369,8,8,512,512,0,0.0002382654276864427,0.0004084550188910446,609,695,86,4,4,4,2,2,948,682,697
163,121,222,933,976,43,70,70,909,909,0,0.0030293747234419145,0.0030293747234419145,924,924,0,5,3,3,5,21,616,123,781
164,18,120,650,931,281,16,16,563,563,0,0.0002723033459273631,0.0005105687736138058,603,703,100,4,4,4,4,4,520,622,406
165,0,102,1,887,886,0,13,1,375,374,0.0,0.00017018959120460194,1,543,542,4,-1,5,9,0,277,673,251
166,14,115,675,954,279,8,8,525,525,0,0.00010211375472276115,0.00017018959120460194,493,556,63,5,4,4,2,8,820,477,576
167,0,206,1,960,959,0,40,1,622,621,0.0,0.002552843868069029,1,904,903,3,-1,4,8,0,308,651,65
168,40,246,733,958,225,126,126,879,879,0,0.0012594029749140542,0.0023486163586235067,828,895,67,3,2,2,11,2,167,160,62
169,0,206,1,977,976,0,8,1,502,501,0.0,0.0009530617107457708,1,811,810,3,-1,4,2,0,761,872,405
170,2,208,363,972,609,9,14,408,484,76,0.0,0.0004084550188910446,1,679,678,3,5,4,5,1,795,623,52
171,1,102,333,908,575,6,6,333,333,0,0.0,0.0,1,1,0,6,6,6,6,1,518,671,540
172,107,313,900,977,77,106,106,918,918,0,0.0020082371762143027,0.0024166921951053475,885,909,24,3,2,2,7,15,331,151,382
173,149,355,950,984,34,64,64,939,939,0,0.0033357159876101976,0.0040845501889104465,930,942,12,3,3,3,4,28,736,41,612
174,6,107,475,941,466,10,10,506,506,0,0.00010211375472276115,0.0002042275094455223,496,572,76,5,4,4,3,1,564,561,550
175,5,5,487,487,0,5,5,415,415,0,0.00013615167296368154,0.00013615167296368154,521,521,0,-1,5,5,3,6,916,392,729
176,0,102,1,869,868,0,24,1,369,368,0.0,3.4037918240920386e-05,1,400,399,4,-1,5,19,0,48,778,360
177,46,662,812,997,185,28,28,700,700,0,0.00034037918240920387,0.0017359338302869397,648,869,221,2,3,3,3,11,837,162,145
178,15,116,581,919,338,30,30,562,562,0,0.0002382654276864427,0.0002723033459273631,599,612,13,5,4,4,7,7,510,427,763
179,3,105,450,950,500,4,4,417,417,0,0.0,3.4037918240920386e-05,1,408,407,4,5,5,2,2,999,364,406
180,12,218,550,961,411,28,28,563,563,0,0.0007488342013002485,0.0010892133837094523,762,814,52,3,4,4,6,2,630,473,465
181,0,102,1,914,913,0,6,1,402,401,0.0,0.00030634126416828345,1,635,634,4,-1,5,3,0,743,868,46
182,0,0,1,1,0,0,0,1,1,0,0.0,0.0,1,1,0,-1,-1,-1,16,0,151,358,446
183,36,36,750,750,0,58,58,718,718,0,0.00030634126416828345,0.00030634126416828345,635,635,0,-1,3,3,8,7,131,134,956
184,2,208,359,964,605,10,21,381,478,97,0.0,0.0002382654276864427,1,591,590,3,5,4,7,1,299,743,409
185,6,212,435,969,534,12,16,459,515,56,0.00010211375472276115,0.0005105687736138058,481,705,224,3,4,4,4,1,623,527,327
186,26,232,785,981,196,22,22,816,816,0,0.0005446066918547262,0.004731270635487933,726,951,225,3,3,3,2,5,986,165,31
187,0,206,1,968,967,0,15,1,470,469,0.0,0.00037441710065012424,1,657,656,3,-1,4,6,0,399,850,101
188,24,24,778,778,0,12,12,631,631,0,0.0009530617107457708,0.0009530617107457708,819,819,0,-1,4,4,2,6,776,658,744
189,1,207,333,966,633,6,15,333,445,112,0.0,0.00088498587426393,1,800,799,3,7,4,6,1,526,469,166
190,12,1652,517,1000,483,36,100,505,815,310,0.00017018959120460194,0.017087034956942034,541,992,451,1,4,2,10,2,310,408,0
191,0,616,1,993,992,0,36,1,551,550,0.0,0.0007488342013002485,1,759,758,2,-1,3,9,0,178,998,67
192,0,206,1,947,946,0,25,1,427,426,0.0,0.0006126825283365669,1,728,727,3,-1,4,11,0,279,800,177
193,54,156,776,920,144,130,130,791,791,0,0.0007828721195411688,0.0009190237925048504,755,777,22,4,3,3,15,4,107,40,385
194,25,127,684,915,231,72,72,806,806,0,0.0010892133837094523,0.0011232513019503727,810,814,4,4,3,3,7,5,193,355,260
195,0,616,1,996,995,0,64,1,760,759,0.0,0.006297014874570271,1,969,968,2,-1,3,8,0,297,929,9
196,0,101,1,922,921,0,4,1,331,330,0.0,0.0,1,1,0,9,-1,10,4,1,740,529,647
197,419,625,986,993,7,102,102,938,938,0,0.008441403723748256,0.008986010415602982,978,979,1,3,3,3,7,70,346,18,658
198,6,6,419,419,0,28,28,515,515,0,3.4037918240920386e-05,3.4037918240920386e-05,398,398,0,-1,4,4,8,1,488,711,860
199,6,6,440,440,0,24,24,646,646,0,0.0002042275094455223,0.0002042275094455223,579,579,0,-1,4,4,4,1,690,556,910
200,20,20,716,716,0,26,26,659,659,0,0.0002723033459273631,0.0002723033459273631,614,614,0,-1,4,4,5,5,602,252,822
201,179,179,960,960,0,54,54,910,910,0,0.004186663943633207,0.004186663943633207,944,944,0,-1,3,3,4,37,740,74,723
202,38,1678,823,1000,177,18,52,672,969,297,0.0009190237925048504,0.03281255318424725,795,997,202,1,4,2,3,14,863,139,36
203,2,104,363,914,551,6,7,387,404,17,0.0,0.00088498587426393,1,775,774,4,5,5,4,1,520,924,335
204,0,102,1,918,917,0,6,1,377,376,0.0,0.00010211375472276115,1,490,489,4,-1,5,4,0,690,698,241
205,0,102,1,958,957,0,3,1,387,386,0.0,0.0002723033459273631,1,616,615,4,-1,5,2,0,982,926,507
206,76,692,830,993,163,138,138,866,866,0,0.0018720855032506212,0.002723033459273631,871,915,44,2,3,3,13,13,228,255,412
207,2,103,361,926,565,6,6,425,425,0,3.4037918240920386e-05,6.807583648184077e-05,400,449,49,5,5,5,3,1,337,421,601
208,0,616,1,989,988,0,90,1,568,567,0.0,0.0012594029749140542,1,826,825,2,-1,3,21,0,2,871,130
209,0,102,1,927,926,0,6,1,359,358,0.0,0.00017018959120460194,1,552,551,4,-1,5,5,0,574,985,722
210,0,102,1,918,917,0,6,1,374,373,0.0,0.00010211375472276115,1,488,487,4,-1,5,4,0,460,782,785
211,13,114,649,947,298,8,8,490,490,0,0.0002723033459273631,0.0002723033459273631,619,619,0,6,4,4,2,6,849,486,739
212,0,0,1,1,0,0,0,1,1,0,0.0,0.0,1,1,0,-1,-1,-1,3,0,774,426,784
213,0,0,1,1,0,0,0,1,1,0,0.0,0.0,1,1,0,-1,-1,-1,3,0,729,902,792
214,76,76,857,857,0,62,62,841,841,0,0.0013955546478777359,0.0013955546478777359,853,853,0,-1,3,3,6,9,473,130,997
215,377,377,981,981,0,206,206,992,992,0,0.007318152421797883,0.007318152421797883,971,971,0,-1,2,2,9,45,287,77,742
216,10,112,612,944,332,14,14,583,583,0,0.00030634126416828345,0.0012934408931549745,640,848,208,4,4,4,3,4,835,622,45
217,0,102,1,898,897,0,11,1,375,374,0.0,0.00013615167296368154,1,514,513,4,-1,5,7,0,450,832,682
218,0,206,1,971,970,0,20,1,562,561,0.0,0.0012934408931549745,1,854,853,3,-1,4,4,0,709,863,58
219,394,394,988,988,0,80,80,949,949,0,0.008986010415602982,0.008986010415602982,980,980,0,-1,3,3,5,70,338,18,757
220,34,136,760,937,177,44,44,796,796,0,0.00088498587426393,0.0010211375472276116,797,821,24,4,3,3,4,4,671,470,410
221,16,222,556,955,399,54,58,594,626,32,0.00017018959120460194,0.0005446066918547262,551,716,165,3,3,3,10,1,114,452,479
222,0,101,1,952,951,0,2,1,329,328,0.0,3.4037918240920386e-05,1,406,405,5,-1,6,2,0,994,826,648
223,0,206,1,971,970,0,13,1,468,467,0.0,0.00034037918240920387,1,648,647,3,-1,4,5,1,688,685,461
224,22,22,636,636,0,40,40,520,520,0,0.0002042275094455223,0.0002042275094455223,556,556,0,-1,4,4,10,6,256,199,824
225,2,2,352,352,0,21,21,364,364,0,3.4037918240920386e-05,3.4037918240920386e-05,398,398,0,-1,5,5,17,3,24,484,955
226,0,102,1,940,939,0,7,1,414,413,0.0,0.00017018959120460194,1,540,539,4,-1,5,4,0,794,733,628
227,0,101,1,932,931,0,3,1,332,331,0.0,3.4037918240920386e-05,1,401,400,5,-1,6,3,0,791,445,449
228,23,124,703,930,227,24,24,638,638,0,0.0007828721195411688,0.0007828721195411688,783,783,0,5,4,4,4,9,694,293,896
229,0,206,1,966,965,0,20,1,484,483,0.0,0.0007488342013002485,1,761,760,3,-1,4,6,1,470,895,289
230,728,830,998,998,0,120,120,987,987,0,0.017597603730555838,0.017597603730555838,992,992,0,4,2,2,6,127,353,11,609
231,18,224,634,967,333,52,52,760,760,0,0.0007488342013002485,0.0019061234214915416,755,874,119,3,3,3,7,3,207,299,297
232,7,7,553,553,0,8,8,502,502,0,6.807583648184077e-05,6.807583648184077e-05,459,459,0,-1,4,4,2,2,894,566,833
233,10,112,676,971,295,8,8,644,644,0,0.0006126825283365669,0.0008169100377820892,751,781,30,4,4,4,2,3,884,616,223
234,7,7,545,545,0,20,20,634,634,0,6.807583648184077e-05,6.807583648184077e-05,444,444,0,-1,4,4,4,3,721,541,775
235,106,722,883,995,112,126,136,899,918,19,0.0021784267674189047,0.003369753905851118,891,924,33,2,3,3,11,15,360,158,842
236,0,1640,1,1000,999,0,138,1,838,837,0.0,0.013104598522754349,1,984,983,1,-1,2,14,0,198,672,6
237,100,201,896,962,66,62,62,797,797,0,0.0009530617107457708,0.0009870996289866913,793,796,3,5,3,3,7,19,324,59,749
238,6,108,403,894,491,19,19,410,410,0,0.0,3.4037918240920386e-05,1,400,399,4,4,4,9,1,164,899,599
239,0,0,1,1,0,0,0,1,1,0,0.0,0.0,1,1,0,-1,-1,-1,6,0,536,766,750
240,6,212,414,955,541,38,46,514,552,38,6.807583648184077e-05,0.0007488342013002485,447,750,303,3,4,4,11,1,271,958,382
241,0,206,1,949,948,0,34,1,434,433,0.0,0.0004084550188910446,1,663,662,3,-1,4,14,0,21,388,722
242,22,22,657,657,0,62,62,843,843,0,0.0010892133837094523,0.0010892133837094523,819,819,0,-1,3,3,6,4,536,440,793
243,0,616,1,988,987,0,88,1,620,619,0.0,0.0015657442390823377,1,856,855,2,-1,3,16,0,50,588,393
244,1,1,331,331,0,3,3,331,331,0,0.0,0.0,1,1,0,-1,6,6,3,1,916,853,864
245,0,101,1,910,909,0,8,1,332,331,0.0,0.0,1,1,0,7,-1,8,8,0,318,488,861
246,16,632,489,988,499,80,140,503,676,173,3.4037918240920386e-05,0.0018720855032506212,406,865,459,2,3,3,23,1,43,756,63
247,0,616,1,993,992,0,47,1,493,492,0.0,0.00088498587426393,1,770,769,2,-1,3,14,0,130,971,389
248,66,272,872,979,107,28,28,769,769,0,0.0011232513019503727,0.004629156880765172,828,952,124,3,3,3,3,17,829,131,31
249,114,730,876,992,116,222,232,890,911,21,0.0016678579938050988,0.002314578440382586,858,897,39,2,2,2,19,7,89,150,474
250,0,206,1,971,970,0,13,1,477,476,0.0,0.0002042275094455223,1,577,576,3,-1,4,5,0,685,669,221
251,0,206,1,950,949,0,40,1,440,439,0.0,0.00030634126416828345,1,623,622,3,-1,4,18,0,29,651,545
252,6,108,438,923,485,20,20,593,593,0,0.00013615167296368154,0.0005446066918547262,509,725,216,4,4,4,4,3,280,285,170
253,0,101,1,947,946,0,4,1,331,330,0.0,0.0,1,1,0,7,-1,8,4,0,480,916,181
254,25,127,705,930,225,34,34,703,703,0,0.0005786446100956465,0.0007828721195411688,724,773,49,4,3,3,4,5,540,454,613
255,528,528,989,989,0,204,204,990,990,0,0.010790020082371761,0.010790020082371761,976,976,0,-1,2,2,11,78,174,9,786
256,142,142,955,955,0,48,48,944,944,0,0.005003573981415297,0.005003573981415297,954,954,0,-1,3,3,3,29,912,142,968
257,0,102,1,960,959,0,3,1,395,394,0.0,0.0002042275094455223,1,586,585,4,-1,5,2,1,847,706,795
258,0,102,1,887,886,0,10,1,353,352,0.0,0.0,1,1,0,4,-1,5,9,0,269,726,606
259,235,441,962,982,20,142,142,959,959,0,0.004561081044283332,0.005105687736138058,948,955,7,3,2,2,8,24,483,13,204
260,809,1015,998,999,1,232,232,998,998,0,0.01776779332176044,0.018754892950747133,993,994,1,3,2,2,10,118,355,37,438
261,111,317,900,975,75,146,146,976,976,0,0.003710133088260322,0.0042547397801150485,935,944,9,3,2,2,8,8,197,352,224
262,0,0,1,1,0,0,0,1,1,0,0.0,0.0,1,1,0,-1,-1,-1,2,0,761,766,635
263,6,107,538,966,428,6,6,480,480,0,0.00017018959120460194,0.00017018959120460194,557,557,0,5,5,5,3,5,853,454,518
264,100,100,850,850,0,100,100,621,621,0,0.010007147962830594,0.010007147962830594,982,982,0,-1,1,1,17,13,103,120,950
265,0,102,1,879,878,0,25,1,409,408,0.0,0.0005446066918547262,1,711,710,4,-1,5,13,0,113,511,131
266,15,117,688,958,270,12,12,709,709,0,0.00037441710065012424,0.0005786446100956465,677,739,62,4,4,4,2,5,806,454,211
267,233,335,978,989,11,32,32,903,903,0,0.004220701861874128,0.004765308553728854,951,959,8,4,3,3,2,57,966,50,161
268,0,206,1,959,958,0,14,1,396,395,0.0,0.00010211375472276115,1,482,481,3,-1,4,8,0,260,715,899
269,36,242,746,966,220,58,58,705,705,0,0.0007147962830593281,0.0013955546478777359,758,842,84,3,3,3,8,8,197,345,195
270,12,218,547,971,424,24,28,548,584,36,0.0004765308553728854,0.0018040096667687805,694,880,186,3,4,4,6,2,341,524,335
271,21,227,732,977,245,12,12,608,608,0,0.0011913271384322134,0.002144388849177984,844,897,53,3,4,4,2,10,931,296,297
272,48,149,776,922,146,102,102,792,792,0,0.0012253650566731338,0.0012253650566731338,822,822,0,5,2,2,12,4,348,336,879
273,0,0,1,1,0,0,0,1,1,0,0.0,0.0,1,1,0,-1,-1,-1,5,0,719,867,608
274,25,126,732,941,209,34,34,737,737,0,0.0013274788113958951,0.0013274788113958951,846,846,0,5,3,3,4,4,566,207,503
275,0,0,1,1,0,0,0,1,1,0,0.0,0.0,1,1,0,-1,-1,-1,8,0,508,898,426
276,0,206,1,934,933,0,36,1,377,376,0.0,3.4037918240920386e-05,1,385,384,3,-1,4,23,0,15,875,714
277,2,104,370,947,577,3,3,373,373,0,3.4037918240920386e-05,6.807583648184077e-05,396,444,48,4,5,5,2,2,618,560,710
278,710,812,999,999,0,168,168,999,999,0,0.019741992579733823,0.019980258007420267,993,994,1,4,2,2,6,98,526,23,468
279,0,206,1,957,956,0,25,1,457,456,0.0,0.0002042275094455223,1,566,565,3,-1,4,10,0,241,998,4
280,0,206,1,969,968,0,16,1,506,505,0.0,0.0002042275094455223,1,571,570,3,-1,4,4,0,736,974,541
281,113,319,943,987,44,32,32,915,915,0,0.002825147213996392,0.0053439531638245,926,961,35,3,3,3,2,20,972,38,111
282,34,34,727,727,0,52,52,724,724,0,0.0007488342013002485,0.0007488342013002485,774,774,0,-1,3,3,7,6,209,234,517
283,4,105,421,922,501,8,8,412,412,0,6.807583648184077e-05,6.807583648184077e-05,453,453,0,8,5,5,4,2,460,749,647
284,0,101,1,922,921,0,3,1,330,329,0.0,0.0,1,1,0,6,-1,7,3,0,620,821,357
285,20,226,646,965,319,78,78,789,789,0,0.00030634126416828345,0.0010211375472276116,640,799,159,3,3,3,8,4,225,545,120
286,2,208,364,975,611,5,10,396,500,104,0.00010211375472276115,0.0006807583648184077,487,771,284,3,5,4,3,1,826,879,189
287,0,0,1,1,0,0,0,1,1,0,0.0,0.0,1,1,0,-1,-1,-1,4,0,567,776,928
288,459,459,990,990,0,142,142,984,984,0,0.008713707069675619,0.008713707069675619,976,976,0,-1,2,2,8,70,521,18,902
289,8,110,595,963,368,5,5,444,444,0,0.0002042275094455223,0.0002723033459273631,579,625,46,4,5,5,3,6,918,683,655
290,1,617,330,998,668,4,30,330,730,400,0.0,0.004050512270669526,1,949,948,2,9,3,4,1,949,647,34
291,27,27,769,769,0,24,24,764,764,0,0.0005105687736138058,0.0005105687736138058,701,701,0,-1,3,3,3,8,912,477,740
292,0,0,1,1,0,0,0,1,1,0,0.0,0.0,1,1,0,-1,-1,-1,5,0,290,488,884
293,90,90,876,876,0,72,72,833,833,0,0.0019741992579733825,0.0019741992579733825,884,884,0,-1,3,3,7,15,273,53,367
294,6,6,465,465,0,11,11,475,475,0,3.4037918240920386e-05,3.4037918240920386e-05,404,404,0,-1,4,4,4,2,573,384,932
295,47,663,820,997,177,36,50,696,826,130,0.0005786446100956465,0.004629156880765172,737,953,216,2,3,3,5,11,537,52,102
296,0,0,1,1,0,0,0,1,1,0,0.0,0.0,1,1,0,-1,-1,-1,8,0,483,928,790
297,16,632,551,990,439,60,64,644,669,25,0.00037441710065012424,0.0024507301133462676,647,904,257,2,3,3,10,2,205,670,91
298,24,125,730,935,205,30,30,690,690,0,0.00034037918240920387,0.00034037918240920387,653,653,0,7,4,4,5,6,452,136,582
299,118,118,879,879,0,262,262,938,938,0,0.0016338200755641784,0.0016338200755641784,856,856,0,-1,2,2,19,8,89,174,998
300,16,16,525,525,0,60,60,501,501,0,6.807583648184077e-05,6.807583648184077e-05,441,441,0,-1,3,3,17,1,56,964,911
301,148,148,932,932,0,118,118,953,953,0,0.0028591851322373124,0.0028591851322373124,921,921,0,-1,3,3,8,20,380,94,980
302,113,214,923,970,47,84,84,960,960,0,0.003778208924742163,0.0038462847612240037,938,940,2,5,2,2,5,19,502,297,680
303,0,102,1,878,877,0,30,1,402,401,0.0,0.00037441710065012424,1,660,659,4,-1,5,16,0,78,803,291
304,0,616,1,993,992,0,52,1,646,645,0.0,0.0013615167296368155,1,832,831,2,-1,3,9,0,147,843,42
305,38,140,754,920,166,72,72,756,756,0,0.0010892133837094523,0.001157289220191293,817,824,7,4,3,3,10,3,241,382,534
306,0,102,1,941,940,0,8,1,455,454,0.0,0.00037441710065012424,1,662,661,4,-1,5,4,0,789,915,375
307,2,104,357,903,546,11,12,387,395,8,0.0,6.807583648184077e-05,1,455,454,4,5,5,7,1,497,606,383
308,2,104,377,943,566,4,4,424,424,0,6.807583648184077e-05,0.00017018959120460194,458,561,103,4,5,5,2,2,817,215,553
309,166,166,949,949,0,108,108,918,918,0,0.004186663943633207,0.004186663943633207,948,948,0,-1,3,3,8,31,225,126,992
310,1,103,332,939,607,3,6,332,453,121,0.0,0.0002382654276864427,1,602,601,4,6,5,3,3,888,484,323
311,0,0,1,1,0,0,0,1,1,0,0.0,0.0,1,1,0,-1,-1,-1,5,1,528,852,522
312,0,102,1,875,874,0,28,1,369,368,0.0,0.00013615167296368154,1,510,509,4,-1,5,21,3,25,753,625
313,7,109,534,944,410,6,6,420,420,0,0.00013615167296368154,0.00030634126416828345,514,631,117,4,5,5,3,5,903,487,229
314,41,247,848,983,135,24,24,822,822,0,0.0008169100377820892,0.0011913271384322134,780,828,48,3,3,3,3,11,796,97,280
315,0,616,1,991,990,0,72,1,626,625,0.0,0.0018380475850097008,1,876,875,2,-1,3,13,1,97,828,153
316,77,283,840,973,133,112,112,831,831,0,0.0010211375472276116,0.002110350930937064,798,885,87,3,3,3,12,13,194,120,185
317,2,103,371,945,574,3,3,374,374,0,3.4037918240920386e-05,3.4037918240920386e-05,418,418,0,6,5,5,2,1,802,592,402
318,9,111,527,911,384,15,16,404,418,14,6.807583648184077e-05,0.0002382654276864427,444,576,132,4,5,5,8,5,302,274,263
319,4,210,464,981,517,3,8,377,521,144,0.0,0.0010892133837094523,1,829,828,3,5,4,2,3,957,441,137
320,0,1640,1,1000,999,0,194,1,842,841,0.0,0.010994247591817285,1,982,981,1,-1,2,20,1,61,706,12
321,12,218,581,972,391,12,16,490,549,59,0.0004765308553728854,0.0009870996289866913,699,811,112,3,4,4,4,5,562,252,289
322,1,102,331,964,633,2,2,331,331,0,0.0,0.0,1,1,0,7,6,6,2,3,865,578,671
323,0,102,1,917,916,0,6,1,370,369,0.0,6.807583648184077e-05,1,446,445,4,-1,5,4,0,445,908,631
324,1,103,332,948,616,3,6,332,455,123,0.0,0.0006807583648184077,1,770,769,4,6,5,3,2,608,331,352
325,22,22,613,613,0,114,114,741,741,0,0.0007147962830593281,0.0007147962830593281,747,747,0,-1,3,3,14,4,127,143,998
326,0,206,1,984,983,0,10,1,654,653,0.0,0.0057524081827155455,1,963,962,3,-1,4,3,0,877,907,184
327,2,103,369,925,556,6,6,412,412,0,6.807583648184077e-05,0.00010211375472276115,452,490,38,5,5,5,3,1,636,931,870
328,189,291,947,972,25,138,138,945,945,0,0.002825147213996392,0.0028932230504782326,920,922,2,4,2,2,9,24,123,129,561
329,0,101,1,944,943,0,3,1,331,330,0.0,0.00010211375472276115,1,489,488,5,-1,6,3,0,867,793,302
330,0,0,1,1,0,0,0,1,1,0,0.0,0.0,1,1,0,-1,-1,-1,4,0,740,651,539
331,0,206,1,963,962,0,28,1,524,523,0.0,0.0006126825283365669,1,731,730,3,-1,4,8,0,454,324,219
332,0,0,1,1,0,0,0,1,1,0,0.0,0.0,1,1,0,-1,-1,-1,7,0,343,446,456
333,2,2,389,389,0,3,3,397,397,0,6.807583648184077e-05,6.807583648184077e-05,451,451,0,-1,5,5,2,1,751,530,766
334,0,206,1,949,948,0,29,1,409,408,0.0,0.0002042275094455223,1,561,560,3,-1,4,14,0,79,887,617
335,174,275,942,967,25,142,142,901,901,0,0.002552843868069029,0.002552843868069029,914,914,0,6,2,2,13,24,160,129,656
336,0,102,1,911,910,0,11,1,408,407,0.0,0.00010211375472276115,1,487,486,4,-1,5,6,0,266,740,286
337,0,101,1,894,893,0,10,1,332,331,0.0,6.807583648184077e-05,1,447,446,5,-1,6,10,0,152,803,690
338,14,14,570,570,0,40,40,584,584,0,0.00034037918240920387,0.00034037918240920387,652,652,0,-1,4,4,8,5,428,688,787
339,6,108,438,919,481,18,18,574,574,0,0.00013615167296368154,0.00030634126416828345,516,641,125,4,4,4,3,1,459,904,519
340,2,104,372,944,572,6,6,451,451,0,0.00013615167296368154,0.0002042275094455223,524,585,61,4,5,5,3,2,674,550,661
341,68,169,883,968,85,22,22,784,784,0,0.0014636304843595766,0.0014636304843595766,866,866,0,5,3,3,2,18,750,64,337
342,224,326,952,974,22,170,170,901,901,0,0.0026549576227917903,0.0026889955410327104,904,906,2,4,3,3,15,30,124,65,220
343,0,101,1,878,877,0,12,1,332,331,0.0,0.0,1,1,0,5,-1,6,12,0,183,867,739
344,1,103,333,891,558,11,12,333,355,22,0.0,0.0,1,1,0,4,7,5,11,3,155,626,495
345,15,117,622,934,312,16,16,514,514,0,0.00013615167296368154,0.0007488342013002485,520,773,253,4,4,4,4,4,758,208,470
346,0,0,1,1,0,0,0,1,1,0,0.0,0.0,1,1,0,-1,-1,-1,12,0,348,790,895
347,6,6,413,413,0,34,34,572,572,0,0.0004765308553728854,0.0004765308553728854,693,693,0,-1,4,4,7,1,193,500,624
348,0,206,1,973,972,0,14,1,551,550,0.0,0.0006126825283365669,1,746,745,3,-1,4,4,0,573,804,186
349,0,0,1,1,0,0,0,1,1,0,0.0,0.0,1,1,0,-1,-1,-1,13,0,115,433,254
350,0,206,1,974,973,0,14,1,562,561,0.0,0.0014295925661186562,1,854,853,3,-1,4,3,0,829,632,255
351,0,206,1,931,930,0,46,1,410,409,0.0,0.0002042275094455223,1,561,560,3,-1,4,20,0,5,823,162
352,0,0,1,1,0,0,0,1,1,0,0.0,0.0,1,1,0,-1,-1,-1,2,0,987,436,852
353,33,134,766,941,175,26,26,628,628,0,0.0005786446100956465,0.0007147962830593281,728,767,39,5,4,4,5,9,502,294,230
354,18,224,678,975,297,16,16,573,573,0,0.0002382654276864427,0.002825147213996392,606,923,317,3,4,4,4,6,573,683,57
355,0,206,1,953,952,0,30,1,474,473,0.0,0.00034037918240920387,1,655,654,3,-1,4,9,0,213,940,404
356,23,23,623,623,0,77,77,592,592,0,0.00034037918240920387,0.00034037918240920387,629,629,0,-1,3,3,16,4,134,278,806
357,0,0,1,1,0,0,0,1,1,0,0.0,0.0,1,1,0,-1,-1,-1,5,1,519,767,965
358,100,100,892,892,0,100,100,925,925,0,0.02719629667449539,0.02719629667449539,996,996,0,-1,1,1,7,29,320,142,864
359,2,2,363,363,0,5,5,365,365,0,6.807583648184077e-05,6.807583648184077e-05,443,443,0,-1,5,5,4,1,655,837,436
360,2,2,361,361,0,9,9,378,378,0,0.0,0.0,1,1,0,-1,5,5,6,1,328,734,846
361,8,109,467,872,405,60,60,511,511,0,0.00010211375472276115,0.00013615167296368154,480,508,28,5,4,4,16,3,117,441,694
362,14,115,699,964,265,14,14,644,644,0,0.000442492937131965,0.0005105687736138058,685,712,27,5,4,4,3,5,922,221,654
363,2,104,373,936,563,5,6,403,440,37,0.0,0.0018380475850097008,1,885,884,4,5,5,3,1,716,807,69
364,100,100,877,877,0,100,100,888,888,0,0.01681473161101467,0.01681473161101467,990,990,0,-1,1,1,9,6,200,447,996
365,0,206,1,965,964,0,16,1,451,450,0.0,0.0007828721195411688,1,766,765,3,-1,4,6,2,441,752,97
366,0,101,1,913,912,0,8,1,331,330,0.0,0.0,1,1,0,5,-1,6,8,0,468,915,692
367,51,153,870,969,99,12,12,625,625,0,0.0010211375472276116,0.001055175465468532,814,817,3,4,4,4,2,19,960,184,238
368,14,220,537,956,419,66,66,572,572,0,0.0002042275094455223,0.00030634126416828345,563,630,67,3,4,4,15,4,138,230,339
369,6,6,434,434,0,16,16,507,507,0,3.4037918240920386e-05,3.4037918240920386e-05,404,404,0,-1,4,4,5,2,476,575,660
370,19,19,620,620,0,40,40,570,570,0,0.00034037918240920387,0.00034037918240920387,637,637,0,-1,4,4,10,5,437,591,969
371,36,242,704,960,256,96,96,765,765,0,0.0012934408931549745,0.001497668402600497,832,853,21,3,3,3,11,6,66,114,384
372,0,206,1,940,939,0,70,1,512,511,0.0,0.0011232513019503727,1,807,806,3,-1,4,19,0,48,991,129
373,25,25,600,600,0,68,68,457,457,0,0.00013615167296368154,0.00013615167296368154,503,503,0,-1,4,4,22,5,18,274,569
374,16,222,491,944,453,150,150,743,743,0,0.00034037918240920387,0.0008509479560230097,636,768,132,3,3,3,19,2,19,493,97
375,2,104,360,916,556,6,7,375,394,19,3.4037918240920386e-05,6.807583648184077e-05,404,448,44,4,5,5,4,3,711,578,662
376,6,108,503,957,454,8,8,555,555,0,0.00010211375472276115,0.0005105687736138058,502,722,220,4,4,4,2,1,806,756,438
377,30,30,654,654,0,76,76,582,582,0,0.0007488342013002485,0.0007488342013002485,755,755,0,-1,4,4,16,8,132,521,967
378,30,646,659,991,332,74,156,558,824,266,0.000442492937131965,0.006569318220497634,677,967,290,2,3,3,16,5,59,124,6
379,5,106,537,966,429,3,3,413,413,0,0.00013615167296368154,0.00013615167296368154,532,532,0,6,5,5,2,3,987,485,140
380,12,113,645,953,308,12,12,715,715,0,0.0002723033459273631,0.00030634126416828345,633,651,18,6,4,4,2,2,684,791,656
381,0,101,1,929,928,0,4,1,332,331,0.0,3.4037918240920386e-05,1,393,392,5,-1,6,4,1,563,920,509
382,16,16,622,622,0,10,10,469,469,0,0.00030634126416828345,0.00030634126416828345,634,634,0,-1,4,4,3,7,471,115,746
383,27,129,638,887,249,84,84,547,547,0,0.0002042275094455223,0.0002042275094455223,569,569,0,4,4,4,20,6,88,229,225
384,9,110,466,867,401,114,114,620,620,0,3.4037918240920386e-05,3.4037918240920386e-05,400,400,0,8,4,4,23,3,57,508,647
385,161,161,969,969,0,32,32,899,899,0,0.004629156880765172,0.004629156880765172,955,955,0,-1,3,3,2,27,653,25,975
386,0,0,1,1,0,0,0,1,1,0,0.0,0.0,1,1,0,-1,-1,-1,4,0,777,614,768
387,0,0,1,1,0,0,0,1,1,0,0.0,0.0,1,1,0,-1,-1,-1,3,1,774,830,892
388,39,141,830,961,131,12,12,608,608,0,0.001497668402600497,0.001599782157323258,864,873,9,4,4,4,2,13,924,261,286
389,10,216,597,976,379,10,14,505,596,91,0.00017018959120460194,0.001157289220191293,549,831,282,3,4,4,3,3,774,596,184
390,0,0,1,1,0,0,0,1,1,0,0.0,0.0,1,1,0,-1,-1,-1,3,0,839,826,874
391,12,12,613,613,0,8,8,500,500,0,0.00013615167296368154,0.00013615167296368154,521,521,0,-1,4,4,2,5,880,350,984
392,6,107,441,926,485,16,16,524,524,0,0.00010211375472276115,0.00013615167296368154,485,520,35,5,4,4,4,2,559,785,265
393,64,165,896,972,76,28,28,846,846,0,0.0018380475850097008,0.0019061234214915416,884,888,4,5,3,3,3,16,854,78,592
394,23,125,689,929,240,38,38,694,694,0,0.0006126825283365669,0.00088498587426393,735,780,45,4,3,3,6,7,518,170,637
395,57,57,855,855,0,22,22,711,711,0,0.0012934408931549745,0.0012934408931549745,846,846,0,-1,3,3,2,13,859,335,813
396,0,101,1,942,941,0,2,1,331,330,0.0,0.00010211375472276115,1,501,500,5,-1,6,2,3,983,854,420
397,18,224,678,973,295,24,24,690,690,0,0.0014636304843595766,0.002212464685659825,852,895,43,3,4,4,4,5,403,393,179
398,0,0,1,1,0,0,0,1,1,0,0.0,0.0,1,1,0,-1,-1,-1,2,1,820,780,359
399,0,206,1,948,947,0,40,1,483,482,0.0,0.0006126825283365669,1,724,723,3,-1,4,12,1,116,962,535
400,8,8,530,530,0,18,18,516,516,0,0.0002042275094455223,0.0002042275094455223,578,578,0,-1,4,4,5,2,363,524,780
401,1,1,333,333,0,14,14,333,333,0,3.4037918240920386e-05,3.4037918240920386e-05,407,407,0,-1,6,6,14,3,144,708,996
402,51,153,836,952,116,34,34,778,778,0,0.0006467204465774873,0.0006467204465774873,740,740,0,4,3,3,4,10,783,366,503
403,0,102,1,966,965,0,4,1,394,393,0.0,0.00013615167296368154,1,526,525,4,-1,5,3,0,853,624,465
404,11,11,643,643,0,9,9,526,526,0,0.0002382654276864427,0.0002382654276864427,603,603,0,-1,4,4,3,4,600,380,359
405,0,102,1,897,896,0,12,1,384,383,0.0,0.00017018959120460194,1,548,547,4,-1,5,8,3,449,746,284
406,2,2,356,356,0,7,7,357,357,0,0.0,0.0,1,1,0,-1,5,5,6,2,378,357,773
407,30,30,754,754,0,28,28,722,722,0,0.00030634126416828345,0.00030634126416828345,638,638,0,-1,3,3,3,6,613,381,533
408,6,6,391,391,0,38,38,461,461,0,0.0002042275094455223,0.0002042275094455223,565,565,0,-1,4,4,13,1,41,481,729
409,10,111,672,969,297,8,8,609,609,0,0.00037441710065012424,0.00037441710065012424,685,685,0,5,4,4,2,4,873,233,837
410,6,107,445,917,472,14,14,468,468,0,0.0,3.4037918240920386e-05,1,403,402,5,4,4,5,1,314,935,771
411,100,100,948,948,0,100,100,997,997,0,0.05085264985193506,0.0549372000408455,1000,1000,0,3,1,1,3,2,918,292,5
412,16,118,668,945,277,28,28,794,794,0,0.00013615167296368154,0.00013615167296368154,526,526,0,4,3,3,3,1,729,655,577
413,36,138,826,958,132,22,22,784,784,0,0.0011913271384322134,0.0011913271384322134,839,839,0,4,3,3,2,8,596,345,434
414,0,616,1,998,997,0,30,1,772,771,0.0,0.006739507811702236,1,970,969,2,-1,3,4,0,597,927,111
415,0,102,1,883,882,0,13,1,351,350,0.0,0.00010211375472276115,1,484,483,4,-1,5,12,0,252,988,279
416,200,302,945,967,22,186,186,876,876,0,0.0020422750944552232,0.002110350930937064,881,889,8,4,2,2,17,20,39,109,152
417,0,0,1,1,0,0,0,1,1,0,0.0,0.0,1,1,0,-1,-1,-1,5,0,386,776,900
418,0,102,1,879,878,0,21,1,364,363,0.0,0.00017018959120460194,1,533,532,4,-1,5,18,0,29,624,208
419,6,6,628,628,0,4,4,561,561,0,0.0004084550188910446,0.0004084550188910446,696,696,0,-1,5,5,2,7,955,224,941
420,6,108,399,895,496,32,32,522,522,0,3.4037918240920386e-05,6.807583648184077e-05,396,441,45,4,4,4,9,2,414,654,842
421,8,8,513,513,0,14,14,457,457,0,0.00017018959120460194,0.00017018959120460194,526,526,0,-1,4,4,5,5,173,231,821
422,0,102,1,967,966,0,3,1,396,395,0.0,0.00030634126416828345,1,654,653,4,-1,5,2,0,933,838,315
423,0,0,1,1,0,0,0,1,1,0,0.0,0.0,1,1,0,-1,-1,-1,3,0,568,702,945
424,22,22,813,813,0,14,14,736,736,0,0.0007828721195411688,0.0007828721195411688,790,790,0,-1,4,4,3,11,812,83,730
425,10,112,647,961,314,14,14,669,669,0,0.0002382654276864427,0.00034037918240920387,621,670,49,4,4,4,3,5,883,454,609
426,0,206,1,948,947,0,37,1,456,455,0.0,0.0005105687736138058,1,689,688,3,-1,4,15,0,110,778,175
427,109,211,912,969,57,50,50,850,850,0,0.001497668402600497,0.001497668402600497,856,856,0,4,3,3,5,18,519,54,724
428,0,0,1,1,0,0,0,1,1,0,0.0,0.0,1,1,0,-1,-1,-1,11,0,167,783,815
429,2,2,388,388,0,4,4,446,446,0,3.4037918240920386e-05,3.4037918240920386e-05,407,407,0,-1,5,5,2,2,985,384,758
430,0,101,1,970,969,0,2,1,330,329,0.0,0.00013615167296368154,1,519,518,5,-1,6,2,0,920,200,314
431,9,9,649,649,0,8,8,604,604,0,0.0007828721195411688,0.0007828721195411688,792,792,0,-1,4,4,2,3,810,390,890
432,541,643,992,996,4,200,200,994,994,0,0.013410939786922631,0.013513053541645392,986,987,1,4,2,2,8,78,225,9,532
433,30,30,737,737,0,42,42,710,710,0,0.00037441710065012424,0.00037441710065012424,668,668,0,-1,3,3,6,4,387,315,928
434,0,206,1,971,970,0,8,1,438,437,0.0,0.000442492937131965,1,693,692,3,-1,4,2,0,893,945,327
435,0,102,1,922,921,0,4,1,363,362,0.0,0.00013615167296368154,1,534,533,4,-1,5,3,1,672,693,424
436,99,305,918,984,66,48,48,918,918,0,0.002484768031587188,0.002995336805200994,909,928,19,3,3,3,3,18,869,55,293
437,3,209,414,968,554,12,24,430,544,114,0.0002042275094455223,0.001157289220191293,573,827,254,3,5,4,6,2,266,566,185
438,22,22,720,720,0,46,46,804,804,0,0.0007828721195411688,0.0007828721195411688,775,775,0,-1,3,3,6,4,661,143,802
439,0,0,1,1,0,0,0,1,1,0,0.0,0.0,1,1,0,-1,-1,-1,2,0,977,923,604
440,66,66,900,900,0,30,30,847,847,0,0.001599782157323258,0.001599782157323258,857,857,0,-1,3,3,4,12,480,179,849
441,6,1646,411,1000,589,32,74,500,758,258,6.807583648184077e-05,0.010687906327649,440,981,541,1,4,2,10,2,258,384,99
442,8,109,620,969,349,8,8,609,609,0,0.0002042275094455223,0.00034037918240920387,584,668,84,5,4,4,2,2,873,700,584
443,18,120,663,931,268,32,32,727,727,0,0.00010211375472276115,0.00030634126416828345,495,644,149,4,3,3,5,3,314,434,670
444,12,218,615,976,361,8,8,482,482,0,0.0002382654276864427,0.0006467204465774873,596,747,151,3,4,4,2,5,429,562,465
445,0,0,1,1,0,0,0,1,1,0,0.0,0.0,1,1,0,-1,-1,-1,3,0,829,845,864
446,28,129,733,938,205,22,22,707,707,0,0.0006467204465774873,0.0006467204465774873,741,741,0,5,3,3,2,5,769,221,764
447,0,0,1,1,0,0,0,1,1,0,0.0,0.0,1,1,0,-1,-1,-1,10,0,105,982,926
448,0,206,1,968,967,0,10,1,441,440,0.0,0.0002042275094455223,1,575,574,3,-1,4,4,0,444,783,447
449,7,7,438,438,0,64,64,397,397,0,0.0,0.0,1,1,0,-1,4,4,35,3,20,563,938
450,6,622,400,993,593,25,48,459,622,163,0.0002382654276864427,0.002314578440382586,592,890,298,2,4,3,9,1,178,481,255
451,112,213,953,981,28,22,22,843,843,0,0.003369753905851118,0.003437829742332959,934,934,0,5,3,3,2,28,841,41,683
452,0,102,1,949,948,0,4,1,382,381,0.0,0.00013615167296368154,1,521,520,4,-1,5,3,1,569,706,286
453,21,227,678,973,295,24,24,605,605,0,0.0007488342013002485,0.0008509479560230097,768,788,20,3,4,4,4,5,671,216,447
454,2,2,345,345,0,36,36,350,350,0,0.0,0.0,1,1,0,-1,5,5,33,1,9,671,522
455,0,0,1,1,0,0,0,1,1,0,0.0,0.0,1,1,0,-1,-1,-1,5,0,517,675,826
456,6,622,525,1000,475,4,18,446,855,409,0.00017018959120460194,0.003948398515946765,556,950,394,2,5,3,2,4,666,645,347
457,22,228,762,980,218,22,22,825,825,0,0.0007488342013002485,0.0012253650566731338,774,843,69,3,3,3,2,5,817,412,268
458,0,616,1,1000,999,0,22,1,863,862,0.0,0.01147077844719017,1,985,984,2,-1,3,2,1,878,568,23
459,0,0,1,1,0,0,0,1,1,0,0.0,0.0,1,1,0,-1,-1,-1,2,0,962,644,228
460,0,206,1,982,981,0,12,1,657,656,0.0,0.001055175465468532,1,828,827,3,-1,4,2,0,897,367,289
461,1,207,332,984,652,2,12,332,682,350,0.0,0.004765308553728854,1,957,956,3,6,4,2,3,965,708,21
462,46,46,768,768,0,94,94,723,723,0,0.0009190237925048504,0.0009190237925048504,789,789,0,-1,3,3,14,6,79,461,902
463,15,117,716,964,248,18,18,742,742,0,0.000442492937131965,0.0011913271384322134,685,834,149,4,4,4,3,6,922,199,185
464,0,0,1,1,0,0,0,1,1,0,0.0,0.0,1,1,0,-1,-1,-1,12,0,375,865,772
465,0,206,1,987,986,0,12,1,754,753,0.0,0.004356853534837809,1,958,957,3,-1,4,2,0,987,324,17
466,6,6,422,422,0,32,32,519,519,0,0.00010211375472276115,0.00010211375472276115,490,490,0,-1,4,4,8,1,225,797,546
467,23,125,692,923,231,24,24,590,590,0,0.00034037918240920387,0.0004765308553728854,651,709,58,4,4,4,4,7,493,329,419
468,1,1,333,333,0,8,8,333,333,0,0.0,0.0,1,1,0,-1,6,6,8,1,260,671,961
469,26,127,814,966,152,12,12,637,637,0,0.0004084550188910446,0.0005446066918547262,698,738,40,5,4,4,2,10,913,195,290
470,62,62,906,906,0,22,22,909,909,0,0.0057524081827155455,0.0057524081827155455,962,962,0,-1,3,3,2,15,821,92,890
471,56,56,803,803,0,66,66,678,678,0,0.001055175465468532,0.001055175465468532,810,810,0,-1,3,3,10,12,310,67,675
472,0,102,1,940,939,0,4,1,365,364,0.0,0.0002042275094455223,1,582,581,4,-1,5,3,0,879,817,683
473,0,0,1,1,0,0,0,1,1,0,0.0,0.0,1,1,0,-1,-1,-1,9,1,262,806,852
474,160,160,963,963,0,44,44,856,856,0,0.0032336022328874367,0.0032336022328874367,938,938,0,-1,3,3,4,38,735,111,902
475,180,796,942,998,56,164,164,965,965,0,0.003778208924742163,0.0057524081827155455,940,965,25,2,2,2,10,19,75,133,122
476,6,6,438,438,0,13,13,396,396,0,6.807583648184077e-05,6.807583648184077e-05,460,460,0,-1,4,4,8,1,449,924,914
477,0,0,1,1,0,0,0,1,1,0,0.0,0.0,1,1,0,-1,-1,-1,12,1,226,738,800
478,96,198,894,965,71,56,56,822,822,0,0.0012253650566731338,0.0016678579938050988,834,864,30,4,3,3,6,18,451,82,336
479,18,224,633,968,335,24,24,609,609,0,0.0005786446100956465,0.0006807583648184077,734,755,21,3,4,4,4,6,300,247,655
480,0,0,1,1,0,0,0,1,1,0,0.0,0.0,1,1,0,-1,-1,-1,4,0,553,877,745
481,6,6,410,410,0,24,24,441,441,0,3.4037918240920386e-05,3.4037918240920386e-05,393,393,0,-1,4,4,9,1,192,265,984
482,41,143,810,946,136,34,34,763,763,0,0.0010892133837094523,0.0014636304843595766,819,858,39,4,3,3,4,9,969,293,46
483,0,206,1,946,945,0,29,1,406,405,0.0,0.0002382654276864427,1,575,574,3,-1,4,13,0,92,821,354
484,26,26,751,751,0,40,40,767,767,0,0.0010211375472276116,0.0010211375472276116,823,823,0,-1,3,3,5,4,314,207,828
485,72,174,892,970,78,28,28,805,805,0,0.0019061234214915416,0.002110350930937064,885,894,9,4,3,3,3,17,844,45,809
486,15,221,622,972,350,20,20,575,575,0,0.0004765308553728854,0.0028591851322373124,700,921,221,3,4,4,4,6,758,432,142
487,160,160,953,953,0,108,108,993,993,0,0.009020048333843901,0.009020048333843901,981,981,0,-1,2,2,5,22,338,128,963
488,6,212,371,940,569,72,82,452,480,28,0.0,0.0002042275094455223,1,543,542,3,4,4,23,3,15,321,263
489,18,18,566,566,0,87,87,557,557,0,0.00013615167296368154,0.00013615167296368154,517,517,0,-1,3,3,21,3,2,434,728
490,0,102,1,960,959,0,3,1,395,394,0.0,0.0002382654276864427,1,607,606,4,-1,5,2,0,847,620,301
491,0,206,1,970,969,0,16,1,516,515,0.0,0.0006807583648184077,1,772,771,3,-1,4,4,1,652,852,103
492,0,102,1,899,898,0,10,1,368,367,0.0,6.807583648184077e-05,1,440,439,4,-1,5,7,0,366,932,229
493,23,229,716,972,256,20,20,575,575,0,0.00030634126416828345,0.0006126825283365669,635,742,107,3,4,4,4,9,758,191,617
494,0,102,1,930,929,0,10,1,438,437,0.0,0.0013615167296368155,1,850,849,4,-1,5,5,0,663,672,38
495,1,1,332,332,0,3,3,332,332,0,0.0,0.0,1,1,0,-1,7,7,3,2,798,721,898
496,0,616,1,986,985,0,134,1,661,660,0.0,0.002144388849177984,1,881,880,2,-1,3,23,1,43,789,133
497,22,638,682,997,315,38,56,722,862,140,0.00017018959120460194,0.010211375472276116,545,983,438,2,3,3,6,3,575,263,3
498,0,102,1,896,895,0,12,1,410,409,0.0,0.00013615167296368154,1,507,506,4,-1,5,6,0,393,600,609
499,36,138,762,932,170,52,52,730,730,0,0.0004765308553728854,0.0005446066918547262,691,708,17,4,3,3,7,7,450,253,659
500,2,618,367,999,632,4,22,416,805,389,0.0,0.005548180673270023,1,965,964,2,5,3,2,2,993,509,56
501,6,108,461,932,471,11,12,474,489,15,6.807583648184077e-05,0.0009190237925048504,440,807,367,4,4,4,4,1,563,840,190
502,2,104,357,906,549,14,14,415,415,0,0.00013615167296368154,0.00013615167296368154,510,510,0,4,5,5,7,2,637,419,369
503,2,104,355,916,561,5,5,355,355,0,0.0,3.4037918240920386e-05,1,400,399,4,5,5,4,3,694,748,121
504,6,6,467,467,0,8,8,475,475,0,0.00017018959120460194,0.00017018959120460194,546,546,0,-1,4,4,3,2,912,292,940
505,0,0,1,1,0,0,0,1,1,0,0.0,0.0,1,1,0,-1,-1,-1,10,1,99,949,565
506,58,160,804,929,125,110,110,839,839,0,0.0012594029749140542,0.0014636304843595766,827,846,19,4,2,2,11,5,279,338,176
507,18,120,637,929,292,30,30,631,631,0,0.0008169100377820892,0.00088498587426393,777,791,14,4,3,3,6,2,515,524,286
508,1,103,330,971,641,2,3,330,401,71,3.4037918240920386e-05,0.00037441710065012424,406,679,273,4,6,5,2,1,898,437,178
509,0,0,1,1,0,0,0,1,1,0,0.0,0.0,1,1,0,-1,-1,-1,2,0,898,699,698
510,70,171,897,972,75,22,22,820,820,0,0.0017018959120460194,0.0017359338302869397,879,885,6,6,3,3,2,17,896,96,357
511,576,576,993,993,0,222,222,992,992,0,0.010824058000612683,0.010824058000612683,983,983,0,-1,2,2,10,75,128,24,808
512,30,30,662,662,0,82,82,605,605,0,0.0008169100377820892,0.0008169100377820892,776,776,0,-1,4,4,15,6,37,46,517
513,25,231,718,971,253,40,44,826,843,17,0.0010211375472276116,0.0018380475850097008,816,884,68,3,3,3,4,4,711,312,97
514,50,50,863,863,0,12,12,631,631,0,0.0011913271384322134,0.0011913271384322134,836,836,0,-1,4,4,2,20,894,87,790
515,0,206,1,950,949,0,23,1,421,420,0.0,0.0004765308553728854,1,689,688,3,-1,4,10,0,310,944,387
516,18,18,609,609,0,43,43,575,575,0,0.0002042275094455223,0.0002042275094455223,567,567,0,-1,3,3,9,5,287,476,792
517,0,102,1,897,896,0,14,1,394,393,0.0,0.00013615167296368154,1,508,507,4,-1,5,9,0,168,701,173
518,35,35,782,782,0,36,36,715,715,0,0.00034037918240920387,0.00034037918240920387,663,663,0,-1,3,3,5,7,677,176,733
519,39,39,811,811,0,34,34,790,790,0,0.0013955546478777359,0.0013955546478777359,844,844,0,-1,3,3,4,14,660,190,828
520,4,105,443,935,492,6,6,425,425,0,0.0,0.00010211375472276115,1,494,493,5,5,5,3,3,844,585,401
521,58,264,855,977,122,30,30,668,668,0,0.001157289220191293,0.0027911092957554717,831,919,88,3,4,4,5,15,386,92,297
522,2,2,364,364,0,5,5,396,396,0,0.00010211375472276115,0.00010211375472276115,487,487,0,-1,5,5,3,1,826,879,515
523,100,100,857,857,0,100,100,684,684,0,0.029034344259505088,0.029034344259505088,1000,1000,0,6,1,1,16,130,195,3,861
524,2,2,365,365,0,3,3,367,367,0,3.4037918240920386e-05,3.4037918240920386e-05,406,406,0,-1,5,5,2,2,932,692,472
525,0,616,1,993,992,0,58,1,603,602,0.0,0.0013955546478777359,1,844,843,2,-1,3,11,1,230,948,169
526,0,101,1,921,920,0,5,1,332,331,0.0,0.0,1,1,0,6,-1,7,5,0,612,808,543
527,466,466,994,994,0,102,102,999,999,0,0.013989584397018279,0.013989584397018279,991,991,0,-1,2,2,4,85,520,0,894
528,38,244,771,973,202,46,46,733,733,0,0.0007147962830593281,0.005037611899656217,753,956,203,3,3,3,6,5,341,221,5
529,70,276,773,957,184,256,256,773,773,0,0.0007828721195411688,0.0009870996289866913,754,789,35,3,2,2,35,6,20,494,891
530,6,212,405,961,556,42,42,630,630,0,0.0002382654276864427,0.0006807583648184077,588,752,164,3,4,4,7,1,246,741,80
531,0,0,1,1,0,0,0,1,1,0,0.0,0.0,1,1,0,-1,-1,-1,6,0,345,981,520
532,40,142,762,926,164,52,52,708,708,0,0.0006467204465774873,0.0006467204465774873,748,748,0,4,3,3,7,10,372,272,373
533,0,102,1,926,925,0,5,1,364,363,0.0,6.807583648184077e-05,1,447,446,4,-1,5,4,0,682,429,279
534,0,206,1,942,941,0,30,1,410,409,0.0,0.00013615167296368154,1,510,509,3,-1,4,14,0,85,981,689
535,34,34,756,756,0,40,40,743,743,0,0.0006126825283365669,0.0006126825283365669,746,746,0,-1,3,3,5,4,537,40,916
536,0,101,1,945,944,0,3,1,332,331,0.0,0.0,1,1,0,5,-1,6,3,0,535,778,530
537,5,5,406,406,0,14,14,393,393,0,0.0,0.0,1,1,0,-1,5,5,8,3,499,411,979
538,12,12,527,527,0,22,22,469,469,0,6.807583648184077e-05,6.807583648184077e-05,450,450,0,-1,4,4,7,2,447,791,699
539,0,206,1,981,980,0,8,1,543,542,0.0,0.0010892133837094523,1,831,830,3,-1,4,2,1,781,767,284
540,26,26,735,735,0,24,24,651,651,0,0.0004765308553728854,0.0004765308553728854,706,706,0,-1,4,4,4,6,736,494,984
541,31,132,727,932,205,40,40,698,698,0,0.0005446066918547262,0.0005446066918547262,712,712,0,5,3,3,5,8,349,417,140
542,0,102,1,881,880,0,21,1,389,388,0.0,0.00010211375472276115,1,475,474,4,-1,5,12,0,62,433,86
543,0,0,1,1,0,0,0,1,1,0,0.0,0.0,1,1,0,-1,-1,-1,5,1,537,660,668
544,150,251,974,992,18,22,22,887,887,0,0.005684332346233704,0.005684332346233704,965,965,0,5,3,3,2,31,995,34,292
545,130,746,929,997,68,82,82,900,900,0,0.002280540522141666,0.00353994349705572,904,936,32,2,3,3,7,18,196,141,345
546,0,0,1,1,0,0,0,1,1,0,0.0,0.0,1,1,0,-1,-1,-1,19,0,14,876,915
547,0,206,1,942,941,0,38,1,423,422,0.0,0.0002382654276864427,1,587,586,3,-1,4,16,0,117,564,467
548,16,16,546,546,0,37,37,519,519,0,0.00013615167296368154,0.00013615167296368154,509,509,0,-1,3,3,10,1,135,334,571
549,8,8,506,506,0,16,16,510,510,0,0.0002382654276864427,0.0002382654276864427,590,590,0,-1,4,4,4,3,391,290,848
550,18,224,571,951,380,106,106,677,677,0,0.00017018959120460194,0.00034037918240920387,537,638,101,3,3,3,17,3,71,300,385
551,97,303,882,975,93,94,94,836,836,0,0.0014636304843595766,0.0017018959120460194,851,869,18,3,3,3,9,14,136,146,628
552,79,180,899,969,70,12,12,604,604,0,0.002280540522141666,0.002280540522141666,902,902,0,9,4,4,2,20,589,94,647
553,0,101,1,902,901,0,5,1,332,331,0.0,3.4037918240920386e-05,1,395,394,5,-1,6,5,0,377,909,460
554,9,215,609,982,373,10,14,538,639,101,0.00017018959120460194,0.0015317063208414173,544,863,319,3,4,4,3,3,576,458,151
555,8,214,502,964,462,13,22,427,526,99,0.00010211375472276115,0.00037441710065012424,479,653,174,3,4,4,5,5,546,401,525
556,55,55,832,832,0,40,40,725,725,0,0.0009530617107457708,0.0009530617107457708,803,803,0,-1,3,3,5,14,793,175,712
557,107,107,923,923,0,44,44,838,838,0,0.0022465026039007454,0.0022465026039007454,894,894,0,-1,3,3,4,25,675,47,712
558,0,102,1,936,935,0,4,1,371,370,0.0,6.807583648184077e-05,1,446,445,4,-1,5,3,0,961,675,528
559,0,616,1,999,998,0,22,1,797,796,0.0,0.009122162088566664,1,978,977,2,-1,3,2,0,881,629,13
560,171,272,969,982,13,38,38,863,863,0,0.003267640151128357,0.003267640151128357,927,927,0,5,3,3,3,38,577,111,466
561,8,109,569,948,379,8,8,522,522,0,0.0002042275094455223,0.0002382654276864427,579,603,24,5,4,4,2,3,723,354,463
562,116,218,914,969,55,108,108,954,954,0,0.002484768031587188,0.0030634126416828346,899,917,18,4,3,3,8,20,449,95,240
563,16,16,601,601,0,32,32,684,684,0,0.0002042275094455223,0.0002042275094455223,570,570,0,-1,3,3,5,1,377,607,858
564,0,102,1,908,907,0,6,1,391,390,0.0,3.4037918240920386e-05,1,397,396,4,-1,5,3,3,837,753,384
565,6,6,429,429,0,14,14,460,460,0,3.4037918240920386e-05,3.4037918240920386e-05,414,414,0,-1,4,4,5,1,479,531,949
566,0,0,1,1,0,0,0,1,1,0,0.0,0.0,1,1,0,-1,-1,-1,7,0,404,915,774
567,46,148,749,919,170,90,90,663,663,0,0.0008169100377820892,0.0009530617107457708,775,794,19,4,3,3,14,8,154,250,653
568,6,212,489,979,490,11,11,527,527,0,0.00017018959120460194,0.00037441710065012424,546,667,121,3,4,4,4,1,480,870,637
569,0,0,1,1,0,0,0,1,1,0,0.0,0.0,1,1,0,-1,-1,-1,4,0,969,745,483
570,6,6,437,437,0,9,9,446,446,0,3.4037918240920386e-05,3.4037918240920386e-05,405,405,0,-1,4,4,3,2,554,690,235
571,10,112,568,925,357,12,12,549,549,0,0.0002723033459273631,0.00030634126416828345,609,634,25,4,4,4,2,4,909,501,476
572,132,234,947,977,30,38,38,895,895,0,0.004220701861874128,0.004595118962524252,950,954,4,4,3,3,3,24,901,8,584
573,0,206,1,969,968,0,24,1,569,568,0.0,0.0010892133837094523,1,825,824,3,-1,4,6,0,764,831,71
574,415,517,990,995,5,88,88,973,973,0,0.009394465434494027,0.009462541270975866,982,982,0,4,2,2,4,81,566,32,505
575,0,102,1,936,935,0,4,1,396,395,0.0,0.0002723033459273631,1,617,616,4,-1,5,2,0,849,982,418
576,9,215,527,967,440,18,26,487,591,104,0.0002042275094455223,0.0014295925661186562,559,845,286,3,4,4,5,6,501,392,79
577,0,0,1,1,0,0,0,1,1,0,0.0,0.0,1,1,0,-1,-1,-1,15,0,95,908,830
578,105,205,946,976,30,22,22,814,814,0,0.0033357159876101976,0.0033357159876101976,933,933,0,6,3,3,2,26,771,108,484
579,35,137,729,916,187,56,56,629,629,0,0.0002042275094455223,0.00030634126416828345,574,620,46,4,4,4,10,11,99,162,239
580,6,108,489,949,460,8,8,510,510,0,0.0002382654276864427,0.0005446066918547262,610,734,124,4,4,4,2,1,964,727,182
581,31,237,683,959,276,62,90,559,698,139,0.0002042275094455223,0.006058749446883829,561,962,401,3,3,3,14,6,79,486,24
582,0,101,1,960,959,0,2,1,332,331,0.0,0.0,1,1,0,7,-1,8,2,0,788,723,469
583,68,170,872,965,93,38,38,855,855,0,0.0013274788113958951,0.0014636304843595766,849,858,9,4,3,3,3,12,746,179,251
584,60,60,890,890,0,22,22,814,814,0,0.0015317063208414173,0.0015317063208414173,873,873,0,-1,3,3,2,18,771,64,205
585,0,101,1,954,953,0,4,1,329,328,0.0,0.0,1,1,0,7,-1,8,4,0,860,831,590
586,1,103,332,918,586,3,5,332,381,49,0.0,3.4037918240920386e-05,1,405,404,4,8,5,3,1,808,857,532
587,8,8,476,476,0,32,32,449,449,0,0.00010211375472276115,0.00010211375472276115,484,484,0,-1,4,4,12,2,143,523,723
588,25,231,703,967,264,28,32,529,568,39,0.00030634126416828345,0.0006126825283365669,621,737,116,3,4,4,8,7,440,176,282
589,0,616,1,998,997,0,23,1,752,751,0.0,0.002382654276864427,1,901,900,2,-1,3,3,0,651,783,499
590,0,206,1,965,964,0,20,1,487,486,0.0,0.0023486163586235067,1,899,898,3,-1,4,6,2,441,462,76
591,456,456,990,990,0,110,110,964,964,0,0.00966676878042139,0.00966676878042139,984,984,0,-1,2,2,6,78,514,9,836
592,0,0,1,1,0,0,0,1,1,0,0.0,0.0,1,1,0,-1,-1,-1,6,1,237,779,705
593,26,128,744,944,200,20,20,548,548,0,0.00034037918240920387,0.0005105687736138058,651,722,71,4,4,4,6,10,486,262,516
594,2,2,386,386,0,2,2,333,333,0,0.0002042275094455223,0.0002042275094455223,588,588,0,-1,6,6,2,5,666,401,835
595,0,0,1,1,0,0,0,1,1,0,0.0,0.0,1,1,0,-1,-1,-1,4,0,741,423,946
596,2,104,361,938,577,4,4,394,394,0,0.0,0.00010211375472276115,1,483,482,4,5,5,2,1,972,449,661
597,0,102,1,958,957,0,4,1,435,434,0.0,0.0005446066918547262,1,737,736,4,-1,5,2,0,751,766,473
598,25,126,686,914,228,47,47,680,680,0,0.00037441710065012424,0.00037441710065012424,665,665,0,6,3,3,7,5,374,510,663
599,722,822,993,994,1,328,328,992,992,0,0.009462541270975866,0.009462541270975866,974,974,0,4,2,2,16,81,117,32,309
600,33,33,783,783,0,24,24,636,636,0,0.0005446066918547262,0.0005446066918547262,738,738,0,-1,4,4,4,8,542,177,675
601,0,0,1,1,0,0,0,1,1,0,0.0,0.0,1,1,0,-1,-1,-1,24,0,28,754,902
602,100,100,892,892,0,100,100,873,873,0,0.018040096667687803,0.018040096667687803,991,991,0,-1,1,1,9,1,119,869,843
603,0,616,1,996,995,0,44,1,807,806,0.0,0.007556417849484326,1,975,974,2,-1,3,4,0,500,388,18
604,0,0,1,1,0,0,0,1,1,0,0.0,0.0,1,1,0,-1,-1,-1,11,0,360,859,911
605,6,6,407,407,0,22,22,454,454,0,3.4037918240920386e-05,3.4037918240920386e-05,400,400,0,-1,4,4,9,1,126,481,905
606,46,662,727,991,264,112,136,651,725,74,0.0004084550188910446,0.002825147213996392,681,923,242,2,3,3,19,6,31,467,41
607,0,616,1,990,989,0,54,1,607,606,0.0,0.0016338200755641784,1,861,860,2,-1,3,10,0,206,588,148
608,24,640,677,995,318,52,62,715,778,63,0.0007488342013002485,0.002144388849177984,764,891,127,2,3,3,7,5,714,589,340
609,1,1,332,332,0,4,4,332,332,0,0.0,0.0,1,1,0,-1,6,6,4,1,650,736,515
610,78,78,857,857,0,106,106,869,869,0,0.00176997174852786,0.00176997174852786,877,877,0,-1,3,3,11,15,174,92,851
611,0,102,1,926,925,0,3,1,366,365,0.0,0.0002382654276864427,1,599,598,4,-1,5,2,1,932,841,365
612,6,107,458,941,483,7,7,467,467,0,3.4037918240920386e-05,0.0002042275094455223,396,574,178,5,4,4,2,2,954,560,755
613,0,206,1,971,970,0,16,1,523,522,0.0,0.0006126825283365669,1,744,743,3,-1,4,4,0,559,533,289
614,6,212,446,972,526,9,14,458,542,84,6.807583648184077e-05,0.0012253650566731338,458,844,386,3,4,4,3,1,746,899,109
615,1,617,333,995,662,7,36,333,602,269,0.0,0.0014295925661186562,1,839,838,2,6,3,7,1,366,736,83
616,0,102,1,898,897,0,11,1,375,374,0.0,6.807583648184077e-05,1,443,442,4,-1,5,7,0,216,923,566
617,40,656,678,996,318,188,198,824,842,18,0.0009530617107457708,0.0018040096667687805,793,866,73,2,2,2,21,2,1,482,283
618,0,0,1,1,0,0,0,1,1,0,0.0,0.0,1,1,0,-1,-1,-1,5,2,392,462,600
619,71,277,846,973,127,68,68,765,765,0,0.0012253650566731338,0.0013615167296368155,827,834,7,3,3,3,8,14,218,190,317
620,0,0,1,1,0,0,0,1,1,0,0.0,0.0,1,1,0,-1,-1,-1,3,0,620,875,833
621,18,18,642,642,0,42,42,722,722,0,0.0002382654276864427,0.0002382654276864427,604,604,0,-1,3,3,6,4,267,305,999
622,166,166,944,944,0,140,140,991,991,0,0.0032336022328874367,0.0032336022328874367,927,927,0,-1,2,2,7,14,299,146,753
623,2,104,351,895,544,8,12,352,385,33,0.0,3.4037918240920386e-05,1,404,403,4,5,5,7,1,321,603,720
624,213,315,954,976,22,134,134,945,945,0,0.004152626025392287,0.00445896728956057,946,948,2,4,3,3,9,25,191,105,368
625,9,215,574,974,400,8,12,473,566,93,6.807583648184077e-05,0.0008509479560230097,438,798,360,3,4,4,2,3,828,347,519
626,0,102,1,935,934,0,3,1,367,366,0.0,0.00013615167296368154,1,507,506,4,-1,5,2,1,733,235,369
627,38,244,764,968,204,68,68,826,826,0,0.0007488342013002485,0.0030293747234419145,762,916,154,3,3,3,8,5,521,221,56
628,8,8,452,452,0,36,36,391,391,0,0.0,0.0,1,1,0,-1,4,4,19,2,31,694,996
629,8,109,596,950,354,4,4,409,409,0,0.0002042275094455223,0.0002042275094455223,580,580,0,6,5,5,2,8,469,302,530
630,0,0,1,1,0,0,0,1,1,0,0.0,0.0,1,1,0,-1,-1,-1,3,0,882,740,990
631,40,141,810,945,135,34,34,755,755,0,0.001157289220191293,0.001157289220191293,835,835,0,5,3,3,4,4,736,207,485
632,0,102,1,945,944,0,6,1,404,403,0.0,0.00017018959120460194,1,541,540,4,-1,5,4,0,754,732,634
633,0,206,1,945,944,0,30,1,387,386,0.0,0.00010211375472276115,1,482,481,3,-1,4,18,0,34,790,315
634,470,571,985,989,4,366,366,988,988,0,0.006126825283365669,0.006126825283365669,964,964,0,5,2,2,19,54,31,28,590
635,15,221,641,974,333,15,16,553,570,17,0.00013615167296368154,0.0005786446100956465,524,745,221,3,4,4,4,4,824,156,120
636,0,0,1,1,0,0,0,1,1,0,0.0,0.0,1,1,0,-1,-1,-1,15,1,49,830,908
637,3,104,478,971,493,3,3,402,402,0,0.00013615167296368154,0.00013615167296368154,532,532,0,6,5,5,2,4,898,270,292
638,27,233,778,978,200,14,18,589,661,72,0.0004084550188910446,0.0025188059498281084,679,909,230,3,4,4,3,11,745,316,141
639,1,103,333,889,556,9,12,333,366,33,0.0,0.0,1,1,0,4,6,5,9,1,166,703,531
640,93,93,869,869,0,100,100,821,821,0,0.0017018959120460194,0.0017018959120460194,866,866,0,-1,3,3,10,18,152,148,949
641,59,265,840,973,133,34,34,733,733,0,0.0016338200755641784,0.0023486163586235067,860,896,36,3,3,3,4,11,391,166,559
642,38,140,812,952,140,30,30,762,762,0,0.0013274788113958951,0.0013274788113958951,849,849,0,4,3,3,4,6,573,397,321
643,2,2,403,403,0,4,4,467,467,0,6.807583648184077e-05,6.807583648184077e-05,466,466,0,-1,5,5,2,1,941,481,811
644,6,212,453,973,520,9,14,462,542,80,3.4037918240920386e-05,0.002927260968719153,401,919,518,3,4,4,3,2,585,518,76
645,28,130,741,936,195,34,34,765,765,0,0.0011913271384322134,0.0014295925661186562,836,851,15,4,3,3,4,3,675,642,198
646,37,37,761,761,0,48,48,709,709,0,0.0010892133837094523,0.0010892133837094523,815,815,0,-1,3,3,7,7,324,237,884
647,2,618,356,993,637,18,40,408,556,148,3.4037918240920386e-05,0.0007147962830593281,393,755,362,2,5,3,9,1,192,756,211
648,30,30,759,759,0,46,46,823,823,0,0.0007147962830593281,0.0007147962830593281,759,759,0,-1,3,3,5,6,524,381,966
649,2,103,364,926,562,6,6,385,385,0,3.4037918240920386e-05,3.4037918240920386e-05,409,409,0,5,5,5,4,1,650,717,781
650,0,102,1,901,900,0,9,1,358,357,0.0,3.4037918240920386e-05,1,403,402,4,-1,5,8,0,137,988,958
651,2,2,366,366,0,7,7,410,410,0,0.00013615167296368154,0.00013615167296368154,514,514,0,-1,5,5,4,4,772,409,846
652,0,616,1,1000,999,0,22,1,836,835,0.0,0.008237176214302734,1,975,974,2,-1,3,2,0,951,937,32
653,47,149,794,930,136,42,42,600,600,0,0.0008509479560230097,0.0009530617107457708,776,794,18,4,4,4,9,13,389,120,239
654,82,288,864,974,110,80,84,831,845,14,0.0018380475850097008,0.0025188059498281084,875,902,27,3,3,3,9,15,388,62,194
655,64,64,801,801,0,112,112,750,750,0,0.0005105687736138058,0.0005105687736138058,701,701,0,-1,2,2,14,6,203,107,811
656,18,224,698,978,280,28,28,816,816,0,0.0005446066918547262,0.0015317063208414173,721,864,143,3,3,3,3,3,770,354,630
657,48,254,734,959,225,116,116,709,709,0,0.00037441710065012424,0.0006126825283365669,655,727,72,3,3,3,15,5,77,688,636
658,0,206,1,962,961,0,38,1,549,548,0.0,0.0018380475850097008,1,866,865,3,-1,4,9,0,394,538,43
659,0,0,1,1,0,0,0,1,1,0,0.0,0.0,1,1,0,-1,-1,-1,5,0,551,997,882
660,0,206,1,960,959,0,22,1,484,483,0.0,0.0005786446100956465,1,717,716,3,-1,4,7,0,340,522,165
661,16,222,615,970,355,34,34,744,744,0,0.0005446066918547262,0.0088498587426393,710,978,268,3,3,3,4,1,832,474,1
662,12,12,680,680,0,12,12,721,721,0,0.00030634126416828345,0.00030634126416828345,647,647,0,-1,4,4,2,3,666,610,888
663,14,630,570,995,425,40,54,611,703,92,0.00010211375472276115,0.00088498587426393,480,786,306,2,4,3,8,6,137,406,354
664,0,0,1,1,0,0,0,1,1,0,0.0,0.0,1,1,0,-1,-1,-1,3,0,288,825,849
665,0,206,1,965,964,0,13,1,438,437,0.0,0.0006467204465774873,1,744,743,3,-1,4,5,1,555,913,59
666,36,242,695,960,265,108,108,691,691,0,0.0007828721195411688,0.0012594029749140542,748,821,73,3,3,3,17,8,73,345,467
667,22,22,621,621,0,116,116,775,775,0,0.000442492937131965,0.000442492937131965,678,678,0,-1,3,3,15,4,102,312,760
668,0,0,1,1,0,0,0,1,1,0,0.0,0.0,1,1,0,-1,-1,-1,3,0,576,712,731
669,0,0,1,1,0,0,0,1,1,0,0.0,0.0,1,1,0,-1,-1,-1,7,0,264,993,856
670,0,206,1,955,954,0,16,1,397,396,0.0,6.807583648184077e-05,1,448,447,3,-1,4,9,1,136,780,370
671,3,3,432,432,0,6,6,418,418,0,0.0,0.0,1,1,0,-1,5,5,3,2,588,244,702
672,0,616,1,993,992,0,42,1,536,535,0.0,0.0010211375472276116,1,810,809,2,-1,3,12,0,93,922,306
673,16,118,598,915,317,34,34,706,706,0,0.00034037918240920387,0.00034037918240920387,648,649,1,4,3,3,4,1,300,561,430
674,16,222,610,971,361,50,50,816,816,0,0.00013615167296368154,0.0005786446100956465,513,735,222,3,3,3,5,1,392,553,165
675,6,6,480,480,0,10,10,494,494,0,6.807583648184077e-05,6.807583648184077e-05,456,456,0,-1,4,4,3,1,861,762,901
676,0,0,1,1,0,0,0,1,1,0,0.0,0.0,1,1,0,-1,-1,-1,7,0,193,922,698
677,235,235,955,955,0,196,196,915,915,0,0.0028591851322373124,0.0028591851322373124,917,917,0,-1,3,3,16,33,145,15,980
678,23,639,728,997,269,18,28,617,762,145,0.0005105687736138058,0.0036760951700194017,712,937,225,2,4,3,3,8,621,386,98
679,6,107,482,938,456,14,14,598,598,0,3.4037918240920386e-05,3.4037918240920386e-05,413,413,0,5,4,4,3,2,530,544,597
680,0,616,1,991,990,0,50,1,547,546,0.0,0.0006126825283365669,1,724,723,2,-1,3,12,0,252,983,407
681,347,347,985,985,0,54,54,918,918,0,0.008475441641989176,0.008475441641989176,978,978,0,-1,3,3,4,70,735,18,936
682,75,75,862,862,0,48,48,729,729,0,0.0012934408931549745,0.0012934408931549745,840,840,0,-1,3,3,7,14,362,190,903
683,0,102,1,919,918,0,6,1,358,357,0.0,0.0,1,1,0,4,-1,5,5,0,656,760,577
684,0,0,1,1,0,0,0,1,1,0,0.0,0.0,1,1,0,-1,-1,-1,12,0,226,588,905
685,2,104,354,916,562,6,6,394,394,0,3.4037918240920386e-05,6.807583648184077e-05,410,454,44,4,5,5,3,2,737,342,215
686,2,104,356,899,543,11,11,373,373,0,3.4037918240920386e-05,3.4037918240920386e-05,397,397,0,4,5,5,8,1,440,530,606
687,0,206,1,943,942,0,56,1,498,497,0.0,0.00034037918240920387,1,638,637,3,-1,4,16,0,195,729,221
688,0,101,1,934,933,0,3,1,330,329,0.0,6.807583648184077e-05,1,447,446,5,-1,6,3,0,961,865,646
689,61,162,844,946,102,50,50,794,794,0,0.0011913271384322134,0.0011913271384322134,827,827,0,7,3,3,5,12,818,67,765
690,10,10,604,604,0,14,14,625,625,0,0.0009190237925048504,0.0009190237925048504,807,807,0,-1,4,4,3,5,693,355,611
691,104,104,932,932,0,34,34,897,897,0,0.0018720855032506212,0.0018720855032506212,885,885,0,-1,3,3,3,16,710,78,856
692,0,102,1,903,902,0,15,1,404,403,0.0,0.00037441710065012424,1,662,661,4,-1,5,8,0,301,918,256
693,179,179,947,947,0,94,94,882,882,0,0.003437829742332959,0.003437829742332959,929,929,0,-1,3,3,9,28,389,41,529
694,16,632,632,998,366,21,40,642,827,185,0.00013615167296368154,0.004356853534837809,520,948,428,2,3,3,4,1,758,577,119
695,125,226,941,976,35,54,54,907,907,0,0.00353994349705572,0.00353994349705572,941,941,0,7,3,3,4,19,495,135,703
696,1,207,333,960,627,9,29,333,509,176,6.807583648184077e-05,0.000442492937131965,443,679,236,3,6,4,9,2,395,357,103
697,1,207,333,964,631,7,18,333,456,123,0.0,0.0002042275094455223,1,567,566,3,6,4,7,4,273,595,329
698,17,17,640,640,0,26,26,586,586,0,0.000442492937131965,0.000442492937131965,703,703,0,-1,4,4,5,8,247,302,876
699,11,217,513,958,445,46,50,558,578,20,0.0002723033459273631,0.0008169100377820892,610,769,159,3,4,4,11,4,234,645,92
700,128,128,952,952,0,32,32,894,894,0,0.0034718676605738795,0.0034718676605738795,931,931,0,-1,3,3,2,31,643,35,728
701,110,212,922,969,47,68,68,957,957,0,0.002995336805200994,0.0030974505599237552,923,926,3,4,2,2,4,12,632,163,628
702,96,96,844,844,0,148,148,811,811,0,0.00088498587426393,0.00088498587426393,778,778,0,-1,3,3,17,13,10,217,745
703,1,207,332,976,644,3,18,332,651,319,0.0,0.0026889955410327104,1,917,916,3,7,4,3,1,729,972,69
704,0,102,1,933,932,0,5,1,366,365,0.0,0.0002042275094455223,1,577,576,4,-1,5,4,0,679,963,353
705,16,16,519,519,0,154,154,809,809,0,0.0008169100377820892,0.0008169100377820892,769,769,0,-1,3,3,18,1,111,480,984
706,27,27,712,712,0,40,40,610,610,0,0.0004084550188910446,0.0004084550188910446,673,673,0,-1,4,4,8,6,146,432,456
707,16,16,549,549,0,112,112,740,740,0,0.00017018959120460194,0.00017018959120460194,544,544,0,-1,3,3,15,1,32,667,859
708,6,107,438,923,485,20,20,593,593,0,0.00013615167296368154,0.00013615167296368154,509,509,0,5,4,4,4,3,280,260,578
709,10,626,555,994,439,30,40,519,582,63,0.00010211375472276115,0.0009870996289866913,496,792,296,2,4,3,11,3,261,248,580
710,2,104,361,921,560,9,10,397,414,17,0.0,0.0005105687736138058,1,707,706,4,5,5,5,1,561,618,293
711,273,273,974,974,0,194,194,983,983,0,0.005071649817897137,0.005071649817897137,957,957,0,-1,2,2,11,37,176,74,538
712,11,112,575,928,353,22,22,577,577,0,0.00013615167296368154,0.0002042275094455223,521,565,44,5,4,4,5,5,565,454,694
713,0,102,1,945,944,0,4,1,386,385,0.0,0.00030634126416828345,1,648,647,4,-1,5,3,0,790,798,262
714,0,206,1,953,952,0,17,1,413,412,0.0,0.00030634126416828345,1,634,633,3,-1,4,7,0,296,836,418
715,2,2,362,362,0,9,9,387,387,0,3.4037918240920386e-05,3.4037918240920386e-05,403,403,0,-1,5,5,6,2,253,662,772
716,0,0,1,1,0,0,0,1,1,0,0.0,0.0,1,1,0,-1,-1,-1,3,0,718,517,768
717,52,668,798,993,195,94,104,815,867,52,0.0013955546478777359,0.0019741992579733825,847,878,31,2,3,3,9,6,159,397,233
718,16,118,580,915,335,35,35,611,611,0,0.0002042275094455223,0.0002042275094455223,565,565,0,4,3,3,7,2,170,419,680
719,3,105,481,965,484,3,3,404,404,0,0.00010211375472276115,0.0007147962830593281,495,779,284,4,5,5,2,5,805,231,336
720,0,206,1,974,973,0,11,1,473,472,0.0,0.0006807583648184077,1,751,750,3,-1,4,4,0,777,922,295
721,21,227,690,973,283,40,40,777,777,0,0.0011232513019503727,0.0017018959120460194,823,865,42,3,3,3,5,4,487,312,500
722,34,135,834,961,127,22,22,822,822,0,0.001055175465468532,0.0010892133837094523,837,845,8,5,3,3,2,9,975,212,509
723,13,219,535,957,422,22,50,423,608,185,0.00010211375472276115,0.0030293747234419145,475,924,449,3,4,4,9,6,287,279,88
724,307,409,989,993,4,32,32,923,923,0,0.009360427516253106,0.009530617107457708,984,985,1,4,3,3,2,78,779,9,263
725,18,224,568,952,384,96,96,613,613,0,0.00037441710065012424,0.000442492937131965,651,675,24,3,4,4,18,4,64,637,451
726,0,616,1,998,997,0,18,1,663,662,0.0,0.0016338200755641784,1,865,864,2,-1,3,3,0,712,356,449
727,14,14,689,689,0,12,12,714,714,0,0.00030634126416828345,0.00030634126416828345,645,645,0,-1,4,4,2,4,876,625,929
728,34,650,716,992,276,86,150,765,953,188,0.0004765308553728854,0.014568229007113924,710,985,275,2,3,3,10,6,189,381,2
729,56,672,816,995,179,98,98,863,863,0,0.0014295925661186562,0.002825147213996392,840,926,86,2,3,3,8,6,244,289,54
730,0,102,1,901,900,0,8,1,351,350,0.0,0.00010211375472276115,1,487,486,4,-1,5,7,2,320,684,311
731,16,118,597,920,323,20,20,531,531,0,0.00013615167296368154,0.00030634126416828345,514,632,118,4,4,4,4,4,448,208,727
732,0,102,1,907,906,0,5,1,352,351,0.0,0.00010211375472276115,1,480,479,4,-1,5,4,0,540,839,659
733,2,2,374,374,0,2,2,332,332,0,0.0,0.0,1,1,0,-1,6,6,2,2,999,694,854
734,12,114,533,912,379,34,34,541,541,0,0.00010211375472276115,0.0002382654276864427,491,582,91,4,4,4,9,3,177,361,579
735,8,110,510,914,404,19,19,485,485,0,0.00010211375472276115,0.0002382654276864427,481,601,120,4,4,4,6,3,345,646,115
736,1,1,333,333,0,8,8,333,333,0,0.0,0.0,1,1,0,-1,7,7,8,1,297,469,738
737,42,248,812,976,164,34,34,738,738,0,0.0005105687736138058,0.001055175465468532,704,816,112,3,3,3,4,9,623,391,616
738,194,194,968,968,0,64,64,939,939,0,0.004152626025392287,0.004152626025392287,945,945,0,-1,3,3,4,36,460,48,946
739,4,106,459,942,483,3,4,375,419,44,6.807583648184077e-05,0.0011232513019503727,459,835,376,4,5,5,2,3,757,361,95
740,7,108,565,949,384,6,6,442,442,0,0.0002042275094455223,0.0002382654276864427,575,602,27,5,5,5,3,6,600,459,421
741,100,202,897,966,69,90,90,957,957,0,0.0030974505599237552,0.003608019333537561,927,937,10,4,2,2,6,9,556,277,114
742,0,0,1,1,0,0,0,1,1,0,0.0,0.0,1,1,0,-1,-1,-1,18,0,86,800,753
743,0,0,1,1,0,0,0,1,1,0,0.0,0.0,1,1,0,-1,-1,-1,4,0,827,356,569
744,0,102,1,929,928,0,7,1,406,405,0.0,0.00017018959120460194,1,540,539,4,-1,5,4,3,891,478,266
745,10,216,548,969,421,24,28,567,612,45,0.00030634126416828345,0.0010892133837094523,626,811,185,3,4,4,6,6,446,447,243
746,16,16,580,580,0,34,34,623,623,0,0.00010211375472276115,0.00010211375472276115,468,468,0,-1,3,3,6,1,514,904,600
747,0,206,1,947,946,0,41,1,463,462,0.0,0.0008509479560230097,1,772,771,3,-1,4,15,0,102,766,535
748,0,206,1,971,970,0,12,1,489,488,0.0,0.0011913271384322134,1,839,838,3,-1,4,4,0,562,657,84
749,72,174,862,959,97,56,56,821,821,0,0.0012594029749140542,0.0012594029749140542,835,835,0,4,3,3,6,13,267,261,575
750,0,0,1,1,0,0,0,1,1,0,0.0,0.0,1,1,0,-1,-1,-1,6,1,575,738,684
751,2,2,370,370,0,3,3,332,332,0,0.0,0.0,1,1,0,-1,6,6,3,3,823,563,962
752,0,102,1,911,910,0,6,1,372,371,0.0,0.00013615167296368154,1,521,520,4,-1,5,4,0,870,200,645
753,2,103,397,969,572,3,3,406,406,0,0.0,3.4037918240920386e-05,1,402,401,5,5,5,2,2,959,320,337
754,76,76,849,849,0,68,68,741,741,0,0.0013955546478777359,0.0013955546478777359,846,846,0,-1,3,3,8,14,357,190,835
755,150,252,943,975,32,82,82,891,891,0,0.002927260968719153,0.0032336022328874367,917,929,12,4,3,3,7,31,658,35,544
756,28,130,767,952,185,18,18,681,681,0,0.0006807583648184077,0.0009870996289866913,755,807,52,4,4,4,3,7,288,169,259
757,23,125,709,934,225,20,20,574,574,0,0.000442492937131965,0.0004765308553728854,699,708,9,4,4,4,4,7,917,329,434
758,8,8,592,592,0,8,8,544,544,0,0.0002723033459273631,0.0002723033459273631,640,640,0,-1,4,4,2,2,781,473,841
759,7,213,526,973,447,7,12,468,561,93,0.00030634126416828345,0.0004084550188910446,638,685,47,3,4,4,2,5,971,605,300
760,2,2,361,361,0,10,10,415,415,0,3.4037918240920386e-05,3.4037918240920386e-05,406,406,0,-1,5,5,5,1,561,899,975
761,6,212,426,965,539,14,18,457,499,42,0.00010211375472276115,0.001497668402600497,479,852,373,3,4,4,5,2,173,550,61
762,2,103,368,942,574,6,6,445,445,0,0.00010211375472276115,0.0002042275094455223,491,565,74,5,5,5,3,1,693,666,544
763,84,290,868,975,107,44,44,760,760,0,0.0009870996289866913,0.0011232513019503727,807,824,17,3,3,3,4,19,503,184,305
764,51,153,905,978,73,42,42,986,986,0,0.009122162088566664,0.009292351679771264,980,980,0,4,2,2,2,6,997,232,343
765,27,233,699,962,263,40,44,581,612,31,0.0004084550188910446,0.0006807583648184077,672,745,73,3,3,3,9,5,250,310,840
766,80,182,871,954,83,76,76,893,893,0,0.002484768031587188,0.0032336022328874367,903,932,29,4,2,2,7,9,141,130,175
767,139,239,930,968,38,84,84,840,840,0,0.0026209197045508697,0.002757071377514551,910,911,1,4,3,3,9,28,177,44,259
768,2,104,357,906,549,10,11,379,390,11,6.807583648184077e-05,0.00013615167296368154,449,509,60,4,5,5,7,3,637,460,248
769,2,2,363,363,0,4,4,397,397,0,3.4037918240920386e-05,3.4037918240920386e-05,396,396,0,-1,5,5,2,1,954,552,649
770,34,240,742,966,224,62,62,779,779,0,0.0011232513019503727,0.0013955546478777359,823,848,25,3,3,3,7,4,340,281,4
771,19,121,689,942,253,8,8,473,473,0,0.00037441710065012424,0.000442492937131965,667,691,24,4,4,4,2,9,990,191,625
772,44,145,771,925,154,60,60,680,680,0,0.0007488342013002485,0.0007488342013002485,759,759,0,5,3,3,11,5,248,562,503
773,0,0,1,1,0,0,0,1,1,0,0.0,0.0,1,1,0,-1,-1,-1,2,0,752,228,792
774,10,112,564,917,353,36,36,617,617,0,0.00034037918240920387,0.0005786446100956465,651,724,73,4,4,4,8,3,318,173,424
775,0,206,1,955,954,0,26,1,448,447,0.0,0.0005446066918547262,1,713,712,3,-1,4,9,0,351,818,240
776,238,339,951,973,22,270,270,937,937,0,0.005037611899656217,0.005037611899656217,953,953,0,5,3,3,20,27,61,88,896
777,7,7,549,549,0,10,10,531,531,0,0.00010211375472276115,0.00010211375472276115,486,486,0,-1,4,4,3,3,953,441,733
778,0,102,1,901,900,0,13,1,408,407,0.0,0.00010211375472276115,1,487,486,4,-1,5,7,0,525,956,278
779,48,664,849,998,149,46,46,971,971,0,0.003880322679464924,0.008747744987916539,944,979,35,2,2,2,2,4,972,407,48
780,0,102,1,966,965,0,4,1,443,442,0.0,0.0002382654276864427,1,607,606,4,-1,5,2,0,968,892,154
781,7,108,487,896,409,20,20,441,441,0,0.00010211375472276115,0.00010211375472276115,479,479,0,5,4,4,8,2,197,749,605
782,0,0,1,1,0,0,0,1,1,0,0.0,0.0,1,1,0,-1,-1,-1,6,1,345,913,712
783,14,115,654,944,290,14,14,589,589,0,0.0004765308553728854,0.0004765308553728854,709,709,0,5,4,4,3,3,863,616,416
784,10,216,534,966,432,24,40,477,610,133,0.00017018959120460194,0.0012253650566731338,546,833,287,3,4,4,8,3,137,653,67
785,24,24,759,759,0,12,12,604,604,0,0.0009530617107457708,0.0009530617107457708,809,809,0,-1,4,4,2,8,761,250,696
786,32,238,716,967,251,48,48,678,678,0,0.00034037918240920387,0.0006807583648184077,645,750,105,3,3,3,7,6,591,199,610
787,18,18,636,636,0,41,41,666,666,0,0.0005105687736138058,0.0005105687736138058,704,704,0,-1,3,3,8,2,158,523,554
788,14,115,651,948,297,10,10,514,514,0,0.00030634126416828345,0.00034037918240920387,624,639,15,5,4,4,3,4,628,637,325
789,17,119,664,936,272,50,50,860,860,0,0.0006467204465774873,0.0007147962830593281,746,762,16,4,3,3,5,3,517,354,652
790,0,206,1,948,947,0,32,1,434,433,0.0,0.00034037918240920387,1,628,627,3,-1,4,15,0,110,813,132
791,15,15,651,651,0,24,24,703,703,0,0.00030634126416828345,0.00030634126416828345,641,641,0,-1,4,4,4,5,543,454,914
792,26,26,765,765,0,22,22,796,796,0,0.00034037918240920387,0.00034037918240920387,657,657,0,-1,3,3,2,4,705,328,638
793,109,109,910,910,0,92,92,935,935,0,0.002314578440382586,0.002314578440382586,894,894,0,-1,2,2,7,18,305,148,757
794,24,640,637,991,354,86,100,706,758,52,0.0002382654276864427,0.0011913271384322134,587,819,232,2,3,3,13,4,228,220,412
795,0,0,1,1,0,0,0,1,1,0,0.0,0.0,1,1,0,-1,-1,-1,3,1,856,789,235
796,0,101,1,960,959,0,2,1,331,330,0.0,0.00010211375472276115,1,501,500,5,-1,6,2,0,997,981,346
797,2,104,367,934,567,5,7,367,418,51,0.0,0.00017018959120460194,1,554,553,4,5,5,4,3,679,460,381
798,0,206,1,960,959,0,13,1,422,421,0.0,0.0002382654276864427,1,581,580,3,-1,4,6,0,393,733,617
799,0,0,1,1,0,0,0,1,1,0,0.0,0.0,1,1,0,-1,-1,-1,2,1,760,539,918
800,6,212,396,950,554,42,46,483,502,19,0.00013615167296368154,0.00034037918240920387,502,646,144,3,4,4,13,1,67,527,507
801,0,0,1,1,0,0,0,1,1,0,0.0,0.0,1,1,0,-1,-1,-1,6,0,322,912,356
802,4,4,423,423,0,10,10,416,416,0,0.00017018959120460194,0.00017018959120460194,558,558,0,-1,5,5,5,2,363,579,966
803,2,104,387,957,570,4,4,468,468,0,3.4037918240920386e-05,0.0011913271384322134,409,852,443,4,5,5,2,1,995,558,203
804,116,322,897,975,78,114,114,878,878,0,0.001599782157323258,0.0024166921951053475,860,908,48,3,3,3,9,13,101,261,403
805,237,1877,964,1000,36,172,196,979,994,15,0.003267640151128357,0.013717281051090916,931,985,54,1,2,2,9,34,164,89,83
806,86,292,833,966,133,190,190,922,922,0,0.002552843868069029,0.004016474352428605,905,938,33,3,2,2,16,6,72,73,151
807,0,102,1,900,899,0,8,1,380,379,0.0,6.807583648184077e-05,1,445,444,4,-1,5,5,0,571,981,347
808,0,0,1,1,0,0,0,1,1,0,0.0,0.0,1,1,0,-1,-1,-1,4,1,581,806,909
809,24,24,714,714,0,28,28,595,595,0,0.0002723033459273631,0.0002723033459273631,616,616,0,-1,4,4,6,4,295,259,502
810,0,0,1,1,0,0,0,1,1,0,0.0,0.0,1,1,0,-1,-1,-1,9,1,202,787,916
811,16,222,596,965,369,56,56,752,752,0,0.00034037918240920387,0.0008169100377820892,645,778,133,3,3,3,8,2,440,223,338
812,6,212,434,970,536,11,15,437,502,65,3.4037918240920386e-05,0.00013615167296368154,404,513,109,3,4,4,5,1,476,601,199
813,36,137,698,901,203,176,176,869,869,0,0.0011232513019503727,0.001157289220191293,822,828,6,5,3,3,16,7,27,224,560
814,10,112,541,915,374,12,12,449,449,0,0.00017018959120460194,0.0002042275094455223,537,568,31,4,4,4,4,4,391,567,763
815,0,101,1,956,955,0,2,1,329,328,0.0,0.0,1,1,0,7,-1,8,2,0,890,955,626
816,2,2,373,373,0,4,4,404,404,0,6.807583648184077e-05,6.807583648184077e-05,451,451,0,-1,5,5,2,2,934,419,844
817,139,139,964,964,0,28,28,853,853,0,0.004629156880765172,0.004629156880765172,956,956,0,-1,3,3,3,31,879,34,901
818,26,26,827,827,0,22,22,901,901,0,0.0011232513019503727,0.0011232513019503727,829,829,0,-1,3,3,2,8,810,186,750
819,48,254,836,978,142,26,26,616,616,0,0.0007147962830593281,0.0010892133837094523,768,829,61,3,4,4,5,13,314,217,267
820,1105,1311,998,999,1,430,430,997,997,0,0.017393376221110316,0.01766567956703768,996,996,0,3,2,2,17,127,94,11,290
821,0,102,1,928,927,0,3,1,364,363,0.0,0.00010211375472276115,1,479,478,4,-1,5,2,0,750,367,247
822,16,16,618,618,0,28,28,658,658,0,0.00013615167296368154,0.00013615167296368154,513,513,0,-1,3,3,5,1,528,870,908
823,56,56,812,812,0,56,56,661,661,0,0.0005786446100956465,0.0005786446100956465,729,729,0,-1,3,3,9,11,147,316,744
824,0,206,1,954,953,0,36,1,472,471,0.0,0.000442492937131965,1,687,686,3,-1,4,12,0,226,751,154
825,1,103,333,888,555,11,19,333,394,61,0.0,0.0004084550188910446,1,671,670,4,6,5,11,1,234,640,414
826,6,622,438,997,559,22,40,568,769,201,6.807583648184077e-05,0.008203138296061813,449,977,528,2,4,3,5,1,363,810,1
827,11,11,585,585,0,24,24,699,699,0,0.0005105687736138058,0.0005105687736138058,711,711,0,-1,4,4,4,5,767,510,835
828,8,110,522,923,401,20,20,583,583,0,0.00017018959120460194,0.00017018959120460194,544,544,0,4,4,4,4,2,921,628,690
829,8,8,523,523,0,24,24,555,555,0,3.4037918240920386e-05,3.4037918240920386e-05,412,412,0,-1,4,4,6,2,405,566,358
830,40,142,799,942,143,58,58,918,918,0,0.0019061234214915416,0.0019061234214915416,883,883,0,4,2,2,4,1,354,612,873
831,255,461,978,994,16,56,56,966,966,0,0.010858095918853602,0.011266550937744648,985,985,0,3,2,2,2,49,589,31,490
832,0,206,1,975,974,0,10,1,512,511,0.0,0.0018040096667687805,1,879,878,3,-1,4,3,0,845,902,27
833,281,383,979,989,10,70,70,939,939,0,0.00622893903808843,0.006535280302256714,963,968,5,4,3,3,5,49,551,16,368
834,0,0,1,1,0,0,0,1,1,0,0.0,0.0,1,1,0,-1,-1,-1,13,2,185,709,984
835,2,208,349,956,607,10,26,349,471,122,0.0,0.0013274788113958951,1,841,840,3,5,4,9,2,330,739,66
836,26,128,776,953,177,12,12,604,604,0,0.0006807583648184077,0.0008169100377820892,759,784,25,4,4,4,2,9,761,245,720
837,100,100,841,841,0,100,100,543,543,0,0.01147077844719017,0.01147077844719017,986,986,0,-1,1,1,23,44,8,27,731
838,38,140,799,944,145,50,50,870,870,0,0.0005786446100956465,0.0009870996289866913,720,804,84,4,3,3,5,8,456,186,209
839,24,126,716,939,223,34,34,750,750,0,0.0004765308553728854,0.0005446066918547262,698,712,14,4,3,3,4,4,815,622,441
840,0,102,1,921,920,0,7,1,379,378,0.0,0.0,1,1,0,4,-1,5,5,0,691,985,434
841,52,52,759,759,0,120,120,716,716,0,0.0004765308553728854,0.0004765308553728854,684,684,0,-1,3,3,18,9,111,245,980
842,0,102,1,904,903,0,11,1,397,396,0.0,0.00010211375472276115,1,477,476,4,-1,5,7,0,305,887,362
843,0,0,1,1,0,0,0,1,1,0,0.0,0.0,1,1,0,-1,-1,-1,3,0,916,856,995
844,0,102,1,930,929,0,7,1,406,405,0.0,0.00030634126416828345,1,622,621,4,-1,5,4,1,945,650,439
845,8,109,560,952,392,8,8,509,509,0,0.0002042275094455223,0.0005786446100956465,579,749,170,5,4,4,2,3,232,505,170
846,30,236,673,956,283,86,94,619,647,28,0.0002042275094455223,0.001940161339732462,563,879,316,3,3,3,16,9,60,341,65
847,100,100,910,910,0,100,100,978,978,0,0.03448041117805235,0.034990979951666154,997,998,1,3,1,1,5,31,766,76,267
848,6,212,498,976,478,12,12,609,609,0,0.00013615167296368154,0.0009190237925048504,533,813,280,3,4,4,2,1,976,452,131
849,6,212,423,965,542,22,26,521,564,43,0.00017018959120460194,0.0007828721195411688,538,782,244,3,4,4,5,1,347,689,219
850,25,127,824,974,150,22,22,897,897,0,0.001055175465468532,0.0016678579938050988,830,884,54,4,3,3,2,4,805,207,97
851,0,206,1,929,928,0,32,1,367,366,0.0,0.00013615167296368154,1,494,493,3,-1,4,24,0,28,514,599
852,12,114,583,927,344,12,12,563,563,0,6.807583648184077e-05,0.0002723033459273631,447,618,171,4,4,4,2,3,859,361,507
853,0,206,1,948,947,0,30,1,454,453,0.0,0.0005446066918547262,1,703,702,3,-1,4,11,0,163,790,216
854,0,101,1,941,940,0,3,1,331,330,0.0,3.4037918240920386e-05,1,404,403,6,-1,7,3,0,814,455,708
855,0,616,1,997,996,0,31,1,718,717,0.0,0.002552843868069029,1,906,905,2,-1,3,5,1,662,685,13
856,40,141,800,944,144,40,40,770,770,0,0.0013274788113958951,0.0013615167296368155,846,848,2,5,3,3,5,10,363,195,464
857,2,2,364,364,0,6,6,418,418,0,0.0,0.0,1,1,0,-1,5,5,3,1,842,618,715
858,24,230,701,973,272,34,34,729,729,0,0.000442492937131965,0.0006807583648184077,689,752,63,3,3,3,4,4,671,622,667
859,116,218,921,964,43,88,88,896,896,0,0.002144388849177984,0.002552843868069029,891,907,16,4,3,3,8,22,158,128,132
860,24,126,688,919,231,54,54,776,776,0,0.000442492937131965,0.0007488342013002485,694,765,71,4,3,3,7,6,335,447,278
861,0,206,1,975,974,0,8,1,484,483,0.0,0.0004084550188910446,1,689,688,3,-1,4,2,0,804,936,253
862,9,215,611,984,373,9,13,543,710,167,0.0004084550188910446,0.0027911092957554717,680,922,242,3,4,4,3,3,877,353,25
863,94,94,881,881,0,68,68,811,811,0,0.0024166921951053475,0.0024166921951053475,902,902,0,-1,3,3,8,20,454,87,600
864,6,108,418,899,481,24,24,464,464,0,0.00013615167296368154,0.00013615167296368154,516,516,0,4,4,4,8,4,231,512,718
865,3,3,442,442,0,6,6,466,466,0,3.4037918240920386e-05,3.4037918240920386e-05,407,407,0,-1,5,5,3,2,899,244,936
866,6,1646,425,1000,575,22,86,479,898,419,0.00013615167296368154,0.021648116001225366,521,995,474,1,4,2,7,1,525,592,11
867,3,3,475,475,0,5,5,429,429,0,6.807583648184077e-05,6.807583648184077e-05,450,450,0,-1,5,5,3,2,730,547,911
868,6,6,409,409,0,12,12,420,420,0,6.807583648184077e-05,6.807583648184077e-05,439,439,0,-1,4,4,4,2,410,654,675
869,26,26,674,674,0,64,64,729,729,0,0.0002382654276864427,0.0002382654276864427,576,576,0,-1,3,3,8,6,303,379,546
870,100,100,901,901,0,100,100,955,955,0,0.023179822322066782,0.023179822322066782,995,995,0,-1,1,1,7,26,477,127,864
871,47,47,862,862,0,18,18,730,730,0,0.0013615167296368155,0.0013615167296368155,849,849,0,-1,4,4,3,14,642,146,650
872,3,105,477,967,490,4,4,444,444,0,6.807583648184077e-05,0.00034037918240920387,447,655,208,4,5,5,2,2,968,724,458
873,0,0,1,1,0,0,0,1,1,0,0.0,0.0,1,1,0,-1,-1,-1,6,0,489,675,271
874,0,206,1,953,952,0,48,1,601,600,0.0,0.0031314884781646754,1,925,924,3,-1,4,10,0,355,927,88
875,2,208,367,970,603,6,14,367,490,123,3.4037918240920386e-05,0.0005446066918547262,400,716,316,3,5,4,5,2,291,292,185
876,13,13,594,594,0,18,18,534,534,0,0.00017018959120460194,0.00017018959120460194,539,539,0,-1,4,4,5,3,692,458,356
877,90,296,881,975,94,86,86,916,916,0,0.002484768031587188,0.0030974505599237552,905,923,18,3,3,3,6,15,255,158,83
878,22,124,720,942,222,8,8,528,528,0,0.0002382654276864427,0.0006807583648184077,599,766,167,4,4,4,2,11,932,162,375
879,6,212,402,948,546,34,45,423,470,47,0.0,0.0010211375472276116,1,798,797,3,4,4,15,1,68,879,227
880,67,273,881,980,99,38,38,876,876,0,0.0018380475850097008,0.0027911092957554717,888,923,35,3,3,3,3,14,801,68,218
881,0,0,1,1,0,0,0,1,1,0,0.0,0.0,1,1,0,-1,-1,-1,9,0,327,716,963
882,858,858,998,998,0,346,346,998,998,0,0.01664454201981007,0.01664454201981007,995,995,0,-1,2,2,16,85,72,0,651
883,9,9,580,580,0,16,16,566,566,0,0.0002723033459273631,0.0002723033459273631,625,625,0,-1,4,4,4,5,728,722,818
884,0,101,1,882,881,0,10,1,332,331,0.0,0.0,1,1,0,5,-1,6,10,0,206,971,597
885,2,208,350,960,610,14,22,381,440,59,0.0,0.0002382654276864427,1,581,580,3,5,4,8,1,244,503,209
886,27,27,785,785,0,12,12,608,608,0,0.0007147962830593281,0.0007147962830593281,768,768,0,-1,4,4,2,13,924,340,808
887,167,269,964,980,16,68,68,972,972,0,0.005241839409101739,0.005990673610401988,958,963,5,4,2,2,4,25,635,105,497
888,0,101,1,926,925,0,6,1,332,331,0.0,6.807583648184077e-05,1,442,441,5,-1,6,6,1,661,641,401
889,15,221,649,976,327,13,13,574,574,0,0.00017018959120460194,0.0006467204465774873,540,759,219,3,4,4,3,5,710,562,405
890,0,206,1,961,960,0,18,1,439,438,0.0,0.0006467204465774873,1,746,745,3,-1,4,8,0,158,907,396
891,0,0,1,1,0,0,0,1,1,0,0.0,0.0,1,1,0,-1,-1,-1,6,0,451,744,604
892,0,616,1,992,991,0,84,1,717,716,0.0,0.002484768031587188,1,909,908,2,-1,3,12,0,106,608,94
893,46,46,776,776,0,80,80,749,749,0,0.00034037918240920387,0.00034037918240920387,636,636,0,-1,3,3,10,9,99,212,836
894,6,108,437,913,476,18,18,463,463,0,0.00017018959120460194,0.0002042275094455223,549,579,30,4,4,4,7,1,342,531,873
895,2,104,346,874,528,20,26,358,375,17,0.0,0.00034037918240920387,1,642,641,4,5,5,17,1,23,402,459
896,16,118,674,947,273,12,12,586,586,0,0.0002723033459273631,0.0005446066918547262,621,724,103,4,4,4,2,5,596,124,121
897,12,113,549,906,357,25,25,485,485,0,0.00013615167296368154,0.0002042275094455223,525,578,53,5,4,4,9,3,190,290,401
898,16,16,633,633,0,26,26,720,720,0,0.00037441710065012424,0.00037441710065012424,665,665,0,-1,3,3,4,1,304,958,954
899,0,206,1,963,962,0,21,1,500,499,0.0,0.0006126825283365669,1,734,733,3,-1,4,7,0,477,604,177
900,33,239,860,990,130,12,12,757,757,0,0.0016678579938050988,0.008747744987916539,878,977,99,3,4,4,2,13,873,335,0
901,14,630,598,995,397,22,36,565,713,148,0.00034037918240920387,0.002110350930937064,648,897,249,2,4,3,5,5,311,362,43
902,23,23,742,742,0,18,18,658,658,0,0.0005105687736138058,0.0005105687736138058,726,726,0,-1,4,4,3,11,588,316,945
903,0,0,1,1,0,0,0,1,1,0,0.0,0.0,1,1,0,-1,-1,-1,16,0,60,358,790
904,352,558,986,994,8,96,96,991,991,0,0.011811157629599374,0.01232172640321318,986,986,0,3,2,2,3,55,737,21,288
905,28,28,786,786,0,28,28,814,814,0,0.0005105687736138058,0.0005105687736138058,724,724,0,-1,3,3,3,8,699,132,932
906,6,6,410,410,0,44,44,643,643,0,0.00010211375472276115,0.00010211375472276115,480,480,0,-1,4,4,8,1,146,609,990
907,28,234,690,965,275,42,42,630,630,0,0.0007147962830593281,0.001055175465468532,758,811,53,3,4,4,7,7,246,150,182
908,34,240,776,976,200,30,30,709,709,0,0.0005105687736138058,0.0010211375472276116,715,823,108,3,3,3,4,3,700,248,137
909,2,104,374,952,578,3,3,375,375,0,3.4037918240920386e-05,6.807583648184077e-05,397,446,49,4,5,5,2,1,830,878,717
910,24,640,674,993,319,48,58,677,767,90,0.000442492937131965,0.0010892133837094523,681,818,137,2,3,3,7,6,340,447,714
911,1,1,333,333,0,11,11,333,333,0,0.0,0.0,1,1,0,-1,6,6,11,1,139,640,745
912,67,273,847,975,128,89,90,854,854,0,0.001055175465468532,0.0013615167296368155,803,834,31,3,2,2,11,9,261,191,40
913,13,115,588,932,344,16,16,526,526,0,0.00010211375472276115,0.0004765308553728854,481,705,224,4,4,4,4,8,700,477,467
914,0,206,1,975,974,0,18,1,653,652,0.0,0.00445896728956057,1,947,946,3,-1,4,3,0,670,826,5
915,144,144,936,936,0,64,64,890,890,0,0.002586881786309949,0.002586881786309949,909,909,0,-1,3,3,4,23,503,122,678
916,6,6,452,452,0,10,10,462,462,0,0.0004084550188910446,0.0004084550188910446,678,678,0,-1,4,4,4,3,550,708,767
917,4,210,416,968,552,8,20,404,545,141,6.807583648184077e-05,0.0011913271384322134,448,836,388,3,5,4,4,2,500,549,146
918,0,101,1,933,932,0,3,1,332,331,0.0,0.00010211375472276115,1,483,482,5,-1,6,3,0,615,989,452
919,4,210,436,973,537,6,11,379,465,86,3.4037918240920386e-05,0.0005786446100956465,403,721,318,3,5,4,4,3,735,411,365
920,0,0,1,1,0,0,0,1,1,0,0.0,0.0,1,1,0,-1,-1,-1,12,0,187,923,864
921,1,617,332,998,666,3,24,332,727,395,0.0,0.0027911092957554717,1,916,915,2,7,3,3,2,900,582,125
922,0,616,1,996,995,0,42,1,706,705,0.0,0.004288777698355968,1,953,952,2,-1,3,6,1,266,456,31
923,28,130,730,929,199,34,34,638,638,0,0.00030634126416828345,0.0004084550188910446,630,671,41,4,4,4,7,9,477,191,463
924,186,186,942,942,0,108,108,891,891,0,0.003165526396405596,0.003165526396405596,930,930,0,-1,3,3,8,28,370,44,818
925,6,6,396,396,0,22,22,423,423,0,3.4037918240920386e-05,3.4037918240920386e-05,392,392,0,-1,4,4,9,2,287,662,845
926,890,890,997,997,0,318,318,998,998,0,0.014466115252391163,0.014466115252391163,989,989,0,-1,2,2,13,96,41,1,372
927,0,0,1,1,0,0,0,1,1,0,0.0,0.0,1,1,0,-1,-1,-1,11,1,248,780,888
928,0,0,1,1,0,0,0,1,1,0,0.0,0.0,1,1,0,-1,-1,-1,8,0,297,983,967
929,23,124,689,926,237,30,30,626,626,0,0.0006807583648184077,0.0007488342013002485,762,777,15,5,4,4,5,9,408,293,537
930,37,243,749,969,220,60,60,766,766,0,0.0004765308553728854,0.0008509479560230097,703,779,76,3,3,3,8,9,468,212,267
931,1,102,333,967,634,2,2,333,333,0,0.0,0.00010211375472276115,1,491,490,5,6,6,2,1,807,671,607
932,0,206,1,979,978,0,9,1,515,514,0.0,0.000442492937131965,1,696,695,3,-1,4,3,0,867,812,296
933,0,0,1,1,0,0,0,1,1,0,0.0,0.0,1,1,0,-1,-1,-1,2,0,934,699,696
934,2,2,361,361,0,10,10,420,420,0,0.0,0.0,1,1,0,-1,5,5,5,1,294,506,669
935,796,1002,999,1000,1,112,112,995,995,0,0.02188638142891181,0.02198849518363457,995,995,0,3,2,2,4,130,558,3,655
936,0,101,1,920,919,0,4,1,332,331,0.0,6.807583648184077e-05,1,456,455,5,-1,6,4,0,344,205,602
937,338,438,982,990,8,96,96,991,991,0,0.008203138296061813,0.008645631233193778,977,978,1,4,2,2,3,57,703,50,218
938,334,540,978,991,13,198,198,985,985,0,0.0057524081827155455,0.006297014874570271,967,970,3,3,2,2,10,36,135,48,169
939,0,0,1,1,0,0,0,1,1,0,0.0,0.0,1,1,0,-1,-1,-1,2,0,828,695,819
940,0,0,1,1,0,0,0,1,1,0,0.0,0.0,1,1,0,-1,-1,-1,3,0,855,778,835
941,14,116,649,948,299,7,7,493,493,0,0.0002382654276864427,0.0005105687736138058,592,720,128,4,4,4,2,3,757,653,636
942,12,114,492,885,393,48,48,470,470,0,6.807583648184077e-05,0.00013615167296368154,437,513,76,4,4,4,14,2,133,579,526
943,2,104,353,909,556,7,8,380,400,20,0.0,0.0004084550188910446,1,669,668,4,5,5,4,1,540,606,250
944,22,228,741,976,235,18,18,746,746,0,0.0006467204465774873,0.0023486163586235067,755,908,153,3,4,4,3,5,899,418,47
945,22,124,643,915,272,48,48,603,603,0,0.0002042275094455223,0.00034037918240920387,566,643,77,4,3,3,9,2,245,697,409
946,16,222,589,968,379,36,36,686,686,0,0.00030634126416828345,0.0004765308553728854,629,704,75,3,3,3,5,1,793,556,154
947,0,206,1,977,976,0,12,1,579,578,0.0,0.0033357159876101976,1,934,933,3,-1,4,2,1,586,706,25
948,0,0,1,1,0,0,0,1,1,0,0.0,0.0,1,1,0,-1,-1,-1,2,0,940,832,668
949,6,108,438,924,486,7,7,385,385,0,0.00010211375472276115,0.0002382654276864427,488,596,108,4,5,5,4,3,736,596,465
950,26,26,688,688,0,46,46,647,647,0,0.0002382654276864427,0.0002382654276864427,584,584,0,-1,3,3,8,4,508,380,564
951,98,199,884,959,75,104,104,906,906,0,0.0026889955410327104,0.0026889955410327104,906,906,0,7,2,2,9,10,388,227,663
952,0,101,1,911,910,0,4,1,332,331,0.0,6.807583648184077e-05,1,452,451,5,-1,6,4,0,622,900,755
953,32,238,771,975,204,40,40,784,784,0,0.0008509479560230097,0.002382654276864427,784,901,117,3,3,3,5,5,656,273,151
954,14,220,542,957,415,44,44,545,545,0,0.0002382654276864427,0.0006467204465774873,582,747,165,3,4,4,12,3,93,301,637
955,0,102,1,901,900,0,11,1,396,395,0.0,0.00037441710065012424,1,657,656,4,-1,5,6,0,470,959,700
956,2,103,361,907,546,9,9,385,385,0,0.0,0.0,1,1,0,5,5,5,6,1,281,606,509
957,8,110,510,917,407,21,22,497,507,10,0.00013615167296368154,0.0002382654276864427,520,588,68,4,4,4,7,5,698,231,420
958,8,109,549,938,389,14,14,500,500,0,0.0002042275094455223,0.0002723033459273631,568,612,44,5,4,4,5,4,602,278,547
959,8,110,531,925,394,16,16,544,544,0,0.00030634126416828345,0.000442492937131965,635,693,58,4,4,4,4,3,593,354,406
960,1,103,332,945,613,2,4,332,412,80,0.0,0.0004084550188910446,1,672,671,4,6,5,2,1,960,671,559
961,29,29,759,759,0,34,34,789,789,0,0.000442492937131965,0.000442492937131965,684,684,0,-1,3,3,4,8,559,132,851
962,32,648,611,990,379,146,156,664,685,21,0.00013615167296368154,0.0007488342013002485,502,743,241,2,3,3,23,4,15,149,688
963,0,0,1,1,0,0,0,1,1,0,0.0,0.0,1,1,0,-1,-1,-1,3,0,621,388,738
964,20,122,645,916,271,42,42,630,630,0,0.00013615167296368154,0.00030634126416828345,515,634,119,4,3,3,8,7,420,451,380
965,0,0,1,1,0,0,0,1,1,0,0.0,0.0,1,1,0,-1,-1,-1,3,0,864,953,635
966,0,0,1,1,0,0,0,1,1,0,0.0,0.0,1,1,0,-1,-1,-1,4,0,513,228,821
967,0,0,1,1,0,0,0,1,1,0,0.0,0.0,1,1,0,-1,-1,-1,7,1,505,573,844
968,0,206,1,959,958,0,28,1,466,465,0.0,0.00034037918240920387,1,647,646,3,-1,4,10,0,211,993,245
969,0,102,1,893,892,0,10,1,365,364,0.0,0.00010211375472276115,1,491,490,4,-1,5,8,0,186,966,361
970,14,14,559,559,0,28,28,541,541,0,0.0002042275094455223,0.0002042275094455223,575,575,0,-1,4,4,6,3,378,248,970
971,0,206,1,965,964,0,24,1,566,565,0.0,0.0015657442390823377,1,851,850,3,-1,4,6,0,446,883,206
972,95,711,884,996,112,54,54,839,839,0,0.0015317063208414173,0.012253650566731339,858,988,130,2,3,3,4,15,503,53,37
973,32,134,770,951,181,24,24,681,681,0,0.000442492937131965,0.0005446066918547262,682,718,36,4,4,4,4,11,545,162,592
974,0,102,1,933,932,0,5,1,395,394,0.0,0.0008509479560230097,1,807,806,4,-1,5,3,0,826,816,113
975,0,206,1,971,970,0,14,1,493,492,0.0,0.00088498587426393,1,791,790,3,-1,4,5,0,456,864,227
976,0,0,1,1,0,0,0,1,1,0,0.0,0.0,1,1,0,-1,-1,-1,5,0,430,751,768
977,53,259,811,970,159,98,98,882,882,0,0.001055175465468532,0.0028932230504782326,800,920,120,3,3,3,8,8,303,497,128
978,7,7,499,499,0,20,20,530,530,0,0.00013615167296368154,0.00013615167296368154,505,505,0,-1,4,4,4,2,493,749,867
979,78,78,863,863,0,98,98,917,917,0,0.002144388849177984,0.002144388849177984,889,889,0,-1,2,2,8,6,454,275,767
980,2,618,375,1000,625,4,24,377,793,416,0.0,0.0015317063208414173,1,860,859,2,5,3,3,1,953,590,224
981,0,0,1,1,0,0,0,1,1,0,0.0,0.0,1,1,0,-1,-1,-1,6,0,341,782,757
982,0,206,1,976,975,0,8,1,511,510,0.0,0.0016678579938050988,1,875,874,3,-1,4,2,1,910,685,13
983,111,111,906,906,0,74,74,922,922,0,0.004561081044283332,0.004561081044283332,955,955,0,-1,2,2,5,11,546,166,808
984,16,16,630,630,0,26,26,707,707,0,0.00010211375472276115,0.00010211375472276115,489,489,0,-1,3,3,4,1,753,720,999
985,34,136,789,949,160,30,30,732,732,0,0.0009530617107457708,0.0011232513019503727,810,828,18,4,3,3,4,10,513,272,354
986,6,622,406,991,585,40,100,528,820,292,0.00017018959120460194,0.012798257258586064,544,986,442,2,4,3,10,2,152,544,2
987,8,110,544,941,397,12,12,608,608,0,0.00017018959120460194,0.00030634126416828345,542,648,106,4,4,4,2,2,904,697,770
988,0,206,1,949,948,0,27,1,405,404,0.0,0.0004084550188910446,1,671,670,3,-1,4,13,0,41,941,371
989,0,101,1,879,878,0,18,1,332,331,0.0,0.0,1,1,0,5,-1,6,18,0,29,801,736
990,58,58,786,786,0,128,128,758,758,0,0.000442492937131965,0.000442492937131965,681,681,0,-1,3,3,16,8,42,286,478
991,6,6,453,453,0,6,6,403,403,0,0.00010211375472276115,0.00010211375472276115,491,491,0,-1,5,5,3,3,743,485,571
992,8,8,505,505,0,28,28,489,489,0,6.807583648184077e-05,6.807583648184077e-05,453,453,0,-1,4,4,8,4,225,442,834
993,2,618,346,986,640,26,71,355,465,110,0.0,0.00088498587426393,1,777,776,2,5,3,23,2,8,357,317
994,0,0,1,1,0,0,0,1,1,0,0.0,0.0,1,1,0,-1,-1,-1,9,0,166,825,539
995,6,212,397,949,552,22,28,415,446,31,0.0,6.807583648184077e-05,1,437,436,3,4,4,10,2,240,597,182
996,18,120,739,964,225,18,18,846,846,0,0.00034037918240920387,0.00037441710065012424,653,669,16,4,3,3,2,2,792,634,499
997,8,214,486,951,465,39,51,500,560,60,0.00010211375472276115,0.0014636304843595766,488,846,358,3,4,4,12,2,194,251,153
998,35,651,763,996,233,52,62,767,817,50,0.0011232513019503727,0.0026209197045508697,814,912,98,2,3,3,7,8,359,161,403
999,39,39,731,731,0,74,74,679,679,0,0.0007828721195411688,0.0007828721195411688,766,766,0,-1,3,3,11,5,167,591,975
