,FreeNet_pre_score,FreeNet_post_score,FreeNet_pre_rank,FreeNet_post_rank,FreeNet_delta_ranks,Reversed_pre_score,Reversed_post_score,Reversed_pre_rank,Reversed_post_rank,Reversed_delta_ranks,Random_pre_score,Random_post_score,Random_pre_rank,Random_post_rank,Random_delta_ranks,dist_victim_relayer,dist_victim_vilain_pre,dist_victim_vilain_post,out_deg_victim,in_deg_villain,victim,villain,relayer
0,0,102,1,916,915,0,6,1,387,386,0.0,3.4037918240920386e-05,1,401,400,4,-1,5,4,0,401,889,659
1,0,0,1,1,0,0,0,1,1,0,0.0,0.0,1,1,0,-1,-1,-1,8,0,231,961,790
2,0,102,1,930,929,0,3,1,374,373,0.0,6.807583648184077e-05,1,450,449,4,-1,5,2,0,934,517,761
3,54,54,840,840,0,34,34,727,727,0,0.0013274788113958951,0.0013274788113958951,844,844,0,-1,3,3,4,7,354,218,961
4,2,104,354,910,556,8,11,363,393,30,0.0,6.807583648184077e-05,1,441,440,4,5,5,6,2,369,764,840
5,22,22,608,608,0,76,76,611,611,0,0.0002382654276864427,0.0002382654276864427,578,578,0,-1,3,3,15,4,81,149,905
6,0,102,1,929,928,0,8,1,397,396,0.0,0.0002382654276864427,1,599,598,4,-1,5,5,0,685,983,293
7,0,101,1,935,934,0,2,1,330,329,0.0,6.807583648184077e-05,1,452,451,5,-1,6,2,0,886,790,314
8,0,206,1,959,958,0,18,1,441,440,0.0,0.0006126825283365669,1,742,741,3,-1,4,7,0,417,994,243
9,22,124,610,893,283,82,82,625,625,0,0.0005786446100956465,0.0006807583648184077,713,739,26,4,3,3,14,3,203,795,499
10,0,0,1,1,0,0,0,1,1,0,0.0,0.0,1,1,0,-1,-1,-1,8,1,443,539,988
11,0,101,1,949,948,0,4,1,331,330,0.0,0.0,1,1,0,5,-1,6,4,0,738,372,555
12,46,252,798,971,173,42,42,698,698,0,0.0007488342013002485,0.0009530617107457708,766,800,34,3,3,3,6,8,498,204,199
13,0,206,1,973,972,0,12,1,463,462,0.0,0.00010211375472276115,1,483,482,3,-1,4,5,0,570,881,508
14,2,104,373,936,563,4,4,418,418,0,0.0,0.0002382654276864427,1,608,607,4,5,5,2,1,776,337,287
15,0,206,1,962,961,0,20,1,458,457,0.0,0.0012594029749140542,1,836,835,3,-1,4,8,0,420,514,78
16,238,340,976,982,6,112,112,990,990,0,0.010483678818203479,0.01055175465468532,984,984,0,4,2,2,4,31,870,34,319
17,22,22,649,649,0,56,56,687,687,0,0.0006467204465774873,0.0006467204465774873,750,750,0,-1,3,3,9,3,422,209,906
18,24,125,805,969,164,8,8,583,583,0,0.0014636304843595766,0.001497668402600497,863,863,0,5,4,4,2,9,751,277,567
19,628,730,995,997,2,144,144,997,997,0,0.011504816365431091,0.011743081793117532,985,986,1,4,2,2,6,92,536,30,404
20,0,102,1,926,925,0,3,1,366,365,0.0,0.0002382654276864427,1,598,597,4,-1,5,2,0,932,740,454
21,0,0,1,1,0,0,0,1,1,0,0.0,0.0,1,1,0,-1,-1,-1,7,0,171,533,783
22,0,0,1,1,0,0,0,1,1,0,0.0,0.0,1,1,0,-1,-1,-1,5,0,571,801,740
23,0,206,1,966,965,0,24,1,498,497,0.0,0.0006126825283365669,1,737,736,3,-1,4,6,0,624,657,355
24,38,140,730,917,187,90,90,779,779,0,0.0007828721195411688,0.0008509479560230097,768,778,10,4,3,3,10,7,135,169,196
25,0,206,1,961,960,0,21,1,465,464,0.0,0.0002723033459273631,1,618,617,3,-1,4,8,0,646,638,170
26,0,102,1,942,941,0,3,1,379,378,0.0,0.00010211375472276115,1,485,484,4,-1,5,2,0,937,821,251
27,513,615,988,991,3,258,258,975,975,0,0.007352190340038803,0.007624493685966166,969,969,0,4,2,2,15,55,0,21,240
28,13,13,648,648,0,8,8,523,523,0,0.0002723033459273631,0.0002723033459273631,624,624,0,-1,4,4,2,6,906,486,774
29,8,8,492,492,0,30,30,491,491,0,0.00013615167296368154,0.00013615167296368154,510,510,0,-1,4,4,9,2,191,724,982
30,2,2,348,348,0,15,15,357,357,0,0.0,0.0,1,1,0,-1,5,5,13,1,41,763,725
31,0,206,1,982,981,0,9,1,563,562,0.0,0.0015657442390823377,1,862,861,3,-1,4,3,0,918,884,85
32,14,116,642,946,304,12,12,593,593,0,0.0002382654276864427,0.0004084550188910446,607,690,83,4,4,4,2,6,653,247,458
33,155,155,957,957,0,60,60,876,876,0,0.004493005207801491,0.004493005207801491,955,955,0,-1,3,3,5,28,605,41,913
34,24,24,662,662,0,70,70,729,729,0,0.000442492937131965,0.000442492937131965,675,675,0,-1,3,3,10,4,169,407,959
35,16,117,560,899,339,64,64,655,655,0,0.00017018959120460194,0.0002042275094455223,536,559,23,5,3,3,11,1,229,474,761
36,14,220,603,971,368,12,16,465,516,51,0.00017018959120460194,0.0005105687736138058,562,707,145,3,4,4,4,6,641,368,107
37,0,102,1,874,873,0,16,1,358,357,0.0,0.0,1,1,0,4,-1,5,14,0,181,970,580
38,0,206,1,958,957,0,30,1,513,512,0.0,0.0006467204465774873,1,739,738,3,-1,4,9,0,168,997,352
39,0,0,1,1,0,0,0,1,1,0,0.0,0.0,1,1,0,-1,-1,-1,9,0,388,638,957
40,22,124,723,951,228,30,30,756,756,0,0.0008509479560230097,0.0013274788113958951,793,849,56,4,3,3,4,3,673,121,490
41,59,59,852,852,0,54,54,873,873,0,0.0009870996289866913,0.0009870996289866913,808,808,0,-1,3,3,4,11,558,83,906
42,26,26,767,767,0,12,12,593,593,0,0.0009870996289866913,0.0009870996289866913,816,816,0,-1,4,4,2,5,653,273,548
43,6,107,442,928,486,10,10,453,453,0,0.00013615167296368154,0.0002042275094455223,512,553,41,5,4,4,4,2,511,690,708
44,13,115,629,943,314,8,8,484,484,0,0.00010211375472276115,0.00030634126416828345,484,648,164,4,4,4,2,5,972,310,4
45,32,32,759,759,0,18,18,603,603,0,0.0007828721195411688,0.0007828721195411688,784,784,0,-1,4,4,3,8,687,250,871
46,0,101,1,923,922,0,4,1,332,331,0.0,0.0,1,1,0,7,-1,8,4,0,475,901,469
47,8,8,542,542,0,12,12,490,490,0,0.0002042275094455223,0.0002042275094455223,575,575,0,-1,4,4,4,2,631,408,865
48,0,0,1,1,0,0,0,1,1,0,0.0,0.0,1,1,0,-1,-1,-1,3,0,626,993,996
49,0,206,1,957,956,0,18,1,451,450,0.0,0.00030634126416828345,1,642,641,3,-1,4,7,0,637,858,490
50,36,137,859,972,113,14,14,682,682,0,0.0012594029749140542,0.0013274788113958951,847,854,7,5,4,4,3,15,668,92,309
51,20,122,569,886,317,78,78,488,488,0,0.00017018959120460194,0.00017018959120460194,534,534,0,4,3,3,23,3,8,311,411
52,0,0,1,1,0,0,0,1,1,0,0.0,0.0,1,1,0,-1,-1,-1,6,0,237,961,684
53,0,206,1,969,968,0,22,1,563,562,0.0,0.003369753905851118,1,929,928,3,-1,4,5,1,290,852,142
54,0,206,1,964,963,0,22,1,484,483,0.0,0.000442492937131965,1,681,680,3,-1,4,7,0,324,945,257
55,0,206,1,956,955,0,38,1,541,540,0.0,0.0006467204465774873,1,735,734,3,-1,4,9,0,306,657,99
56,34,240,722,963,241,64,64,701,701,0,0.0002723033459273631,0.0004084550188910446,605,670,65,3,3,3,9,5,191,252,378
57,0,102,1,918,917,0,5,1,359,358,0.0,6.807583648184077e-05,1,453,452,4,-1,5,4,1,736,962,419
58,318,318,993,993,0,46,46,976,976,0,0.011266550937744648,0.011266550937744648,988,988,0,-1,2,2,2,92,702,30,573
59,0,0,1,1,0,0,0,1,1,0,0.0,0.0,1,1,0,-1,-1,-1,3,0,808,587,826
60,8,8,489,489,0,28,28,481,481,0,6.807583648184077e-05,6.807583648184077e-05,437,437,0,-1,4,4,8,3,411,441,660
61,0,0,1,1,0,0,0,1,1,0,0.0,0.0,1,1,0,-1,-1,-1,2,0,749,446,423
62,2,104,373,942,569,4,4,375,375,0,0.0,0.0002042275094455223,1,574,573,4,5,5,3,1,785,503,287
63,0,101,1,914,913,0,5,1,332,331,0.0,0.0,1,1,0,5,-1,6,5,0,531,699,781
64,122,224,893,957,64,106,106,802,802,0,0.0019061234214915416,0.0019061234214915416,880,880,0,4,3,3,11,21,162,157,592
65,0,0,1,1,0,0,0,1,1,0,0.0,0.0,1,1,0,-1,-1,-1,12,0,212,702,735
66,0,102,1,930,929,0,7,1,427,426,0.0,0.0006467204465774873,1,750,749,4,-1,5,4,0,507,358,172
67,0,102,1,913,912,0,5,1,360,359,0.0,0.0,1,1,0,4,-1,5,4,0,711,649,893
68,48,254,779,963,184,72,74,639,645,6,0.0006126825283365669,0.0009190237925048504,720,781,61,3,2,2,14,3,84,526,417
69,3,105,450,950,500,3,4,376,416,40,3.4037918240920386e-05,0.0007828721195411688,409,774,365,4,5,5,2,3,999,373,172
70,0,206,1,979,978,0,8,1,518,517,0.0,0.0006467204465774873,1,744,743,3,-1,4,2,0,977,776,479
71,136,136,961,961,0,32,32,941,941,0,0.003199564314646516,0.003199564314646516,930,930,0,-1,3,3,2,33,874,15,794
72,499,601,998,1000,2,56,56,988,988,0,0.018822968787228972,0.019129310051397258,994,995,1,4,2,2,2,127,895,11,391
73,36,36,758,758,0,36,36,626,626,0,0.0005446066918547262,0.0005446066918547262,732,732,0,-1,4,4,6,6,368,136,883
74,6,6,392,392,0,47,47,483,483,0,6.807583648184077e-05,6.807583648184077e-05,440,440,0,-1,4,4,16,1,72,935,776
75,50,151,899,978,79,22,22,909,909,0,0.0016338200755641784,0.0018720855032506212,874,888,14,5,3,3,2,12,981,99,759
76,10,112,537,918,381,15,15,483,483,0,0.0002382654276864427,0.0002723033459273631,574,605,31,4,4,4,4,4,567,443,505
77,6,108,457,930,473,26,26,648,648,0,6.807583648184077e-05,0.0014636304843595766,445,858,413,4,4,4,5,1,517,659,61
78,0,616,1,998,997,0,22,1,644,643,0.0,0.0011913271384322134,1,832,831,2,-1,3,4,3,641,854,257
79,178,384,944,979,35,146,146,917,917,0,0.0026889955410327104,0.003778208924742163,917,936,19,3,2,2,12,20,58,38,92
80,22,228,766,983,217,8,8,539,539,0,0.0006467204465774873,0.002995336805200994,752,929,177,3,4,4,2,10,760,195,13
81,1,1,333,333,0,5,5,333,333,0,0.0,0.0,1,1,0,-1,6,6,5,2,463,692,975
82,0,0,1,1,0,0,0,1,1,0,0.0,0.0,1,1,0,-1,-1,-1,7,0,366,745,890
83,38,38,805,805,0,50,50,820,820,0,0.0009870996289866913,0.0009870996289866913,805,805,0,-1,3,3,5,8,724,186,849
84,4,4,480,480,0,4,4,419,419,0,6.807583648184077e-05,6.807583648184077e-05,464,464,0,-1,5,5,2,2,897,491,820
85,0,616,1,997,996,0,30,1,737,736,0.0,0.0023486163586235067,1,907,906,2,-1,3,4,0,280,786,49
86,16,16,517,517,0,53,53,464,464,0,6.807583648184077e-05,6.807583648184077e-05,449,449,0,-1,3,3,19,1,48,807,968
87,151,357,947,984,37,64,64,934,934,0,0.0033016780693692774,0.0036760951700194017,935,939,4,3,3,3,4,30,858,39,233
88,0,206,1,969,968,0,12,1,458,457,0.0,0.0005105687736138058,1,715,714,3,-1,4,4,1,736,742,382
89,1,103,332,932,600,3,5,332,393,61,0.0,0.00013615167296368154,1,525,524,4,6,5,3,1,729,402,710
90,2,104,388,957,569,4,4,452,452,0,0.0002723033459273631,0.0005105687736138058,632,723,91,4,5,5,2,1,974,556,417
91,12,218,555,967,412,16,20,488,531,43,0.00017018959120460194,0.00088498587426393,539,793,254,3,4,4,4,4,385,315,184
92,0,0,1,1,0,0,0,1,1,0,0.0,0.0,1,1,0,-1,-1,-1,2,0,715,735,200
93,64,270,866,977,111,40,40,776,776,0,0.0018380475850097008,0.0028932230504782326,884,922,38,3,3,3,5,19,412,297,183
94,6,6,404,404,0,18,18,450,450,0,0.0,0.0,1,1,0,-1,4,4,7,1,374,623,701
95,15,631,617,997,380,16,34,517,737,220,3.4037918240920386e-05,0.0038462847612240037,408,947,539,2,4,3,4,6,652,459,88
96,0,102,1,933,932,0,5,1,402,401,0.0,0.00037441710065012424,1,669,668,4,-1,5,3,0,823,483,272
97,0,101,1,905,904,0,6,1,331,330,0.0,0.0,1,1,0,5,-1,6,6,0,356,772,543
98,8,110,560,943,383,14,14,581,581,0,3.4037918240920386e-05,0.0005105687736138058,410,712,302,4,4,4,3,3,564,300,467
99,8,214,523,968,445,20,20,566,566,0,0.00013615167296368154,0.0002042275094455223,505,563,58,3,4,4,4,4,832,239,385
100,6,108,453,921,468,10,10,470,470,0,0.00030634126416828345,0.0006807583648184077,635,756,121,4,4,4,3,1,743,452,338
101,22,22,578,578,0,92,92,541,541,0,0.0002042275094455223,0.0002042275094455223,563,563,0,-1,3,3,21,2,54,586,854
102,54,54,780,780,0,166,166,873,873,0,0.00088498587426393,0.00088498587426393,780,780,0,-1,3,3,16,4,60,470,993
103,0,206,1,962,961,0,22,1,522,521,0.0,0.0014295925661186562,1,853,852,3,-1,4,5,0,426,804,85
104,0,0,1,1,0,0,0,1,1,0,0.0,0.0,1,1,0,-1,-1,-1,2,0,997,908,740
105,28,129,795,954,159,22,22,805,805,0,0.0013274788113958951,0.0013615167296368155,854,856,2,5,3,3,2,7,939,224,492
106,8,8,504,504,0,24,24,479,479,0,0.00010211375472276115,0.00010211375472276115,485,485,0,-1,4,4,8,3,428,829,200
107,9,9,518,518,0,27,27,519,519,0,3.4037918240920386e-05,3.4037918240920386e-05,399,399,0,-1,4,4,8,3,236,572,816
108,179,795,928,999,71,266,270,936,940,4,0.0029612988869600733,0.009156200006807584,920,979,59,2,2,2,21,18,1,63,9
109,0,206,1,951,950,0,40,1,515,514,0.0,0.001055175465468532,1,811,810,3,-1,4,12,1,93,428,92
110,236,442,964,985,21,154,154,963,963,0,0.0046972327172470135,0.0053099152455835805,953,955,2,3,2,2,10,29,409,17,219
111,18,18,772,772,0,8,8,589,589,0,0.0006126825283365669,0.0006126825283365669,747,747,0,-1,4,4,2,7,481,399,898
112,0,102,1,935,934,0,5,1,399,398,0.0,0.0002042275094455223,1,584,583,4,-1,5,3,0,770,707,507
113,62,268,864,980,116,32,32,860,860,0,0.0014295925661186562,0.0016678579938050988,860,875,15,3,3,3,2,14,909,387,173
114,155,155,918,918,0,148,148,881,881,0,0.0013615167296368155,0.0013615167296368155,843,843,0,-1,3,3,13,22,41,116,968
115,21,637,665,995,330,24,34,609,711,102,0.0004765308553728854,0.003914360597705844,700,945,245,2,4,3,4,8,509,417,57
116,59,59,789,789,0,148,148,821,821,0,0.0008509479560230097,0.0008509479560230097,772,772,0,-1,3,3,16,9,26,293,388
117,26,26,735,735,0,30,30,676,676,0,0.00034037918240920387,0.00034037918240920387,644,644,0,-1,4,4,5,7,326,253,988
118,8,110,549,938,389,14,14,500,500,0,3.4037918240920386e-05,0.00017018959120460194,402,543,141,4,4,4,5,2,602,724,544
119,6,107,527,959,432,8,8,576,576,0,0.0002382654276864427,0.00030634126416828345,609,649,40,5,4,4,2,1,974,741,810
120,42,248,813,977,164,62,62,953,953,0,0.003267640151128357,0.0036760951700194017,931,936,5,3,2,2,3,4,687,440,610
121,0,0,1,1,0,0,0,1,1,0,0.0,0.0,1,1,0,-1,-1,-1,7,0,466,831,823
122,0,101,1,914,913,0,5,1,332,331,0.0,6.807583648184077e-05,1,454,453,5,-1,6,5,0,314,729,550
123,0,101,1,965,964,0,2,1,332,331,0.0,0.0,1,1,0,6,-1,7,2,0,873,488,225
124,26,26,790,790,0,22,22,818,818,0,0.0007488342013002485,0.0007488342013002485,763,763,0,-1,3,3,2,7,838,134,925
125,0,102,1,951,950,0,4,1,419,418,0.0,0.0014636304843595766,1,862,861,4,-1,5,2,0,686,855,27
126,6,108,455,936,481,26,26,644,644,0,0.00017018959120460194,0.000442492937131965,547,693,146,4,4,4,5,2,848,223,365
127,10,112,551,923,372,16,16,523,523,0,0.00010211375472276115,0.00017018959120460194,477,542,65,4,4,4,4,3,711,369,625
128,0,0,1,1,0,0,0,1,1,0,0.0,0.0,1,1,0,-1,-1,-1,8,0,199,858,641
129,61,677,829,995,166,56,74,683,791,108,0.0008509479560230097,0.0036760951700194017,781,937,156,2,3,3,9,12,319,159,44
130,38,244,718,961,243,82,82,684,684,0,0.00034037918240920387,0.0004765308553728854,636,690,54,3,3,3,12,7,44,237,251
131,0,101,1,886,885,0,9,1,332,331,0.0,3.4037918240920386e-05,1,401,400,5,-1,6,9,0,208,620,398
132,20,20,785,785,0,18,18,781,781,0,0.0004765308553728854,0.0004765308553728854,723,723,0,-1,4,4,3,4,853,470,455
133,83,289,883,976,93,46,46,737,737,0,0.0013274788113958951,0.0017018959120460194,833,861,28,3,3,3,6,17,549,327,169
134,104,310,941,987,46,32,32,912,912,0,0.0030974505599237552,0.0037441710065012424,935,949,14,3,3,3,2,19,747,133,219
135,79,79,868,868,0,82,82,888,888,0,0.002484768031587188,0.002484768031587188,912,912,0,-1,3,3,7,14,400,146,930
136,0,0,1,1,0,0,0,1,1,0,0.0,0.0,1,1,0,-1,-1,-1,5,0,531,822,800
137,2,104,359,906,547,9,10,396,409,13,0.0,6.807583648184077e-05,1,452,451,4,5,5,5,1,474,618,360
138,0,0,1,1,0,0,0,1,1,0,0.0,0.0,1,1,0,-1,-1,-1,18,0,29,908,735
139,84,290,918,984,66,56,56,981,981,0,0.00704584907587052,0.007182000748834201,967,967,0,3,2,2,2,13,776,217,557
140,52,258,736,961,225,260,260,927,927,0,0.0010892133837094523,0.0012594029749140542,807,820,13,3,2,2,21,3,1,642,86
141,0,0,1,1,0,0,0,1,1,0,0.0,0.0,1,1,0,-1,-1,-1,7,0,209,839,356
142,12,114,540,909,369,28,28,510,510,0,0.00037441710065012424,0.0004765308553728854,666,699,33,4,4,4,8,2,142,524,230
143,0,101,1,945,944,0,2,1,331,330,0.0,0.0,1,1,0,6,-1,7,2,0,838,921,402
144,27,233,711,972,261,38,38,686,686,0,6.807583648184077e-05,0.0011913271384322134,440,830,390,3,3,3,6,6,624,199,174
145,9,625,483,991,508,44,100,467,687,220,0.0,0.0036760951700194017,1,938,937,2,4,3,14,4,127,442,88
146,376,478,995,998,3,56,56,989,989,0,0.018788930868988054,0.019163347969638176,995,996,1,4,2,2,2,96,841,1,351
147,27,643,708,995,287,44,58,640,744,104,0.0009190237925048504,0.004118588107151367,798,945,147,2,4,3,8,7,420,399,8
148,40,141,755,913,158,54,54,647,647,0,0.0004765308553728854,0.0004765308553728854,696,696,0,5,3,3,9,4,274,164,484
149,6,6,381,381,0,50,50,516,516,0,3.4037918240920386e-05,3.4037918240920386e-05,394,394,0,-1,4,4,13,2,92,325,674
150,0,102,1,917,916,0,8,1,406,405,0.0,0.00030634126416828345,1,618,617,4,-1,5,4,1,822,730,510
151,6,212,454,968,514,16,21,474,524,50,0.0002723033459273631,0.000442492937131965,612,693,81,3,4,4,7,2,697,325,302
152,4,1644,470,1000,530,6,44,450,963,513,0.0002723033459273631,0.03427618366860683,629,997,368,1,5,2,3,4,569,149,100
153,2,208,353,959,606,12,20,370,428,58,0.0,0.00013615167296368154,1,501,500,3,5,4,9,1,389,734,149
154,2,104,390,964,574,3,4,395,486,91,3.4037918240920386e-05,0.0005105687736138058,402,725,323,4,5,5,2,1,981,463,174
155,2,2,359,359,0,4,4,360,360,0,0.0,0.0,1,1,0,-1,5,5,3,2,620,320,400
156,12,113,626,940,314,14,14,597,597,0,0.0002382654276864427,0.0002382654276864427,605,605,0,5,4,4,3,4,774,149,579
157,33,239,848,990,142,22,22,892,892,0,0.0019061234214915416,0.002212464685659825,892,912,20,3,3,3,2,5,997,589,810
158,0,102,1,886,885,0,12,1,361,360,0.0,0.00013615167296368154,1,517,516,4,-1,5,9,1,276,705,805
159,24,126,692,932,240,22,22,581,581,0,0.0002042275094455223,0.00037441710065012424,572,667,95,4,4,4,5,4,692,259,749
160,30,132,800,958,158,12,12,616,616,0,0.0013955546478777359,0.0014295925661186562,861,862,1,4,4,4,2,8,804,174,124
161,21,227,712,974,262,18,18,631,631,0,0.0004084550188910446,0.00088498587426393,672,791,119,3,4,4,3,8,923,257,710
162,87,293,911,984,73,28,28,808,808,0,0.0020082371762143027,0.0024507301133462676,891,905,14,3,3,3,3,19,745,59,115
163,16,222,604,969,365,32,40,682,722,40,0.00034037918240920387,0.0024507301133462676,638,905,267,3,3,3,5,1,390,891,38
164,7,7,547,547,0,14,14,590,590,0,6.807583648184077e-05,6.807583648184077e-05,452,452,0,-1,4,4,3,2,716,22,913
165,26,232,747,977,230,18,18,589,589,0,0.0002042275094455223,0.0007147962830593281,582,762,180,3,4,4,3,6,819,683,194
166,28,28,731,731,0,30,30,702,702,0,0.0006126825283365669,0.0006126825283365669,739,739,0,-1,3,3,4,5,572,306,729
167,0,206,1,965,964,0,34,1,605,604,0.0,0.0009870996289866913,1,799,798,3,-1,4,7,0,658,992,53
168,0,102,1,902,901,0,13,1,370,369,0.0,0.00013615167296368154,1,520,519,4,-1,5,11,0,261,254,332
169,1,207,332,978,646,2,12,332,674,342,0.0,0.0030974505599237552,1,925,924,3,6,4,2,1,757,893,25
170,18,18,628,628,0,34,34,647,647,0,0.00034037918240920387,0.00034037918240920387,635,635,0,-1,3,3,6,4,473,270,852
171,16,118,607,922,315,24,24,545,545,0,3.4037918240920386e-05,0.0002723033459273631,400,618,218,4,4,4,6,4,266,156,229
172,19,635,665,998,333,12,40,513,843,330,0.000442492937131965,0.00445896728956057,695,952,257,2,4,3,4,9,949,198,81
173,20,226,665,969,304,22,26,504,532,28,0.00030634126416828345,0.0007147962830593281,634,756,122,3,4,4,7,6,497,424,80
174,2,104,348,890,542,11,18,348,393,45,0.0,0.000442492937131965,1,672,671,4,5,5,10,2,259,721,473
175,0,206,1,951,950,0,36,1,428,427,0.0,0.0005105687736138058,1,702,701,3,-1,4,15,3,32,348,473
176,14,220,631,972,341,26,30,658,709,51,0.0002723033459273631,0.0011232513019503727,622,823,201,3,4,4,5,8,795,521,535
177,12,12,536,536,0,44,44,640,640,0,0.0004765308553728854,0.0004765308553728854,695,695,0,-1,4,4,8,3,415,209,701
178,6,212,420,965,545,30,34,502,532,30,6.807583648184077e-05,0.0005105687736138058,457,710,253,3,4,4,9,2,180,648,382
179,6,108,399,889,490,52,52,491,491,0,6.807583648184077e-05,0.00013615167296368154,445,505,60,4,4,4,16,2,78,719,648
180,0,616,1,996,995,0,28,1,737,736,0.0,0.0026209197045508697,1,905,904,2,-1,3,3,0,989,356,78
181,52,154,796,926,130,66,66,681,681,0,0.0007147962830593281,0.0008169100377820892,753,770,17,4,3,3,11,7,215,396,191
182,1,103,332,957,625,2,4,332,451,119,0.0,0.0005105687736138058,1,724,723,4,6,5,2,3,974,578,375
183,429,531,991,996,5,80,80,968,968,0,0.012559991830899623,0.012798257258586064,988,988,0,4,3,3,5,85,291,0,634
184,0,102,1,894,893,0,15,1,397,396,0.0,0.0002382654276864427,1,587,586,4,-1,5,8,0,231,644,688
185,18,120,607,902,295,48,48,574,574,0,0.00037441710065012424,0.000442492937131965,657,687,30,4,4,4,10,8,82,521,322
186,0,101,1,883,882,0,12,1,332,331,0.0,0.0,1,1,0,5,-1,6,12,0,143,769,721
187,97,97,914,914,0,28,28,778,778,0,0.0028591851322373124,0.0028591851322373124,913,913,0,-1,3,3,3,25,855,47,998
188,0,0,1,1,0,0,0,1,1,0,0.0,0.0,1,1,0,-1,-1,-1,6,0,515,923,945
189,13,114,675,957,282,18,18,707,707,0,0.0005105687736138058,0.0005105687736138058,710,710,0,6,4,4,3,5,798,216,590
190,48,149,800,928,128,70,70,819,819,0,0.0017018959120460194,0.0017018959120460194,865,865,0,7,2,2,8,7,236,451,344
191,42,248,816,975,159,62,62,891,891,0,0.0011232513019503727,0.0014295925661186562,819,843,24,3,3,3,6,6,494,114,482
192,1,617,333,996,663,3,28,333,724,391,0.0,0.002586881786309949,1,906,905,2,7,3,3,1,459,469,63
193,0,101,1,949,948,0,2,1,331,330,0.0,0.0,1,1,0,6,-1,7,2,0,702,959,708
194,0,206,1,952,951,0,23,1,415,414,0.0,0.0004765308553728854,1,689,688,3,-1,4,10,1,205,693,216
195,19,121,755,969,214,8,8,552,552,0,0.0005446066918547262,0.0009190237925048504,740,800,60,4,4,4,2,8,889,284,479
196,6,108,412,905,493,44,44,630,630,0,0.00017018959120460194,0.0009870996289866913,541,804,263,4,4,4,8,1,334,741,166
197,70,171,868,959,91,40,40,760,760,0,0.0013274788113958951,0.0013274788113958951,852,852,0,7,3,3,5,16,766,78,765
198,0,0,1,1,0,0,0,1,1,0,0.0,0.0,1,1,0,-1,-1,-1,4,0,516,905,984
199,26,128,764,946,182,26,26,679,679,0,0.0007488342013002485,0.0010211375472276116,778,812,34,4,4,4,5,9,685,245,535
200,24,125,792,965,173,12,12,691,691,0,0.0007488342013002485,0.0007828721195411688,767,772,5,6,4,4,2,5,967,308,602
201,6,212,458,972,514,14,14,552,552,0,0.00013615167296368154,0.0013955546478777359,536,860,324,3,4,4,3,1,672,958,304
202,2,2,348,348,0,20,20,348,348,0,0.0,0.0,1,1,0,-1,5,5,19,1,83,671,358
203,5,107,467,930,463,8,8,436,436,0,0.00030634126416828345,0.0004765308553728854,641,702,61,4,5,5,4,3,706,653,561
204,0,102,1,933,932,0,6,1,463,462,0.0,0.0005105687736138058,1,705,704,4,-1,5,3,0,823,847,114
205,16,222,645,972,327,24,24,725,725,0,0.0002382654276864427,0.0012594029749140542,601,834,233,3,3,3,3,1,836,718,106
206,0,0,1,1,0,0,0,1,1,0,0.0,0.0,1,1,0,-1,-1,-1,6,0,341,758,514
207,0,0,1,1,0,0,0,1,1,0,0.0,0.0,1,1,0,-1,-1,-1,2,0,702,707,455
208,0,206,1,947,946,0,21,1,395,394,0.0,0.0002042275094455223,1,563,562,3,-1,4,12,0,292,574,341
209,18,224,577,951,374,38,42,448,469,21,0.00017018959120460194,0.0002042275094455223,529,557,28,3,4,4,13,3,115,596,592
210,6,107,490,946,456,8,8,508,508,0,6.807583648184077e-05,6.807583648184077e-05,463,463,0,7,4,4,3,1,871,807,703
211,0,102,1,873,872,0,15,1,355,354,0.0,6.807583648184077e-05,1,435,434,4,-1,5,13,0,120,993,550
212,0,0,1,1,0,0,0,1,1,0,0.0,0.0,1,1,0,-1,-1,-1,3,0,554,669,794
213,2,2,359,359,0,4,4,393,393,0,0.00010211375472276115,0.00010211375472276115,481,481,0,-1,5,5,2,1,828,687,752
214,215,215,957,957,0,166,166,948,948,0,0.0046972327172470135,0.0046972327172470135,947,947,0,-1,2,2,12,24,93,13,834
215,36,652,677,992,315,92,140,570,711,141,0.00010211375472276115,0.002757071377514551,472,913,441,2,3,3,19,5,19,310,74
216,10,10,503,503,0,32,32,420,420,0,3.4037918240920386e-05,3.4037918240920386e-05,406,406,0,-1,4,4,15,3,95,526,757
217,1,1,333,333,0,10,10,333,333,0,0.0,0.0,1,1,0,-1,6,6,10,1,272,861,611
218,0,102,1,893,892,0,14,1,393,392,0.0,0.00013615167296368154,1,525,524,4,-1,5,8,0,186,794,521
219,16,118,599,924,325,28,28,554,554,0,0.00017018959120460194,0.0002042275094455223,544,576,32,4,3,3,7,1,400,360,899
220,10,112,607,950,343,8,8,510,510,0,6.807583648184077e-05,0.00010211375472276115,451,498,47,4,4,4,2,5,964,241,935
221,0,0,1,1,0,0,0,1,1,0,0.0,0.0,1,1,0,-1,-1,-1,4,0,885,673,880
222,60,676,780,995,215,162,182,828,867,39,0.0010892133837094523,0.006467204465774873,809,963,154,2,3,3,17,6,103,114,9
223,109,211,943,976,33,38,38,902,902,0,0.0034718676605738795,0.003710133088260322,932,938,6,4,3,3,3,27,639,69,4
224,56,158,816,941,125,72,72,819,819,0,0.0009190237925048504,0.0010892133837094523,780,810,30,4,3,3,7,15,346,137,406
225,0,102,1,954,953,0,4,1,427,426,0.0,0.0007828721195411688,1,783,782,4,-1,5,2,0,946,822,183
226,3,105,455,950,495,3,3,376,376,0,6.807583648184077e-05,0.0006807583648184077,448,761,313,4,5,5,2,3,760,196,226
227,10,112,609,950,341,8,8,505,505,0,0.00030634126416828345,0.0009530617107457708,642,814,172,4,4,4,2,5,896,454,413
228,0,206,1,951,950,0,23,1,424,423,0.0,0.0004084550188910446,1,664,663,3,-1,4,11,0,215,565,240
229,12,114,563,913,350,20,20,488,488,0,0.00017018959120460194,0.00037441710065012424,537,658,121,4,4,4,6,2,419,425,636
230,57,263,839,978,139,50,50,791,791,0,0.0011913271384322134,0.0020763130126961434,825,885,60,3,3,3,5,15,492,137,193
231,29,131,803,958,155,18,18,695,695,0,0.0009190237925048504,0.0016678579938050988,808,875,67,4,4,4,3,9,862,294,289
232,0,102,1,944,943,0,4,1,421,420,0.0,0.00034037918240920387,1,659,658,4,-1,5,2,0,986,665,467
233,6,6,461,461,0,24,24,734,734,0,0.0004765308553728854,0.0004765308553728854,694,694,0,-1,4,4,4,1,491,759,930
234,0,101,1,944,943,0,3,1,332,331,0.0,6.807583648184077e-05,1,445,444,5,-1,6,3,0,642,833,337
235,6,212,460,973,513,12,12,562,562,0,0.0002382654276864427,0.0006467204465774873,603,749,146,3,4,4,2,4,971,409,377
236,0,102,1,915,914,0,7,1,385,384,0.0,0.000442492937131965,1,698,697,4,-1,5,4,2,444,709,379
237,0,206,1,980,979,0,8,1,522,521,0.0,0.0015657442390823377,1,865,864,3,-1,4,2,0,942,900,43
238,0,0,1,1,0,0,0,1,1,0,0.0,0.0,1,1,0,-1,-1,-1,4,0,503,776,981
239,34,240,728,964,236,58,58,709,709,0,0.00030634126416828345,0.0013274788113958951,618,832,214,3,3,3,8,4,358,259,175
240,2,104,368,942,574,5,6,407,444,37,6.807583648184077e-05,0.00017018959120460194,449,538,89,4,5,5,3,2,693,575,29
241,70,686,818,993,175,108,122,736,787,51,0.0011913271384322134,0.002552843868069029,823,911,88,2,2,2,14,6,203,376,148
242,0,0,1,1,0,0,0,1,1,0,0.0,0.0,1,1,0,-1,-1,-1,9,0,140,843,906
243,86,292,835,966,131,190,190,840,840,0,0.0012594029749140542,0.0018040096667687805,828,877,49,3,3,3,19,14,46,190,29
244,0,616,1,999,998,0,38,1,885,884,0.0,0.005820484019197386,1,964,963,2,-1,3,3,0,670,740,8
245,16,16,650,650,0,14,14,564,564,0,0.0004084550188910446,0.0004084550188910446,678,678,0,-1,4,4,3,4,855,328,802
246,31,133,789,944,155,38,38,768,768,0,0.0008169100377820892,0.0009870996289866913,781,813,32,4,3,3,6,6,594,232,191
247,14,220,534,955,421,50,54,574,588,14,0.0002382654276864427,0.0005786446100956465,581,724,143,3,4,4,11,5,139,362,827
248,21,21,710,710,0,18,18,635,635,0,0.0006467204465774873,0.0006467204465774873,748,748,0,-1,4,4,3,6,627,516,909
249,40,40,738,738,0,104,104,860,860,0,0.0008509479560230097,0.0008509479560230097,781,781,0,-1,3,3,9,6,100,490,388
250,0,101,1,909,908,0,7,1,332,331,0.0,0.0,1,1,0,5,-1,6,7,0,477,998,543
251,106,312,909,981,72,80,80,919,919,0,0.0025188059498281084,0.0030974505599237552,911,930,19,3,2,2,6,13,402,261,249
252,39,141,846,969,123,22,22,909,909,0,0.0018040096667687805,0.0018040096667687805,884,884,0,4,3,3,2,10,821,227,347
253,2,618,360,997,637,5,28,380,730,350,3.4037918240920386e-05,0.006705469893461316,409,976,567,2,5,3,3,1,819,687,19
254,0,0,1,1,0,0,0,1,1,0,0.0,0.0,1,1,0,-1,-1,-1,2,0,723,905,641
255,70,172,890,967,77,22,22,780,780,0,0.002484768031587188,0.002757071377514551,904,913,9,4,3,3,2,16,429,78,365
256,64,680,857,997,140,34,44,722,817,95,0.0007147962830593281,0.002825147213996392,762,916,154,2,3,3,4,10,516,405,84
257,6,622,405,995,590,22,40,436,571,135,3.4037918240920386e-05,0.0010211375472276116,409,809,400,2,4,3,9,1,803,935,103
258,128,128,907,907,0,126,126,906,906,0,0.0032336022328874367,0.0032336022328874367,927,927,0,-1,3,3,11,19,271,135,929
259,64,165,856,954,98,50,50,822,822,0,0.0017018959120460194,0.0017359338302869397,870,871,1,5,3,3,5,17,677,269,460
260,8,8,578,578,0,8,8,542,542,0,0.0002042275094455223,0.0002042275094455223,582,582,0,-1,4,4,2,3,548,121,745
261,1,1,332,332,0,2,2,332,332,0,0.0,0.0,1,1,0,-1,7,7,2,1,985,603,969
262,8,8,525,525,0,20,20,570,570,0,0.00013615167296368154,0.00013615167296368154,514,514,0,-1,4,4,4,4,652,442,953
263,6,108,382,881,499,66,66,519,519,0,6.807583648184077e-05,0.0002042275094455223,448,557,109,4,4,4,17,1,6,797,631
264,0,206,1,971,970,0,20,1,594,593,0.0,0.002757071377514551,1,917,916,3,-1,4,4,0,559,699,126
265,0,102,1,914,913,0,8,1,421,420,0.0,0.0004084550188910446,1,690,689,4,-1,5,4,0,512,750,333
266,0,0,1,1,0,0,0,1,1,0,0.0,0.0,1,1,0,-1,-1,-1,14,0,130,673,744
267,6,6,371,371,0,46,46,402,402,0,0.00010211375472276115,0.00010211375472276115,468,468,0,-1,4,4,23,3,15,755,515
268,202,202,976,976,0,32,32,911,911,0,0.006126825283365669,0.006126825283365669,965,965,0,-1,3,3,2,57,734,50,760
269,0,206,1,982,981,0,8,1,518,517,0.0,0.005241839409101739,1,961,960,3,-1,4,2,0,938,985,32
270,0,101,1,957,956,0,2,1,330,329,0.0,0.0,1,1,0,5,-1,6,2,0,985,783,481
271,49,49,812,812,0,48,48,730,730,0,0.0007488342013002485,0.0007488342013002485,768,768,0,-1,3,3,7,13,336,340,919
272,2,2,367,367,0,7,7,399,399,0,0.0,0.0,1,1,0,-1,5,5,4,1,740,878,650
273,1,207,333,960,627,7,18,333,447,114,0.0,6.807583648184077e-05,1,443,442,3,6,4,7,1,340,621,305
274,2,208,365,972,607,3,7,367,456,89,6.807583648184077e-05,0.00037441710065012424,448,672,224,3,5,4,2,1,932,555,52
275,14,630,537,991,454,32,50,499,624,125,6.807583648184077e-05,0.0019741992579733825,449,878,429,2,4,3,8,3,370,485,98
276,34,136,699,914,215,102,102,805,805,0,0.0004765308553728854,0.0005786446100956465,693,719,26,4,3,3,12,4,292,407,443
277,3,3,441,441,0,4,4,372,372,0,0.0,0.0,1,1,0,-1,5,5,3,3,590,563,985
278,110,110,950,950,0,38,38,930,930,0,0.0026209197045508697,0.0026209197045508697,913,913,0,-1,3,3,3,34,916,89,895
279,0,1640,1,1000,999,0,66,1,778,777,0.0,0.013581129378127233,1,985,984,1,-1,2,8,0,137,686,128
280,24,230,722,977,255,18,18,647,647,0,0.0009870996289866913,0.0034037918240920387,813,928,115,3,4,4,3,7,829,399,26
281,21,121,700,937,237,18,18,589,589,0,0.0007147962830593281,0.0007147962830593281,762,762,0,5,4,4,3,6,819,232,692
282,44,146,781,930,149,70,70,749,749,0,0.0005446066918547262,0.0007828721195411688,721,771,50,4,3,3,10,7,427,422,516
283,20,226,687,973,286,18,18,605,605,0,0.0005786446100956465,0.0012253650566731338,738,832,94,3,4,4,3,4,836,40,113
284,17,223,677,978,301,14,14,559,559,0,0.0005786446100956465,0.0013274788113958951,745,849,104,3,4,4,3,6,833,467,399
285,6,108,398,894,496,54,54,541,541,0,6.807583648184077e-05,6.807583648184077e-05,440,440,0,4,4,4,15,1,110,152,334
286,0,102,1,924,923,0,5,1,389,388,0.0,0.00034037918240920387,1,651,650,4,-1,5,3,1,337,742,256
287,0,102,1,936,935,0,5,1,395,394,0.0,0.0004084550188910446,1,684,683,4,-1,5,3,0,863,981,237
288,2,618,367,999,632,6,24,417,763,346,6.807583648184077e-05,0.0053099152455835805,450,958,508,2,5,3,3,2,912,550,183
289,17,119,649,929,280,60,60,897,897,0,0.0008509479560230097,0.0010211375472276116,789,808,19,4,3,3,5,3,487,299,4
290,0,0,1,1,0,0,0,1,1,0,0.0,0.0,1,1,0,-1,-1,-1,3,0,863,942,856
291,12,114,638,948,310,12,12,608,608,0,0.0006126825283365669,0.0012934408931549745,739,843,104,4,4,4,2,5,713,535,99
292,0,102,1,948,947,0,6,1,396,395,0.0,0.00034037918240920387,1,657,656,4,-1,5,4,0,480,783,299
293,0,616,1,996,995,0,40,1,705,704,0.0,0.003982436434187685,1,943,942,2,-1,3,5,1,408,583,88
294,44,660,710,990,280,114,132,665,716,51,0.00030634126416828345,0.0009190237925048504,615,785,170,2,3,3,19,6,11,435,90
295,0,616,1,997,996,0,44,1,764,763,0.0,0.004799346471969774,1,957,956,2,-1,3,6,0,451,758,27
296,18,634,586,991,405,88,102,687,763,76,0.00017018959120460194,0.003914360597705844,535,943,408,2,3,3,12,2,239,323,105
297,2,104,380,949,569,5,5,415,415,0,0.0002723033459273631,0.0004084550188910446,629,690,61,4,5,5,3,1,569,527,162
298,34,135,748,922,174,46,46,750,750,0,0.0011232513019503727,0.001157289220191293,822,823,1,5,3,3,6,4,536,281,572
299,100,100,883,883,0,100,100,834,834,0,0.01674665577453283,0.01674665577453283,991,991,0,-1,1,1,11,26,176,127,633
300,0,206,1,972,971,0,10,1,472,471,0.0,0.0008169100377820892,1,780,779,3,-1,4,3,1,585,742,269
301,1,103,331,938,607,3,4,331,382,51,0.0,0.0002042275094455223,1,582,581,4,6,5,3,1,871,671,341
302,26,232,708,971,263,40,40,704,704,0,0.0002382654276864427,0.0012934408931549745,590,834,244,3,3,3,5,5,818,124,62
303,96,296,906,980,74,52,52,838,838,0,0.0021784267674189047,0.0027911092957554717,897,921,24,3,3,3,6,16,657,78,80
304,0,0,1,1,0,0,0,1,1,0,0.0,0.0,1,1,0,-1,-1,-1,7,0,466,644,940
305,6,212,461,976,515,12,12,584,584,0,0.00010211375472276115,0.0006126825283365669,498,738,240,3,4,4,2,1,429,799,67
306,0,206,1,948,947,0,64,1,561,560,0.0,0.0013955546478777359,1,840,839,3,-1,4,14,0,172,367,183
307,40,246,756,967,211,54,54,667,667,0,0.0011232513019503727,0.0016338200755641784,810,867,57,3,4,4,9,8,330,352,185
308,1,102,332,935,603,2,2,332,332,0,0.0,3.4037918240920386e-05,1,403,402,5,7,6,2,1,993,621,842
309,120,220,945,972,27,54,54,929,929,0,0.0034037918240920387,0.0035059055788147996,934,934,0,4,3,3,4,29,633,142,454
310,25,127,672,911,239,76,76,723,723,0,0.0002723033459273631,0.00030634126416828345,613,644,31,4,3,3,10,5,75,454,274
311,0,0,1,1,0,0,0,1,1,0,0.0,0.0,1,1,0,-1,-1,-1,7,0,366,514,914
312,188,289,970,979,9,84,84,967,967,0,0.005956635692161067,0.005990673610401988,964,967,3,5,2,2,5,27,647,88,337
313,0,206,1,981,980,0,12,1,684,683,0.0,0.0027911092957554717,1,924,923,3,-1,4,2,0,792,644,74
314,6,6,469,469,0,12,12,604,604,0,0.00010211375472276115,0.00010211375472276115,492,492,0,-1,4,4,2,3,589,309,946
315,0,0,1,1,0,0,0,1,1,0,0.0,0.0,1,1,0,-1,-1,-1,10,0,205,803,533
316,19,120,741,952,211,8,8,519,519,0,0.0002382654276864427,0.0002382654276864427,622,622,0,6,4,4,2,8,802,386,563
317,0,206,1,972,971,0,8,1,465,464,0.0,0.0006807583648184077,1,755,754,3,-1,4,2,0,905,892,375
318,6,108,457,933,476,14,14,477,477,0,0.00010211375472276115,0.0002382654276864427,488,600,112,4,4,4,6,2,486,325,368
319,6,212,462,974,512,12,16,497,568,71,0.0002042275094455223,0.0004084550188910446,580,695,115,3,4,4,4,1,673,840,619
320,0,0,1,1,0,0,0,1,1,0,0.0,0.0,1,1,0,-1,-1,-1,11,0,360,483,632
321,46,662,751,992,241,170,180,880,895,15,0.0009190237925048504,0.004629156880765172,789,945,156,2,2,2,16,3,151,525,34
322,0,102,1,925,924,0,6,1,366,365,0.0,0.00010211375472276115,1,488,487,4,-1,5,5,0,848,823,332
323,0,102,1,884,883,0,11,1,365,364,0.0,3.4037918240920386e-05,1,395,394,4,-1,5,9,0,202,372,680
324,0,102,1,899,898,0,9,1,387,386,0.0,3.4037918240920386e-05,1,398,397,4,-1,5,5,0,349,716,550
325,0,0,1,1,0,0,0,1,1,0,0.0,0.0,1,1,0,-1,-1,-1,7,1,361,947,930
326,30,30,780,780,0,34,34,797,797,0,0.0007147962830593281,0.0007147962830593281,755,755,0,-1,3,3,4,7,706,176,974
327,14,14,546,546,0,28,28,481,481,0,0.00013615167296368154,0.00013615167296368154,507,507,0,-1,4,4,8,3,411,369,988
328,14,14,508,508,0,102,102,620,620,0,0.00030634126416828345,0.00030634126416828345,620,620,0,-1,4,4,21,4,2,501,757
329,14,220,594,970,376,22,30,542,626,84,0.00010211375472276115,0.0008509479560230097,486,792,306,3,4,4,5,3,474,307,440
330,0,0,1,1,0,0,0,1,1,0,0.0,0.0,1,1,0,-1,-1,-1,6,0,402,798,769
331,2,104,361,906,545,8,10,368,387,19,6.807583648184077e-05,0.00013615167296368154,447,509,62,4,5,5,6,1,328,503,531
332,1,1,333,333,0,3,3,333,333,0,0.0,0.0,1,1,0,-1,6,6,3,1,627,469,822
333,58,160,838,953,115,58,58,920,920,0,0.0027911092957554717,0.002927260968719153,912,916,4,4,2,2,4,4,887,185,360
334,6,6,396,396,0,44,44,444,444,0,0.0002382654276864427,0.0002382654276864427,586,586,0,-1,4,4,17,2,112,805,673
335,34,34,698,698,0,71,71,593,593,0,0.0002723033459273631,0.0002723033459273631,601,601,0,-1,3,3,15,4,81,210,966
336,0,101,1,969,968,0,2,1,331,330,0.0,6.807583648184077e-05,1,448,447,6,-1,7,2,0,959,825,313
337,34,34,798,798,0,40,40,817,817,0,0.0006807583648184077,0.0006807583648184077,751,751,0,-1,3,3,5,7,376,150,982
338,0,102,1,889,888,0,9,1,357,356,0.0,0.0,1,1,0,4,-1,5,8,1,236,828,463
339,35,137,809,951,142,34,34,857,857,0,0.0005786446100956465,0.0005786446100956465,742,742,0,4,3,3,3,4,864,557,771
340,16,118,656,937,281,24,24,681,681,0,0.0002382654276864427,0.0004765308553728854,595,704,109,4,4,4,4,5,619,252,473
341,9,111,580,941,361,18,18,708,708,0,0.0004765308553728854,0.00088498587426393,714,809,95,4,4,4,3,4,826,287,204
342,13,13,537,537,0,25,25,441,441,0,3.4037918240920386e-05,3.4037918240920386e-05,401,401,0,-1,4,4,9,3,164,411,914
343,0,0,1,1,0,0,0,1,1,0,0.0,0.0,1,1,0,-1,-1,-1,2,3,932,753,713
344,190,292,968,981,13,72,72,987,987,0,0.0063650907110521125,0.006433166547533953,965,966,1,4,2,2,3,37,842,74,654
345,6,108,399,888,489,23,25,396,408,12,3.4037918240920386e-05,0.0002042275094455223,403,575,172,4,4,4,12,1,44,337,365
346,29,29,657,657,0,96,96,664,664,0,0.0004084550188910446,0.0004084550188910446,663,663,0,-1,3,3,15,5,37,510,925
347,0,206,1,983,982,0,7,1,528,527,0.0,0.0011913271384322134,1,840,839,3,-1,4,2,0,821,957,63
348,22,123,691,925,234,42,42,705,705,0,0.0006807583648184077,0.0007147962830593281,763,767,4,5,3,3,6,3,526,209,563
349,16,16,603,603,0,38,38,596,596,0,0.00010211375472276115,0.00010211375472276115,479,479,0,-1,3,3,8,1,286,238,478
350,24,24,698,698,0,42,42,734,734,0,0.00013615167296368154,0.00013615167296368154,508,508,0,-1,3,3,6,3,451,222,789
351,0,0,1,1,0,0,0,1,1,0,0.0,0.0,1,1,0,-1,-1,-1,4,0,694,715,976
352,7,108,560,957,397,4,4,446,446,0,0.00013615167296368154,0.0002382654276864427,534,615,81,5,5,5,2,6,806,459,279
353,0,206,1,973,972,0,16,1,549,548,0.0,0.0019741992579733825,1,884,883,3,-1,4,4,0,891,934,111
354,0,616,1,999,998,0,33,1,920,919,0.0,0.005003573981415297,1,959,958,2,-1,3,3,0,856,712,286
355,6,6,382,382,0,55,55,436,436,0,0.0,0.0,1,1,0,-1,4,4,22,2,22,560,966
356,16,118,565,903,338,46,46,628,628,0,0.0004084550188910446,0.0006467204465774873,674,738,64,4,3,3,8,1,218,869,562
357,2,104,353,889,536,12,13,366,373,7,0.0,3.4037918240920386e-05,1,399,398,4,5,5,9,1,269,924,791
358,6,108,396,901,505,25,26,458,471,13,0.0002042275094455223,0.00037441710065012424,563,650,87,4,4,4,9,1,330,552,499
359,178,178,973,973,0,56,56,989,989,0,0.017801831240001363,0.017801831240001363,996,996,0,-1,2,2,2,48,947,56,866
360,263,469,971,989,18,136,136,980,980,0,0.006739507811702236,0.008407365805507334,969,978,9,3,2,2,7,32,450,26,81
361,25,25,719,719,0,28,28,667,667,0,0.0002723033459273631,0.0002723033459273631,623,623,0,-1,3,3,5,9,464,341,812
362,24,126,618,895,277,86,86,629,629,0,0.0002723033459273631,0.00030634126416828345,610,625,15,4,3,3,16,3,72,222,401
363,0,206,1,963,962,0,34,1,526,525,0.0,0.0020422750944552232,1,874,873,3,-1,4,9,2,166,271,98
364,0,206,1,968,967,0,16,1,456,455,0.0,0.0006126825283365669,1,728,727,3,-1,4,6,0,341,802,559
365,10,216,581,976,395,14,18,566,672,106,0.00010211375472276115,0.0032336022328874367,479,933,454,3,4,4,3,3,901,301,48
366,28,28,762,762,0,30,30,784,784,0,0.0007147962830593281,0.0007147962830593281,752,752,0,-1,3,3,4,3,696,382,833
367,16,222,637,973,336,22,26,576,647,71,0.0004765308553728854,0.0007147962830593281,709,763,54,3,4,4,5,6,517,275,93
368,42,42,794,794,0,50,50,840,840,0,0.0006467204465774873,0.0006467204465774873,745,745,0,-1,3,3,5,7,406,169,967
369,159,260,988,997,9,22,22,946,946,0,0.007454304094761564,0.007454304094761564,975,975,0,6,3,3,2,70,944,18,560
370,12,12,630,630,0,8,8,500,500,0,0.00013615167296368154,0.00013615167296368154,534,534,0,-1,4,4,2,4,983,164,757
371,0,101,1,940,939,0,3,1,331,330,0.0,0.0,1,1,0,5,-1,6,3,0,800,957,679
372,30,646,720,994,274,33,48,520,639,119,0.0002382654276864427,0.0021784267674189047,581,883,302,2,3,3,9,4,166,208,297
373,2,208,360,961,601,8,22,361,480,119,0.0,0.0011913271384322134,1,827,826,3,5,4,7,2,400,344,397
374,0,206,1,964,963,0,30,1,549,548,0.0,0.0017018959120460194,1,868,867,3,-1,4,7,0,273,201,98
375,102,308,894,978,84,76,76,875,875,0,0.0013615167296368155,0.0021784267674189047,835,895,60,3,3,3,6,18,432,148,245
376,18,120,672,933,261,30,30,743,743,0,0.00037441710065012424,0.0008169100377820892,663,781,118,4,3,3,4,3,397,197,535
377,132,233,963,984,21,56,56,984,984,0,0.008339289969025495,0.008407365805507334,975,975,0,5,2,2,2,28,469,44,870
378,2,2,384,384,0,5,5,429,429,0,0.0,0.0,1,1,0,-1,5,5,3,1,730,788,746
379,6,212,415,968,553,11,24,422,608,186,0.0,0.0023486163586235067,1,895,894,3,4,4,4,1,509,837,41
380,4,620,432,998,566,6,24,419,733,314,0.0002382654276864427,0.005514142755029102,611,967,356,2,5,3,3,2,672,22,20
381,2,208,373,977,604,3,8,374,518,144,0.0,0.0002382654276864427,1,604,603,3,5,4,2,2,919,509,557
382,360,360,979,979,0,132,132,967,967,0,0.006569318220497634,0.006569318220497634,968,968,0,-1,2,2,8,50,334,33,978
383,0,102,1,912,911,0,8,1,388,387,0.0,0.00013615167296368154,1,524,523,4,-1,5,5,1,311,841,810
384,10,10,672,672,0,8,8,600,600,0,0.00013615167296368154,0.00013615167296368154,535,535,0,-1,4,4,2,4,963,545,983
385,14,116,620,939,319,14,14,543,543,0,0.0002382654276864427,0.0005786446100956465,590,735,145,4,4,4,3,4,626,202,132
386,0,206,1,963,962,0,12,1,443,442,0.0,0.0002382654276864427,1,611,610,3,-1,4,4,0,516,776,439
387,4,4,468,468,0,8,8,465,465,0,0.0,0.0,1,1,0,-1,5,5,4,2,738,425,918
388,0,206,1,963,962,0,21,1,446,445,0.0,0.0009190237925048504,1,792,791,3,-1,4,9,0,388,729,166
389,22,638,710,997,287,28,28,737,737,0,0.0006807583648184077,0.005071649817897137,759,962,203,2,3,3,3,3,680,121,33
390,0,0,1,1,0,0,0,1,1,0,0.0,0.0,1,1,0,-1,-1,-1,22,1,33,650,446
391,1,103,332,958,626,2,3,332,396,64,0.0,0.00013615167296368154,1,523,522,4,8,5,2,2,751,582,406
392,195,401,952,984,32,148,148,955,955,0,0.004288777698355968,0.006331052792811192,950,968,18,3,2,2,9,26,351,112,98
393,313,415,984,991,7,78,78,972,972,0,0.01058579257292624,0.010619830491167161,987,987,0,4,2,2,4,62,559,70,485
394,0,0,1,1,0,0,0,1,1,0,0.0,0.0,1,1,0,-1,-1,-1,10,0,125,860,568
395,0,206,1,971,970,0,14,1,489,488,0.0,0.0010892133837094523,1,816,815,3,-1,4,5,0,601,877,84
396,6,6,490,490,0,7,7,498,498,0,0.0,0.0,1,1,0,-1,4,4,2,1,983,639,436
397,0,0,1,1,0,0,0,1,1,0,0.0,0.0,1,1,0,-1,-1,-1,7,0,591,986,789
398,109,210,934,974,40,38,38,869,869,0,0.002723033459273631,0.002723033459273631,915,914,-1,5,3,3,3,20,626,94,552
399,39,245,719,960,241,98,98,694,694,0,0.0004084550188910446,0.0006467204465774873,670,745,75,3,3,3,15,5,68,591,168
400,37,137,804,944,140,40,40,855,855,0,0.0016338200755641784,0.0017018959120460194,866,870,4,4,3,3,4,11,344,193,648
401,55,261,780,959,179,100,100,689,689,0,0.0007147962830593281,0.0009870996289866913,741,796,55,3,3,3,14,8,203,284,584
402,2,618,360,996,636,14,58,425,786,361,3.4037918240920386e-05,0.006977773239388679,407,970,563,2,5,3,7,1,658,756,19
403,16,222,625,971,346,38,38,851,851,0,0.0005446066918547262,0.003778208924742163,728,943,215,3,3,3,3,1,930,480,34
404,0,102,1,922,921,0,6,1,417,416,0.0,0.0002042275094455223,1,564,563,4,-1,5,3,0,855,877,827
405,164,164,959,959,0,60,60,888,888,0,0.0033357159876101976,0.0033357159876101976,928,928,0,-1,3,3,5,30,363,75,709
406,0,206,1,962,961,0,26,1,521,520,0.0,0.0018720855032506212,1,879,878,3,-1,4,7,0,264,735,112
407,0,0,1,1,0,0,0,1,1,0,0.0,0.0,1,1,0,-1,-1,-1,4,0,578,657,769
408,9,9,562,562,0,12,12,492,492,0,0.00030634126416828345,0.00030634126416828345,639,639,0,-1,4,4,4,3,767,93,823
409,10,112,533,909,376,24,24,476,476,0,0.00017018959120460194,0.00017018959120460194,544,544,0,4,4,4,8,4,142,567,540
410,0,0,1,1,0,0,0,1,1,0,0.0,0.0,1,1,0,-1,-1,-1,5,1,604,806,866
411,1,103,332,927,595,3,4,332,369,37,0.0,6.807583648184077e-05,1,446,445,4,6,5,3,2,923,739,526
412,100,100,909,909,0,100,100,991,991,0,0.05200993907212635,0.05200993907212635,999,999,0,-1,1,1,4,98,354,23,828
413,0,0,1,1,0,0,0,1,1,0,0.0,0.0,1,1,0,-1,-1,-1,13,0,185,588,819
414,148,148,932,932,0,158,158,971,971,0,0.0030974505599237552,0.0030974505599237552,926,926,0,-1,2,2,10,10,211,227,824
415,44,146,849,964,115,32,32,907,907,0,0.0009530617107457708,0.0010892133837094523,807,832,25,4,3,3,2,8,907,132,809
416,0,206,1,989,988,0,8,1,614,613,0.0,0.001497668402600497,1,866,865,3,-1,4,2,0,866,818,281
417,22,228,581,944,363,66,72,492,510,18,0.00017018959120460194,0.00030634126416828345,526,615,89,3,3,3,19,2,11,499,655
418,0,102,1,942,941,0,3,1,373,372,0.0,0.0002723033459273631,1,626,625,4,-1,5,2,0,938,916,246
419,15,117,636,930,294,20,20,501,501,0,0.0005105687736138058,0.0007828721195411688,710,781,71,4,4,4,6,5,253,591,450
420,8,109,582,955,373,14,14,665,665,0,0.0008509479560230097,0.0008509479560230097,791,791,0,5,4,4,3,3,608,559,763
421,7,7,584,584,0,4,4,465,465,0,0.0002723033459273631,0.0002723033459273631,633,633,0,-1,5,5,2,5,799,591,699
422,6,107,450,927,477,13,13,466,466,0,0.00017018959120460194,0.0002042275094455223,550,578,28,5,4,4,5,4,765,512,543
423,209,209,964,964,0,138,138,970,970,0,0.0051397256543789785,0.0051397256543789785,961,961,0,-1,2,2,9,29,166,142,901
424,16,16,599,599,0,52,52,713,713,0,0.0004084550188910446,0.0004084550188910446,675,675,0,-1,3,3,7,1,118,404,735
425,2,208,364,970,606,4,14,365,538,173,0.0,0.0013274788113958951,1,844,843,3,5,4,3,2,989,374,100
426,42,248,770,967,197,84,88,786,800,14,0.0007828721195411688,0.0018380475850097008,765,874,109,3,3,3,11,8,379,302,148
427,58,58,823,823,0,74,74,755,755,0,0.0008169100377820892,0.0008169100377820892,781,781,0,-1,3,3,9,13,245,340,783
428,8,624,511,996,485,30,62,553,789,236,6.807583648184077e-05,0.0051397256543789785,448,958,510,2,4,3,7,3,343,508,33
429,0,101,1,915,914,0,4,1,330,329,0.0,0.0,1,1,0,5,-1,6,4,0,542,944,788
430,7,109,537,938,401,12,12,627,627,0,0.00013615167296368154,0.0002382654276864427,523,588,65,4,4,4,2,2,993,724,110
431,20,636,683,997,314,24,34,631,737,106,0.0008509479560230097,0.007522379931243405,783,972,189,2,4,3,4,8,532,264,18
432,1,1,333,333,0,4,4,333,333,0,0.0,0.0,1,1,0,-1,6,6,4,2,563,656,668
433,0,0,1,1,0,0,0,1,1,0,0.0,0.0,1,1,0,-1,-1,-1,10,2,259,462,832
434,6,212,398,951,553,30,42,410,472,62,0.00017018959120460194,0.00037441710065012424,546,664,118,3,4,4,15,1,95,592,178
435,15,117,629,936,307,18,18,615,615,0,0.000442492937131965,0.0007488342013002485,701,768,67,4,4,4,3,7,592,371,461
436,36,652,724,993,269,68,78,713,775,62,0.00088498587426393,0.002723033459273631,785,914,129,2,3,3,8,6,370,289,42
437,19,225,642,968,326,36,36,644,644,0,0.00034037918240920387,0.0007147962830593281,643,757,114,3,3,3,7,6,416,406,302
438,0,0,1,1,0,0,0,1,1,0,0.0,0.0,1,1,0,-1,-1,-1,3,0,707,488,889
439,2,104,360,918,558,4,4,361,361,0,0.0,3.4037918240920386e-05,1,406,405,4,5,5,3,1,808,743,492
440,0,102,1,932,931,0,7,1,409,408,0.0,0.0005446066918547262,1,726,725,4,-1,5,4,0,603,866,138
441,7,108,537,943,406,7,7,427,427,0,0.0,3.4037918240920386e-05,1,406,405,6,5,5,4,4,553,444,503
442,0,102,1,912,911,0,10,1,400,399,0.0,0.0002382654276864427,1,597,596,4,-1,5,6,0,237,944,197
443,45,45,817,817,0,34,34,719,719,0,0.00034037918240920387,0.00034037918240920387,642,642,0,-1,3,3,4,11,385,249,974
444,54,54,809,809,0,68,68,749,749,0,0.0020763130126961434,0.0020763130126961434,895,895,0,-1,2,2,9,4,262,164,793
445,0,616,1,995,994,0,38,1,671,670,0.0,0.0020422750944552232,1,889,888,2,-1,3,6,1,630,962,95
446,21,21,722,722,0,40,40,832,832,0,0.0007828721195411688,0.0007828721195411688,776,776,0,-1,3,3,5,5,744,355,436
447,18,634,595,992,397,38,60,524,670,146,0.00013615167296368154,0.0026889955410327104,499,917,418,2,4,3,9,4,123,230,98
448,8,214,523,973,450,10,15,438,524,86,6.807583648184077e-05,0.0004765308553728854,441,705,264,3,4,4,4,2,700,547,248
449,0,0,1,1,0,0,0,1,1,0,0.0,0.0,1,1,0,-1,-1,-1,12,0,184,744,445
450,14,116,602,926,324,26,26,557,557,0,0.0002042275094455223,0.0002382654276864427,560,583,23,4,4,4,7,3,482,385,346
451,0,616,1,996,995,0,64,1,835,834,0.0,0.006773545729943157,1,974,973,2,-1,3,7,0,359,715,30
452,2,208,366,973,607,8,12,441,497,56,0.00017018959120460194,0.0004765308553728854,550,698,148,3,5,4,4,1,597,904,212
453,0,0,1,1,0,0,0,1,1,0,0.0,0.0,1,1,0,-1,-1,-1,12,1,87,730,828
454,130,130,936,936,0,106,106,969,969,0,0.0036760951700194017,0.0036760951700194017,938,938,0,-1,2,2,7,15,404,158,359
455,19,120,695,936,241,24,24,616,616,0,0.000442492937131965,0.000442492937131965,687,687,0,6,4,4,6,9,594,391,640
456,298,400,978,983,5,160,160,991,991,0,0.007488342013002485,0.007726607440688927,975,975,0,4,2,2,7,28,273,41,286
457,49,49,798,798,0,54,54,691,691,0,0.0005446066918547262,0.0005446066918547262,718,718,0,-1,3,3,8,11,383,249,388
458,134,134,894,894,0,256,256,907,907,0,0.002552843868069029,0.002552843868069029,905,905,0,-1,2,2,22,15,22,158,769
459,0,0,1,1,0,0,0,1,1,0,0.0,0.0,1,1,0,-1,-1,-1,5,0,604,903,554
460,31,132,883,985,102,4,4,545,545,0,0.0020763130126961434,0.0021784267674189047,897,900,3,5,5,5,2,24,775,119,536
461,10,112,573,931,358,18,18,589,589,0,0.0002042275094455223,0.0004765308553728854,582,709,127,4,4,4,3,3,819,236,545
462,50,50,817,817,0,50,50,717,717,0,0.0008509479560230097,0.0008509479560230097,786,786,0,-1,3,3,8,8,309,187,573
463,0,206,1,951,950,0,35,1,457,456,0.0,0.000442492937131965,1,668,667,3,-1,4,13,0,160,725,159
464,53,53,810,810,0,54,54,669,669,0,0.0009190237925048504,0.0009190237925048504,794,794,0,-1,3,3,8,9,483,294,977
465,16,118,690,950,260,22,22,787,787,0,0.0004084550188910446,0.00088498587426393,686,807,121,4,3,3,2,2,804,223,242
466,7,213,485,957,472,14,18,424,478,54,6.807583648184077e-05,0.00030634126416828345,449,636,187,3,4,4,5,3,238,761,318
467,10,216,494,950,456,36,50,422,464,42,3.4037918240920386e-05,0.0005786446100956465,397,717,320,3,4,4,17,4,112,581,186
468,2,104,382,947,565,4,4,432,432,0,6.807583648184077e-05,0.0004084550188910446,463,675,212,4,5,5,2,1,951,756,266
469,48,149,765,921,156,102,102,805,805,0,0.000442492937131965,0.000442492937131965,681,681,0,6,3,3,12,5,292,221,344
470,987,987,997,997,0,392,392,997,997,0,0.016372238673882704,0.016372238673882704,996,996,0,-1,2,2,17,98,63,23,798
471,0,0,1,1,0,0,0,1,1,0,0.0,0.0,1,1,0,-1,-1,-1,2,0,943,939,846
472,0,0,1,1,0,0,0,1,1,0,0.0,0.0,1,1,0,-1,-1,-1,5,0,519,776,965
473,40,141,764,929,165,72,72,829,829,0,0.0007488342013002485,0.0007828721195411688,756,765,9,5,3,3,7,4,221,328,764
474,0,102,1,913,912,0,6,1,362,361,0.0,3.4037918240920386e-05,1,392,391,4,-1,5,5,0,605,969,320
475,16,222,596,965,369,44,44,685,685,0,0.0005446066918547262,0.0007147962830593281,718,754,36,3,3,3,7,4,343,409,447
476,3,105,461,952,491,5,5,405,405,0,0.0002723033459273631,0.0004765308553728854,628,702,74,4,5,5,3,2,798,579,204
477,101,307,922,984,62,66,66,899,899,0,0.0021784267674189047,0.005956635692161067,896,962,66,3,3,3,6,23,494,122,12
478,58,264,785,961,176,124,124,742,742,0,0.0008169100377820892,0.00088498587426393,771,776,5,3,3,3,17,9,210,414,323
479,144,144,908,908,0,226,226,929,929,0,0.002382654276864427,0.002382654276864427,895,895,0,-1,2,2,17,12,24,58,822
480,6,622,428,997,569,9,28,432,689,257,0.0,0.002586881786309949,1,908,907,2,4,3,3,1,634,896,73
481,0,0,1,1,0,0,0,1,1,0,0.0,0.0,1,1,0,-1,-1,-1,4,0,671,955,938
482,29,131,715,921,206,38,38,674,674,0,0.0004084550188910446,0.000442492937131965,670,681,11,4,3,3,6,7,473,371,319
483,0,101,1,903,902,0,5,1,331,330,0.0,3.4037918240920386e-05,1,393,392,5,-1,6,5,0,818,983,764
484,2,104,353,915,562,9,12,354,379,25,0.0,0.00010211375472276115,1,489,488,4,5,5,8,1,468,140,891
485,0,206,1,969,968,0,18,1,594,593,0.0,0.0020763130126961434,1,895,894,3,-1,4,3,0,892,908,108
486,0,206,1,967,966,0,28,1,594,593,0.0,0.0018380475850097008,1,865,864,3,-1,4,6,3,575,882,109
487,68,170,879,963,84,38,38,847,847,0,0.0015657442390823377,0.0017359338302869397,861,867,6,4,3,3,3,18,592,147,458
488,52,154,790,927,137,66,66,659,659,0,0.0006807583648184077,0.0008509479560230097,749,778,29,4,3,3,10,9,135,375,384
489,0,206,1,958,957,0,18,1,435,434,0.0,0.0005105687736138058,1,707,706,3,-1,4,8,0,365,696,413
490,0,206,1,978,977,0,8,1,513,512,0.0,0.0012594029749140542,1,841,840,3,-1,4,2,0,924,483,227
491,7,7,520,520,0,11,11,452,452,0,0.00010211375472276115,0.00010211375472276115,492,492,0,-1,4,4,4,3,690,761,881
492,0,102,1,926,925,0,6,1,419,418,0.0,0.0002042275094455223,1,580,579,4,-1,5,3,0,923,833,622
493,16,117,597,925,328,16,16,492,492,0,0.00030634126416828345,0.00030634126416828345,627,627,0,5,4,4,4,6,540,613,364
494,16,632,519,992,473,76,86,558,592,34,0.0002042275094455223,0.00088498587426393,561,776,215,2,3,3,17,4,10,512,187
495,127,743,911,995,84,154,154,889,889,0,0.002110350930937064,0.0027911092957554717,890,912,22,2,3,3,14,19,47,91,273
496,0,102,1,939,938,0,4,1,366,365,0.0,0.00013615167296368154,1,522,521,4,-1,5,3,1,699,428,468
497,0,0,1,1,0,0,0,1,1,0,0.0,0.0,1,1,0,-1,-1,-1,8,0,223,822,841
498,2,104,350,884,534,12,12,367,367,0,0.0,0.00010211375472276115,1,482,481,4,5,5,9,1,100,540,398
499,0,0,1,1,0,0,0,1,1,0,0.0,0.0,1,1,0,-1,-1,-1,2,0,847,702,946
500,32,32,697,697,0,84,84,729,729,0,0.0002723033459273631,0.0002723033459273631,600,600,0,-1,3,3,12,8,194,302,620
501,38,38,706,706,0,92,92,675,675,0,0.00034037918240920387,0.00034037918240920387,642,642,0,-1,3,3,14,4,85,202,867
502,155,361,945,982,37,78,78,874,874,0,0.003778208924742163,0.0038462847612240037,933,935,2,3,3,3,8,31,309,102,305
503,22,124,631,900,269,72,72,707,707,0,0.0008509479560230097,0.00088498587426393,772,780,8,4,3,3,10,4,205,312,639
504,6,108,417,890,473,14,15,420,424,4,3.4037918240920386e-05,0.00017018959120460194,407,544,137,4,4,4,6,2,425,662,637
505,8,8,499,499,0,26,26,511,511,0,0.0002723033459273631,0.0002723033459273631,598,598,0,-1,4,4,7,2,209,22,921
506,2,103,353,899,546,13,13,374,374,0,0.0,0.0,1,1,0,5,5,5,9,1,339,606,265
507,0,616,1,990,989,0,88,1,558,557,0.0,0.001055175465468532,1,802,801,2,-1,3,19,0,89,930,352
508,114,114,888,888,0,166,166,859,859,0,0.0017018959120460194,0.0017018959120460194,865,865,0,-1,3,3,16,17,53,60,455
509,15,116,676,946,270,18,18,710,710,0,0.00034037918240920387,0.00037441710065012424,658,672,14,5,4,4,3,5,961,510,342
510,21,21,777,777,0,12,12,637,637,0,0.0002382654276864427,0.0002382654276864427,613,613,0,-1,4,4,2,5,913,182,866
511,24,24,657,657,0,52,52,638,638,0,0.0005446066918547262,0.0005446066918547262,720,720,0,-1,3,3,9,4,367,637,684
512,12,12,567,567,0,24,24,562,562,0,0.00013615167296368154,0.00013615167296368154,512,512,0,-1,4,4,6,2,455,576,731
513,600,600,993,993,0,166,166,991,991,0,0.01055175465468532,0.01055175465468532,978,978,0,-1,2,2,8,92,301,30,978
514,53,53,853,853,0,54,54,917,917,0,0.0015657442390823377,0.0015657442390823377,870,870,0,-1,2,2,4,8,423,286,699
515,0,101,1,950,949,0,2,1,330,329,0.0,0.0,1,1,0,6,-1,7,2,0,897,915,893
516,2,104,371,946,575,3,4,373,405,32,0.0,0.0,1,1,0,4,5,5,2,1,232,853,506
517,0,0,1,1,0,0,0,1,1,0,0.0,0.0,1,1,0,-1,-1,-1,4,0,423,800,542
518,15,15,662,662,0,18,18,706,706,0,0.0005105687736138058,0.0005105687736138058,708,708,0,-1,4,4,3,7,676,237,641
519,6,212,416,961,545,26,39,515,623,108,3.4037918240920386e-05,0.0007828721195411688,385,766,381,3,4,4,8,2,521,325,490
520,100,100,907,907,0,100,100,996,996,0,0.05817080227373294,0.05854521937438306,999,1000,1,3,1,1,3,92,459,30,616
521,8,214,521,969,448,28,28,595,595,0,0.0002382654276864427,0.0007147962830593281,579,752,173,3,4,4,6,2,575,628,307
522,2,103,395,962,567,3,3,404,404,0,0.0,0.0,1,1,0,5,5,5,2,1,788,935,466
523,26,127,805,970,165,18,18,832,832,0,0.0011913271384322134,0.001497668402600497,841,864,23,5,4,4,3,9,877,245,840
524,40,40,735,735,0,92,92,803,803,0,0.001157289220191293,0.001157289220191293,809,809,0,-1,3,3,11,6,271,471,678
525,21,122,710,940,230,30,30,707,707,0,0.0006126825283365669,0.0006807583648184077,734,750,16,5,4,4,5,6,463,368,627
526,32,238,767,973,206,20,20,563,563,0,0.0006126825283365669,0.001055175465468532,742,823,81,3,4,4,4,6,759,136,591
527,19,121,617,902,285,32,32,521,521,0,0.0002382654276864427,0.0002382654276864427,574,574,0,4,4,4,8,9,411,317,364
528,0,102,1,926,925,0,8,1,423,422,0.0,0.0007488342013002485,1,777,776,4,-1,5,4,1,619,948,116
529,0,0,1,1,0,0,0,1,1,0,0.0,0.0,1,1,0,-1,-1,-1,6,0,98,731,982
530,2,208,358,966,608,8,32,369,627,258,6.807583648184077e-05,0.0031314884781646754,442,926,484,3,5,4,6,1,441,717,33
531,6,107,483,942,459,12,12,675,675,0,0.0002723033459273631,0.00037441710065012424,613,674,61,5,4,4,2,1,757,360,749
532,0,0,1,1,0,0,0,1,1,0,0.0,0.0,1,1,0,-1,-1,-1,4,2,617,752,819
533,26,128,781,961,180,18,18,798,798,0,0.000442492937131965,0.0006126825283365669,695,747,52,4,3,3,2,6,979,379,176
534,527,733,990,997,7,182,182,989,989,0,0.010347527145239796,0.010858095918853602,982,983,1,3,2,2,9,69,277,12,255
535,2,208,370,979,609,6,18,455,720,265,0.0,0.005207801490860819,1,959,958,3,5,4,3,1,797,837,24
536,18,634,601,992,391,60,92,607,754,147,0.0002723033459273631,0.0035739814152966403,603,939,336,2,4,3,12,6,187,247,65
537,185,185,964,964,0,94,94,976,976,0,0.00976888253514415,0.00976888253514415,980,980,0,-1,2,2,5,31,688,34,372
538,36,652,879,1000,121,8,18,645,908,263,0.001157289220191293,0.008203138296061813,837,977,140,2,4,3,2,17,941,269,770
539,52,52,817,817,0,42,42,693,693,0,0.0010211375472276116,0.0010211375472276116,801,801,0,-1,4,4,7,17,141,226,542
540,42,144,805,943,138,34,34,729,729,0,0.0007488342013002485,0.0007828721195411688,764,776,12,4,3,3,4,13,614,217,566
541,0,206,1,968,967,0,11,1,446,445,0.0,0.00017018959120460194,1,541,540,3,-1,4,4,0,623,860,710
542,176,278,955,979,24,94,94,967,967,0,0.005207801490860819,0.005377991082065421,961,964,3,4,2,2,5,29,528,142,251
543,46,252,845,982,137,12,12,593,593,0,0.0013274788113958951,0.0022465026039007454,846,904,58,3,4,4,2,12,653,163,116
544,38,38,710,710,0,106,106,804,804,0,0.0004084550188910446,0.0004084550188910446,673,673,0,-1,3,3,11,4,66,288,956
545,0,0,1,1,0,0,0,1,1,0,0.0,0.0,1,1,0,-1,-1,-1,2,2,952,775,847
546,0,102,1,926,925,0,5,1,390,389,0.0,0.00013615167296368154,1,521,520,4,-1,5,3,0,831,811,474
547,16,117,714,965,251,18,18,738,738,0,0.0008169100377820892,0.0008169100377820892,782,782,0,5,4,4,3,6,850,192,419
548,5,211,560,988,428,4,8,467,644,177,0.00010211375472276115,0.003199564314646516,514,939,425,3,5,4,2,3,941,248,69
549,36,36,740,740,0,74,74,765,765,0,0.0006126825283365669,0.0006126825283365669,737,737,0,-1,3,3,9,6,217,114,962
550,21,21,677,677,0,24,24,623,623,0,0.0006467204465774873,0.0006467204465774873,743,743,0,-1,4,4,4,6,887,295,620
551,0,102,1,867,866,0,23,1,350,349,0.0,0.00013615167296368154,1,502,501,4,-1,5,21,0,1,903,687
552,1,617,332,990,658,10,66,332,671,339,0.0,0.0053099152455835805,1,960,959,2,6,3,10,1,205,640,24
553,58,264,842,978,136,50,50,846,846,0,0.0012934408931549745,0.001497668402600497,846,860,14,3,3,3,5,9,669,294,252
554,2,2,346,346,0,19,19,355,355,0,0.0,0.0,1,1,0,-1,5,5,17,2,39,656,702
555,2,103,367,932,565,7,7,400,400,0,0.0,0.0,1,1,0,5,5,5,4,1,462,592,708
556,3,3,479,479,0,4,4,468,468,0,6.807583648184077e-05,6.807583648184077e-05,458,458,0,-1,5,5,2,2,865,584,779
557,0,0,1,1,0,0,0,1,1,0,0.0,0.0,1,1,0,-1,-1,-1,5,0,294,974,804
558,30,132,746,940,194,16,16,563,563,0,0.0006126825283365669,0.0009190237925048504,727,779,52,4,4,4,4,9,520,154,510
559,0,206,1,949,948,0,52,1,485,484,0.0,0.0009190237925048504,1,784,783,3,-1,4,16,0,26,970,97
560,6,6,436,436,0,12,12,429,429,0,0.00010211375472276115,0.00010211375472276115,485,485,0,-1,4,4,6,1,526,788,790
561,110,110,912,912,0,82,82,900,900,0,0.0021784267674189047,0.0021784267674189047,892,892,0,-1,3,3,7,12,722,58,923
562,12,12,521,521,0,24,24,437,437,0,3.4037918240920386e-05,3.4037918240920386e-05,401,401,0,-1,4,4,9,2,159,547,974
563,46,148,764,919,155,84,84,713,713,0,0.00088498587426393,0.0009530617107457708,780,790,10,4,2,2,11,3,188,300,615
564,1,207,333,965,632,7,22,333,495,162,0.0,0.0008509479560230097,1,780,779,3,8,4,7,3,342,626,326
565,56,56,856,856,0,52,52,955,955,0,0.002552843868069029,0.002552843868069029,918,918,0,-1,2,2,3,6,808,494,956
566,99,99,943,943,0,28,28,846,846,0,0.0020422750944552232,0.0020422750944552232,890,890,0,-1,3,3,3,34,854,89,774
567,16,16,605,605,0,52,52,792,792,0,0.0002382654276864427,0.0002382654276864427,593,593,0,-1,3,3,6,1,419,394,800
568,14,220,603,971,368,9,18,434,642,208,0.00010211375472276115,0.0015317063208414173,490,863,373,3,4,4,3,3,471,353,55
569,0,206,1,952,951,0,35,1,505,504,0.0,0.000442492937131965,1,666,665,3,-1,4,10,0,256,713,136
570,91,297,926,987,61,22,22,805,805,0,0.0037441710065012424,0.005514142755029102,944,961,17,3,3,3,2,25,939,47,74
571,2,104,353,889,536,11,12,353,365,12,0.0,0.0,1,1,0,4,5,5,10,1,437,590,599
572,0,101,1,900,899,0,7,1,331,330,0.0,0.00010211375472276115,1,488,487,5,-1,6,7,0,329,956,761
573,4,4,401,401,0,21,21,408,408,0,3.4037918240920386e-05,3.4037918240920386e-05,413,413,0,-1,5,5,11,3,224,829,672
574,61,61,863,863,0,44,44,877,877,0,0.0017018959120460194,0.0017018959120460194,865,865,0,-1,3,3,4,13,660,255,436
575,0,102,1,875,874,0,23,1,373,372,0.0,0.00013615167296368154,1,506,505,4,-1,5,16,0,53,930,810
576,2,2,405,405,0,3,3,417,417,0,0.0,0.0,1,1,0,-1,5,5,2,1,962,853,569
577,46,1686,732,1000,268,154,198,773,871,98,0.0007828721195411688,0.007658531604207087,758,967,209,1,2,2,19,3,148,525,203
578,0,101,1,947,946,0,3,1,331,330,0.0,0.00010211375472276115,1,490,489,5,-1,6,3,1,798,920,771
579,78,694,820,995,175,158,166,817,844,27,0.0014636304843595766,0.007011811157629599,847,964,117,2,2,2,17,6,103,275,32
580,259,465,982,994,12,48,48,929,929,0,0.008101024541339052,0.008577555396711936,979,982,3,3,3,3,3,49,900,16,392
581,12,114,755,980,225,8,8,687,687,0,0.0005105687736138058,0.0013955546478777359,729,866,137,4,4,4,2,6,956,192,61
582,86,702,891,997,106,28,38,738,844,106,0.0018040096667687805,0.003778208924742163,872,939,67,2,3,3,3,20,989,49,233
583,0,616,1,994,993,0,118,1,652,651,0.0,0.0027911092957554717,1,915,914,2,-1,3,21,0,1,564,27
584,2,2,358,358,0,7,7,369,369,0,0.0,0.0,1,1,0,-1,5,5,5,2,426,739,914
585,108,108,885,885,0,196,196,900,900,0,0.0015657442390823377,0.0015657442390823377,868,868,0,-1,2,2,17,9,56,277,908
586,0,102,1,930,929,0,4,1,365,364,0.0,0.0002382654276864427,1,593,592,4,-1,5,3,0,842,429,617
587,22,123,780,966,186,12,12,697,697,0,0.00037441710065012424,0.0005105687736138058,671,718,47,5,4,4,2,9,878,245,704
588,2,104,362,941,579,4,5,364,396,32,6.807583648184077e-05,0.00010211375472276115,446,485,39,4,5,5,3,1,814,717,380
589,0,0,1,1,0,0,0,1,1,0,0.0,0.0,1,1,0,-1,-1,-1,20,1,70,738,802
590,1,1,332,332,0,4,4,332,332,0,3.4037918240920386e-05,3.4037918240920386e-05,398,398,0,-1,7,7,4,1,675,640,716
591,16,222,623,969,346,22,26,632,688,56,0.0009190237925048504,0.0020082371762143027,795,883,88,3,3,3,4,1,614,931,71
592,0,0,1,1,0,0,0,1,1,0,0.0,0.0,1,1,0,-1,-1,-1,4,0,682,916,978
593,6,212,448,972,524,9,14,453,553,100,0.00013615167296368154,0.0006126825283365669,528,744,216,3,4,4,3,1,801,607,382
594,103,103,905,905,0,62,62,825,825,0,0.0012594029749140542,0.0012594029749140542,826,826,0,-1,3,3,7,16,722,113,767
595,2,2,349,349,0,21,21,405,405,0,3.4037918240920386e-05,3.4037918240920386e-05,384,384,0,-1,5,5,12,1,219,807,568
596,26,232,805,987,182,22,22,842,842,0,0.0008509479560230097,0.002382654276864427,789,915,126,3,3,3,2,6,686,467,65
597,0,206,1,978,977,0,14,1,637,636,0.0,0.0037441710065012424,1,941,940,3,-1,4,3,0,911,980,34
598,8,8,523,523,0,10,10,462,462,0,6.807583648184077e-05,6.807583648184077e-05,455,455,0,-1,4,4,3,3,737,829,918
599,22,22,586,586,0,108,108,634,634,0,0.0006126825283365669,0.0006126825283365669,708,708,0,-1,3,3,19,2,83,473,803
600,6,212,388,943,555,39,52,446,506,60,3.4037918240920386e-05,0.00037441710065012424,395,654,259,3,4,4,14,1,85,623,482
601,14,220,578,971,393,28,32,585,623,38,0.00017018959120460194,0.0008169100377820892,543,776,233,3,4,4,6,3,341,301,405
602,0,0,1,1,0,0,0,1,1,0,0.0,0.0,1,1,0,-1,-1,-1,6,2,322,271,664
603,70,171,882,961,79,56,56,971,971,0,0.005173763572619898,0.005173763572619898,962,962,0,9,2,2,2,6,971,46,647
604,0,102,1,870,869,0,17,1,361,360,0.0,0.0,1,1,0,4,-1,5,14,0,122,969,602
605,167,783,942,997,55,112,112,935,935,0,0.002552843868069029,0.0038462847612240037,911,939,28,2,2,2,8,23,218,106,163
606,28,1668,641,1000,359,114,258,690,944,254,0.00030634126416828345,0.01834643793185609,625,998,373,1,3,2,19,3,148,519,11
607,0,102,1,864,863,0,31,1,392,391,0.0,6.807583648184077e-05,1,446,445,4,-1,5,16,1,117,948,700
608,12,12,571,571,0,10,10,454,454,0,0.0002723033459273631,0.0002723033459273631,616,616,0,-1,4,4,3,4,930,210,977
609,69,69,902,902,0,18,18,721,721,0,0.002382654276864427,0.002382654276864427,908,908,0,-1,4,4,3,19,797,133,894
610,16,16,575,575,0,76,76,783,783,0,0.0002042275094455223,0.0002042275094455223,574,574,0,-1,3,3,10,2,527,493,951
611,0,206,1,967,966,0,16,1,503,502,0.0,0.000442492937131965,1,689,688,3,-1,4,5,0,604,995,810
612,23,23,718,718,0,22,22,574,574,0,0.00037441710065012424,0.00037441710065012424,669,669,0,-1,4,4,5,9,524,317,498
613,115,115,915,915,0,112,112,954,954,0,0.002586881786309949,0.002586881786309949,905,905,0,-1,2,2,8,19,308,144,816
614,7,7,508,508,0,24,24,636,636,0,0.00017018959120460194,0.00017018959120460194,543,543,0,-1,4,4,4,4,759,305,946
615,18,224,653,973,320,20,24,596,688,92,0.000442492937131965,0.0009530617107457708,697,802,105,3,4,4,4,6,740,516,327
616,18,224,675,972,297,20,24,622,693,71,0.00034037918240920387,0.0011232513019503727,660,833,173,3,4,4,4,3,885,507,453
617,10,112,542,902,360,54,54,684,684,0,0.0005105687736138058,0.0009870996289866913,708,792,84,4,4,4,9,4,289,312,326
618,32,238,749,970,221,56,56,807,807,0,0.00034037918240920387,0.0009190237925048504,646,795,149,3,3,3,6,6,549,494,232
619,70,171,929,977,48,14,14,684,684,0,0.002314578440382586,0.0024507301133462676,913,916,3,5,4,4,3,28,730,44,384
620,6,108,460,930,470,12,12,562,562,0,6.807583648184077e-05,0.000442492937131965,448,694,246,4,4,4,2,2,971,714,229
621,12,114,544,914,370,34,34,607,607,0,0.0002042275094455223,0.0002723033459273631,580,618,38,4,4,4,7,2,362,700,689
622,104,206,938,975,37,38,38,902,902,0,0.0032336022328874367,0.0033016780693692774,926,927,1,4,3,3,3,18,639,55,309
623,0,206,1,964,963,0,16,1,452,451,0.0,0.00034037918240920387,1,649,648,3,-1,4,6,0,498,372,209
624,36,138,760,931,171,46,46,672,672,0,0.0008169100377820892,0.0010211375472276116,778,810,32,4,3,3,8,8,365,521,167
625,6,107,456,931,475,20,20,625,625,0,0.00030634126416828345,0.00037441710065012424,629,668,39,5,4,4,4,2,635,785,879
626,0,0,1,1,0,0,0,1,1,0,0.0,0.0,1,1,0,-1,-1,-1,3,0,855,822,388
627,40,246,789,973,184,50,50,798,798,0,0.0004084550188910446,0.0006467204465774873,683,753,70,3,3,3,5,4,474,40,90
628,0,0,1,1,0,0,0,1,1,0,0.0,0.0,1,1,0,-1,-1,-1,2,0,993,871,817
629,28,28,699,699,0,52,52,715,715,0,0.0006126825283365669,0.0006126825283365669,735,735,0,-1,3,3,7,4,714,288,947
630,0,102,1,930,929,0,4,1,403,402,0.0,0.00017018959120460194,1,540,539,4,-1,5,2,0,934,436,287
631,8,8,567,567,0,10,10,504,504,0,0.00030634126416828345,0.00030634126416828345,642,642,0,-1,4,4,3,2,590,697,742
632,16,16,533,533,0,66,66,568,568,0,6.807583648184077e-05,6.807583648184077e-05,439,439,0,-1,3,3,15,1,81,552,897
633,0,206,1,962,961,0,25,1,578,577,0.0,0.0007147962830593281,1,748,747,3,-1,4,5,0,546,664,390
634,0,102,1,916,915,0,8,1,414,413,0.0,0.0006467204465774873,1,749,748,4,-1,5,4,1,558,830,242
635,24,24,664,664,0,42,42,620,620,0,0.00010211375472276115,0.00010211375472276115,473,473,0,-1,3,3,8,3,443,653,821
636,12,12,517,517,0,25,25,439,439,0,0.00013615167296368154,0.00013615167296368154,510,510,0,-1,4,4,10,3,310,829,939
637,0,102,1,898,897,0,10,1,352,351,0.0,3.4037918240920386e-05,1,396,395,4,-1,5,9,0,339,833,570
638,1,103,331,914,583,6,7,331,357,26,0.0,3.4037918240920386e-05,1,413,412,4,8,5,6,1,446,647,762
639,0,0,1,1,0,0,0,1,1,0,0.0,0.0,1,1,0,-1,-1,-1,3,3,899,746,733
640,28,130,759,944,185,40,40,781,781,0,0.000442492937131965,0.0005786446100956465,697,733,36,4,3,3,5,5,517,221,233
641,6,212,392,948,556,48,49,460,463,3,3.4037918240920386e-05,0.00034037918240920387,402,630,228,3,4,4,17,2,63,492,494
642,38,244,691,952,261,150,150,781,781,0,0.0005786446100956465,0.001055175465468532,715,798,83,3,3,3,19,3,48,616,303
643,158,158,959,959,0,38,38,882,882,0,0.0034718676605738795,0.0034718676605738795,938,938,0,-1,3,3,3,38,620,111,886
644,4,105,463,947,484,4,4,423,423,0,0.0002042275094455223,0.0002382654276864427,578,599,21,5,5,5,2,2,838,425,585
645,6,212,441,970,529,13,17,455,493,38,6.807583648184077e-05,0.0002042275094455223,447,543,96,3,4,4,5,1,407,594,197
646,0,0,1,1,0,0,0,1,1,0,0.0,0.0,1,1,0,-1,-1,-1,4,0,611,902,573
647,0,102,1,931,930,0,5,1,389,388,0.0,6.807583648184077e-05,1,453,452,4,-1,5,3,0,774,757,124
648,0,206,1,967,966,0,36,1,706,705,0.0,0.008679669151434699,1,975,974,3,-1,4,6,0,322,228,23
649,2,208,368,977,609,6,10,427,492,65,3.4037918240920386e-05,0.002314578440382586,408,907,499,3,5,4,3,2,958,597,76
650,0,102,1,935,934,0,5,1,399,398,0.0,0.00013615167296368154,1,526,525,4,-1,5,3,1,770,948,453
651,1,101,333,889,556,8,8,333,333,0,0.0,0.0,1,1,0,6,7,7,8,1,411,765,663
652,24,126,694,935,241,30,30,558,558,0,0.000442492937131965,0.0008509479560230097,689,776,87,4,4,4,7,7,264,115,391
653,8,8,457,457,0,59,59,461,461,0,0.0,0.0,1,1,0,-1,4,4,20,2,61,244,927
654,15,15,788,788,0,8,8,687,687,0,0.0005786446100956465,0.0005786446100956465,748,748,0,-1,4,4,2,6,944,658,815
655,82,288,882,977,95,48,48,913,913,0,0.0017018959120460194,0.0020082371762143027,868,889,21,3,3,3,3,13,778,255,118
656,0,0,1,1,0,0,0,1,1,0,0.0,0.0,1,1,0,-1,-1,-1,5,0,238,847,669
657,0,206,1,953,952,0,21,1,402,401,0.0,0.0002042275094455223,1,558,557,3,-1,4,11,0,233,839,443
658,0,206,1,979,978,0,7,1,515,514,0.0,0.0002723033459273631,1,631,630,3,-1,4,2,0,817,865,321
659,126,332,926,980,54,102,102,938,938,0,0.0030634126416828346,0.003642057251778481,925,938,13,3,3,3,7,25,329,47,185
660,0,616,1,990,989,0,70,1,498,497,0.0,0.0006807583648184077,1,737,736,2,-1,3,19,0,89,846,295
661,0,101,1,885,884,0,9,1,332,331,0.0,0.0,1,1,0,5,-1,6,9,1,414,568,788
662,0,0,1,1,0,0,0,1,1,0,0.0,0.0,1,1,0,-1,-1,-1,8,0,301,514,849
663,0,206,1,973,972,0,24,1,596,595,0.0,0.0014295925661186562,1,850,849,3,-1,4,6,0,529,624,61
664,2,103,353,912,559,7,7,354,354,0,0.0,0.0,1,1,0,6,5,5,6,3,352,484,663
665,123,224,918,964,46,98,98,898,898,0,0.0021784267674189047,0.002212464685659825,895,895,0,5,3,3,8,24,380,129,687
666,40,246,770,969,199,76,76,751,751,0,0.0007828721195411688,0.002484768031587188,762,902,140,3,3,3,10,8,293,345,171
667,0,206,1,972,971,0,9,1,478,477,0.0,0.0002723033459273631,1,623,622,3,-1,4,3,0,923,564,496
668,0,206,1,958,957,0,13,1,388,387,0.0,0.00013615167296368154,1,511,510,3,-1,4,8,0,350,905,496
669,6,6,464,464,0,10,10,484,484,0,0.0002042275094455223,0.0002042275094455223,578,578,0,-1,4,4,3,1,831,869,678
670,29,29,700,700,0,54,54,675,675,0,0.00034037918240920387,0.00034037918240920387,641,641,0,-1,3,3,8,10,317,266,903
671,0,0,1,1,0,0,0,1,1,0,0.0,0.0,1,1,0,-1,-1,-1,5,0,677,669,600
672,63,269,862,981,119,72,72,971,971,0,0.004493005207801491,0.004969536063174376,953,957,4,3,2,2,3,4,687,125,204
673,189,395,951,983,32,102,102,928,928,0,0.004050512270669526,0.004322815616596889,949,952,3,3,3,3,7,24,372,8,465
674,0,101,1,868,867,0,23,1,332,331,0.0,0.0,1,1,0,5,-1,6,23,0,30,846,337
675,28,130,705,921,216,64,64,783,783,0,0.0006807583648184077,0.0007488342013002485,752,764,12,4,3,3,8,5,646,306,22
676,28,28,737,737,0,20,20,593,593,0,0.0004084550188910446,0.0004084550188910446,671,671,0,-1,4,4,4,9,690,343,911
677,29,235,741,974,233,38,42,696,718,22,0.0005105687736138058,0.0017018959120460194,709,857,148,3,3,3,6,4,275,156,297
678,48,254,828,979,151,40,40,799,799,0,0.0005786446100956465,0.0010211375472276116,729,814,85,3,3,3,4,8,762,177,293
679,28,28,783,783,0,28,28,809,809,0,0.0004084550188910446,0.0004084550188910446,683,683,0,-1,3,3,3,6,748,192,874
680,0,206,1,970,969,0,18,1,578,577,0.0,0.0009870996289866913,1,808,807,3,-1,4,3,0,808,715,327
681,0,616,1,993,992,0,27,1,526,525,0.0,0.0007488342013002485,1,746,745,2,-1,3,7,0,346,436,407
682,115,115,936,936,0,84,84,974,974,0,0.009870996289866912,0.009870996289866912,981,981,0,-1,2,2,5,15,663,219,979
683,14,116,642,946,304,8,8,479,479,0,0.00037441710065012424,0.0014295925661186562,676,855,179,4,4,4,2,4,653,479,127
684,0,102,1,917,916,0,4,1,367,366,0.0,0.00013615167296368154,1,515,514,4,-1,5,3,0,703,991,584
685,122,328,920,979,59,80,84,882,885,3,0.0018380475850097008,0.0023486163586235067,873,901,28,3,3,3,8,18,146,54,294
686,0,0,1,1,0,0,0,1,1,0,0.0,0.0,1,1,0,-1,-1,-1,8,0,308,914,930
687,0,616,1,993,992,0,42,1,680,679,0.0,0.002484768031587188,1,912,911,2,-1,3,6,0,560,872,26
688,18,18,620,620,0,38,38,670,670,0,0.00013615167296368154,0.00013615167296368154,522,522,0,-1,3,3,6,4,255,270,706
689,0,0,1,1,0,0,0,1,1,0,0.0,0.0,1,1,0,-1,-1,-1,3,0,554,737,937
690,0,0,1,1,0,0,0,1,1,0,0.0,0.0,1,1,0,-1,-1,-1,4,0,891,984,976
691,0,102,1,933,932,0,4,1,363,362,0.0,3.4037918240920386e-05,1,415,414,4,-1,5,3,0,640,356,215
692,1,103,333,891,558,11,14,333,368,35,0.0,0.00013615167296368154,1,504,503,4,7,5,11,3,174,626,797
693,16,222,535,955,420,76,76,682,682,0,0.000442492937131965,0.0005105687736138058,697,710,13,3,3,3,11,1,227,741,447
694,5,5,530,530,0,4,4,471,471,0,0.0002042275094455223,0.0002042275094455223,584,584,0,-1,5,5,2,4,898,622,981
695,22,123,685,931,246,28,28,669,669,0,0.000442492937131965,0.000442492937131965,692,692,0,5,3,3,5,2,669,491,893
696,0,206,1,964,963,0,23,1,547,546,0.0,0.0018720855032506212,1,880,879,3,-1,4,6,0,251,735,335
697,0,206,1,936,935,0,28,1,367,366,0.0,0.00010211375472276115,1,467,466,3,-1,4,21,0,54,992,419
698,8,8,572,572,0,10,10,532,532,0,0.00010211375472276115,0.00010211375472276115,489,489,0,-1,4,4,3,2,854,244,735
699,0,206,1,976,975,0,14,1,573,572,0.0,0.0026889955410327104,1,912,911,3,-1,4,3,0,729,953,8
700,4,106,387,880,493,21,21,392,392,0,3.4037918240920386e-05,0.00010211375472276115,401,479,78,4,5,5,11,5,227,476,661
701,0,102,1,887,886,0,16,1,393,392,0.0,6.807583648184077e-05,1,444,443,4,-1,5,9,0,192,903,443
702,16,222,654,976,322,34,34,867,867,0,0.0004084550188910446,0.0010211375472276116,670,809,139,3,3,3,3,1,901,681,172
703,16,118,520,888,368,110,110,693,693,0,0.0002042275094455223,0.0004084550188910446,556,672,116,4,3,3,18,1,86,655,241
704,0,206,1,969,968,0,18,1,531,530,0.0,0.0002723033459273631,1,616,615,3,-1,4,5,0,662,982,233
705,0,102,1,896,895,0,13,1,398,397,0.0,0.00017018959120460194,1,551,550,4,-1,5,7,0,678,533,263
706,24,230,719,971,252,28,28,676,676,0,0.0002042275094455223,0.0006126825283365669,570,750,180,3,3,3,5,3,412,93,589
707,0,206,1,970,969,0,18,1,624,623,0.0,0.001055175465468532,1,825,824,3,-1,4,3,0,869,955,630
708,73,174,831,934,103,98,98,757,757,0,0.0009530617107457708,0.0009530617107457708,787,787,0,8,3,3,13,12,113,172,647
709,31,133,831,963,132,24,24,835,835,0,0.0012934408931549745,0.0014295925661186562,847,859,12,4,3,3,3,7,608,218,307
710,39,39,798,798,0,30,30,722,722,0,0.0009190237925048504,0.0009190237925048504,800,800,0,-1,3,3,4,10,690,366,794
711,0,101,1,870,869,0,11,1,331,330,0.0,0.0,1,1,0,6,-1,7,11,1,307,852,484
712,0,616,1,989,988,0,57,1,535,534,0.0,0.0007147962830593281,1,743,742,2,-1,3,15,0,124,773,417
713,1,1,332,332,0,2,2,332,332,0,0.0,0.0,1,1,0,-1,6,6,2,2,913,357,429
714,2,2,360,360,0,5,5,382,382,0,0.0,0.0,1,1,0,-1,5,5,3,1,808,878,983
715,2,2,351,351,0,19,19,389,389,0,6.807583648184077e-05,6.807583648184077e-05,444,444,0,-1,5,5,12,2,292,320,816
716,40,141,839,960,121,24,24,790,790,0,0.0008509479560230097,0.0008509479560230097,789,789,0,5,3,3,3,9,899,242,555
717,9,9,609,609,0,10,10,538,538,0,0.0002382654276864427,0.0002382654276864427,593,593,0,-1,4,4,3,3,576,485,884
718,9,9,556,556,0,8,8,462,462,0,0.00017018959120460194,0.00017018959120460194,544,544,0,-1,4,4,3,4,864,398,882
719,6,212,404,959,555,24,24,461,461,0,0.0002382654276864427,0.0007147962830593281,581,753,172,3,4,4,8,1,358,152,273
720,12,12,494,494,0,44,44,468,468,0,0.00010211375472276115,0.00010211375472276115,483,483,0,-1,4,4,14,2,122,491,472
721,19,225,691,975,284,20,20,649,649,0,0.00034037918240920387,0.0007147962830593281,662,768,106,3,4,4,4,5,573,510,327
722,0,101,1,944,943,0,2,1,331,330,0.0,3.4037918240920386e-05,1,402,401,5,-1,6,2,0,942,665,878
723,0,206,1,956,955,0,14,1,401,400,0.0,0.00013615167296368154,1,515,514,3,-1,4,7,0,372,876,958
724,18,224,643,967,324,24,24,625,625,0,0.0004084550188910446,0.0005786446100956465,685,734,49,3,4,4,4,4,516,233,241
725,8,8,560,560,0,14,14,581,581,0,0.00013615167296368154,0.00013615167296368154,532,532,0,-1,4,4,3,2,564,363,811
726,489,590,998,999,1,56,56,982,982,0,0.02209060893835733,0.022226760611321013,997,997,0,5,2,2,2,118,943,37,383
727,9,9,677,677,0,8,8,645,645,0,0.00030634126416828345,0.00030634126416828345,656,656,0,-1,4,4,2,4,941,625,462
728,16,222,648,973,325,34,34,767,767,0,0.0007147962830593281,0.0009530617107457708,770,811,41,3,3,3,4,2,649,160,688
729,34,34,832,832,0,18,18,718,718,0,0.0009190237925048504,0.0009190237925048504,808,808,0,-1,4,4,3,9,654,242,941
730,0,102,1,899,898,0,8,1,353,352,0.0,3.4037918240920386e-05,1,395,394,4,-1,5,7,0,366,839,931
731,4,106,442,932,490,6,7,393,426,33,3.4037918240920386e-05,0.0004084550188910446,410,679,269,4,5,5,4,2,491,547,209
732,103,103,880,880,0,94,94,815,815,0,0.0008509479560230097,0.0008509479560230097,776,776,0,-1,3,3,9,20,159,189,847
733,24,24,701,701,0,34,34,685,685,0,0.0007828721195411688,0.0007828721195411688,770,770,0,-1,3,3,6,3,575,307,995
734,36,242,752,966,214,78,78,847,847,0,0.0014295925661186562,0.0036760951700194017,845,941,96,3,3,3,8,4,418,185,111
735,113,113,938,938,0,40,40,822,822,0,0.0033357159876101976,0.0033357159876101976,934,934,0,-1,3,3,5,24,685,13,478
736,8,1648,508,1000,492,23,79,484,880,396,0.00010211375472276115,0.01507879778072773,486,988,502,1,4,2,8,2,158,408,66
737,81,81,932,932,0,46,46,980,980,0,0.008066986623098132,0.008066986623098132,976,976,0,-1,2,2,2,14,686,84,685
738,12,218,631,981,350,12,12,604,604,0,0.00037441710065012424,0.0007488342013002485,687,775,88,3,4,4,2,3,943,209,293
739,82,82,869,869,0,60,60,851,851,0,0.0011232513019503727,0.0011232513019503727,824,824,0,-1,3,3,5,15,793,92,773
740,36,137,865,978,113,12,12,737,737,0,0.0008169100377820892,0.0008509479560230097,792,797,5,5,4,4,2,12,749,179,718
741,106,106,921,921,0,40,40,791,791,0,0.0018380475850097008,0.0018380475850097008,879,879,0,-1,3,3,5,22,570,203,955
742,0,616,1,991,990,0,46,1,650,649,0.0,0.0017359338302869397,1,875,874,2,-1,3,8,0,380,916,103
743,0,0,1,1,0,0,0,1,1,0,0.0,0.0,1,1,0,-1,-1,-1,2,0,924,930,777
744,74,1714,829,1000,171,108,152,794,896,102,0.002144388849177984,0.013683243132849994,895,989,94,1,3,2,13,12,120,100,77
745,0,206,1,974,973,0,10,1,504,503,0.0,0.0004084550188910446,1,686,685,3,-1,4,3,0,774,865,40
746,0,0,1,1,0,0,0,1,1,0,0.0,0.0,1,1,0,-1,-1,-1,5,0,599,945,787
747,0,101,1,911,910,0,4,1,332,331,0.0,3.4037918240920386e-05,1,403,402,6,-1,7,4,0,711,894,764
748,6,622,448,998,550,10,28,461,777,316,6.807583648184077e-05,0.0063650907110521125,451,969,518,2,4,3,3,2,801,691,50
749,6,622,442,997,555,8,30,414,718,304,0.0002042275094455223,0.0029612988869600733,578,924,346,2,5,3,4,3,652,653,65
750,0,101,1,873,872,0,19,1,332,331,0.0,0.0,1,1,0,6,-1,7,19,0,46,903,861
751,18,18,593,593,0,56,56,576,576,0,0.00034037918240920387,0.00034037918240920387,642,642,0,-1,4,4,12,3,252,93,918
752,0,101,1,955,954,0,3,1,330,329,0.0,0.0002042275094455223,1,594,593,5,-1,6,3,0,883,866,346
753,0,0,1,1,0,0,0,1,1,0,0.0,0.0,1,1,0,-1,-1,-1,4,0,280,912,821
754,146,146,944,944,0,44,44,796,796,0,0.002280540522141666,0.002280540522141666,895,895,0,-1,3,3,4,23,671,66,976
755,10,10,643,643,0,8,8,555,555,0,0.0002382654276864427,0.0002382654276864427,602,602,0,-1,4,4,2,4,991,557,949
756,0,206,1,975,974,0,11,1,486,485,0.0,0.000442492937131965,1,688,687,3,-1,4,5,1,602,693,258
757,16,118,590,912,322,39,40,592,595,3,0.00034037918240920387,0.000442492937131965,646,680,34,4,3,3,9,1,388,463,248
758,416,518,994,998,4,56,56,984,984,0,0.0158616699002689,0.016168011164437182,994,994,0,4,2,2,2,91,970,7,216
759,2,2,355,355,0,8,8,355,355,0,0.0,0.0,1,1,0,-1,5,5,7,2,450,292,428
760,528,734,982,993,11,456,456,992,992,0,0.007318152421797883,0.007828721195411689,962,963,1,3,2,2,22,50,22,33,333
761,194,400,942,980,38,172,172,937,937,0,0.003982436434187685,0.0046972327172470135,941,946,5,3,2,2,13,24,185,119,295
762,0,102,1,897,896,0,12,1,384,383,0.0,0.00034037918240920387,1,634,633,4,-1,5,8,0,449,960,435
763,16,117,612,927,315,38,38,705,705,0,0.0005786446100956465,0.0005786446100956465,716,716,0,6,3,3,6,1,446,80,621
764,112,318,904,979,75,78,78,802,802,0,0.0014295925661186562,0.0021784267674189047,840,895,55,3,3,3,8,19,244,59,161
765,3,105,451,945,494,4,5,383,413,30,0.0,0.0002382654276864427,1,604,603,4,5,5,3,5,871,401,683
766,105,207,934,973,39,50,50,889,889,0,0.0020422750944552232,0.002586881786309949,886,912,26,4,3,3,5,23,574,106,355
767,91,193,934,978,44,22,22,826,826,0,0.003778208924742163,0.0040845501889104465,939,945,6,4,3,3,2,29,851,142,461
768,130,130,897,897,0,300,300,867,867,0,0.0015657442390823377,0.0015657442390823377,851,851,0,-1,3,3,30,17,7,269,833
769,166,267,952,975,23,72,72,854,854,0,0.002825147213996392,0.0028591851322373124,915,915,0,5,3,3,7,32,207,26,290
770,10,216,588,975,387,10,14,485,568,83,0.0002382654276864427,0.00037441710065012424,603,661,58,3,4,4,3,3,337,301,655
771,233,233,968,968,0,100,100,897,897,0,0.004220701861874128,0.004220701861874128,945,945,0,-1,3,3,9,48,389,56,276
772,18,18,672,672,0,28,28,737,737,0,0.0002723033459273631,0.0002723033459273631,628,628,0,-1,3,3,3,3,680,505,979
773,0,616,1,998,997,0,22,1,677,676,0.0,0.0018040096667687805,1,873,872,2,-1,3,4,0,593,696,236
774,133,235,903,953,50,208,208,917,917,0,0.0020763130126961434,0.0024507301133462676,883,896,13,4,3,3,17,18,24,63,869
775,0,206,1,972,971,0,11,1,470,469,0.0,0.000442492937131965,1,698,697,3,-1,4,4,0,631,950,616
776,16,16,720,720,0,12,12,754,754,0,0.00030634126416828345,0.00030634126416828345,644,644,0,-1,4,4,2,4,995,167,918
777,2,208,371,976,605,5,10,390,499,109,0.0,0.00030634126416828345,1,638,637,3,5,4,3,2,568,692,328
778,118,220,914,963,49,50,50,789,789,0,0.0019741992579733825,0.002212464685659825,877,888,11,4,3,3,5,17,426,45,29
779,32,32,646,646,0,164,164,743,743,0,0.0004084550188910446,0.0004084550188910446,658,658,0,-1,3,3,22,4,33,551,740
780,7,7,603,603,0,8,8,611,611,0,0.00017018959120460194,0.00017018959120460194,544,544,0,-1,4,4,2,2,959,323,502
781,8,8,538,538,0,6,6,412,412,0,0.00034037918240920387,0.00034037918240920387,658,658,0,-1,5,5,3,5,780,562,686
782,0,206,1,970,969,0,14,1,523,522,0.0,0.0005105687736138058,1,699,698,3,-1,4,3,0,808,678,243
783,20,122,668,921,253,16,16,493,493,0,0.00013615167296368154,0.00017018959120460194,514,535,21,4,4,4,4,9,638,317,319
784,34,240,764,972,208,40,40,748,748,0,0.0010211375472276116,0.003642057251778481,813,944,131,3,3,3,5,6,311,377,48
785,6,6,520,520,0,8,8,551,551,0,0.0,0.0,1,1,0,-1,4,4,2,1,940,609,932
786,1,103,332,964,632,3,4,332,405,73,0.0,0.0005105687736138058,1,732,731,4,7,5,3,1,812,671,351
787,0,206,1,947,946,0,31,1,416,415,0.0,0.00017018959120460194,1,540,539,3,-1,4,15,0,102,880,505
788,0,206,1,966,965,0,18,1,560,559,0.0,0.0008509479560230097,1,789,788,3,-1,4,3,0,837,664,147
789,0,616,1,997,996,0,40,1,778,777,0.0,0.006841621566424997,1,970,969,2,-1,3,5,0,667,696,19
790,125,125,956,956,0,34,34,834,834,0,0.0035739814152966403,0.0035739814152966403,935,935,0,-1,3,3,4,37,789,74,974
791,0,0,1,1,0,0,0,1,1,0,0.0,0.0,1,1,0,-1,-1,-1,2,0,965,276,573
792,343,343,982,982,0,100,100,968,968,0,0.008986010415602982,0.008986010415602982,980,980,0,-1,2,2,6,54,446,19,977
793,6,6,427,427,0,15,15,449,449,0,3.4037918240920386e-05,3.4037918240920386e-05,398,398,0,-1,4,4,6,1,251,531,784
794,0,0,1,1,0,0,0,1,1,0,0.0,0.0,1,1,0,-1,-1,-1,2,0,981,457,850
795,0,616,1,991,990,0,60,1,632,631,0.0,0.0018380475850097008,1,872,871,2,-1,3,11,0,360,740,73
796,1,618,333,992,659,14,78,333,623,290,0.0,0.003165526396405596,1,926,925,2,6,3,14,4,268,595,25
797,0,616,1,994,993,0,70,1,576,575,0.0,0.0020422750944552232,1,883,882,2,-1,3,14,0,121,892,108
798,0,206,1,947,946,0,27,1,381,380,0.0,0.00010211375472276115,1,484,483,3,-1,4,17,0,39,565,164
799,4,210,435,972,537,7,24,392,655,263,3.4037918240920386e-05,0.001497668402600497,412,858,446,3,5,4,4,3,784,598,68
800,1,617,333,993,660,6,33,333,652,319,0.0,0.0038462847612240037,1,943,942,2,7,3,6,1,536,469,79
801,0,101,1,936,935,0,2,1,331,330,0.0,0.0,1,1,0,6,-1,7,2,0,948,969,603
802,170,170,945,945,0,146,146,924,924,0,0.0027911092957554717,0.0027911092957554717,923,923,0,-1,3,3,11,24,188,119,515
803,26,232,713,971,258,34,34,736,736,0,0.0005786446100956465,0.002484768031587188,725,902,177,3,3,3,4,5,887,252,66
804,0,0,1,1,0,0,0,1,1,0,0.0,0.0,1,1,0,-1,-1,-1,4,1,475,792,359
805,74,280,877,979,102,54,54,895,895,0,0.002280540522141666,0.002586881786309949,905,913,8,3,3,3,4,14,700,84,290
806,0,0,1,1,0,0,0,1,1,0,0.0,0.0,1,1,0,-1,-1,-1,8,3,225,753,907
807,1,207,333,960,627,8,19,333,430,97,0.0,0.0002723033459273631,1,610,609,3,6,4,8,1,223,640,199
808,19,19,597,597,0,54,54,491,491,0,6.807583648184077e-05,6.807583648184077e-05,441,441,0,-1,3,3,16,4,195,442,757
809,60,60,807,807,0,94,94,716,716,0,0.00176997174852786,0.00176997174852786,868,868,0,-1,3,3,14,11,172,166,965
810,0,101,1,892,891,0,6,1,332,331,0.0,0.0,1,1,0,5,-1,6,6,0,560,960,676
811,133,133,909,909,0,166,166,938,938,0,0.002212464685659825,0.002212464685659825,894,894,0,-1,2,2,12,14,143,243,488
812,0,206,1,969,968,0,10,1,453,452,0.0,0.0011232513019503727,1,836,835,3,-1,4,3,0,930,794,139
813,118,118,896,896,0,164,164,894,894,0,0.002314578440382586,0.002314578440382586,895,895,0,-1,3,3,14,27,144,304,914
814,96,96,889,889,0,76,76,895,895,0,0.002280540522141666,0.002280540522141666,893,893,0,-1,3,3,6,13,353,261,948
815,58,264,815,969,154,156,156,922,922,0,0.002280540522141666,0.002927260968719153,896,923,27,3,2,2,12,4,106,281,390
816,4,4,404,404,0,14,14,403,403,0,0.00010211375472276115,0.00010211375472276115,484,484,0,-1,5,5,8,2,418,298,726
817,6,108,428,911,483,30,30,569,569,0,0.0002382654276864427,0.0002382654276864427,598,598,0,4,4,4,7,1,497,110,518
818,61,162,895,974,79,32,32,948,948,0,0.002280540522141666,0.002586881786309949,906,918,12,5,3,3,2,18,998,148,413
819,0,102,1,905,904,0,8,1,356,355,0.0,6.807583648184077e-05,1,459,458,4,-1,5,7,1,510,895,196
820,14,14,579,579,0,24,24,535,535,0,0.0002723033459273631,0.0002723033459273631,612,612,0,-1,4,4,6,3,515,507,564
821,6,212,399,951,552,17,28,400,482,82,3.4037918240920386e-05,0.0002723033459273631,396,606,210,3,4,4,9,1,414,265,29
822,0,0,1,1,0,0,0,1,1,0,0.0,0.0,1,1,0,-1,-1,-1,2,0,625,928,792
823,1,102,332,948,616,3,3,332,332,0,0.0,3.4037918240920386e-05,1,399,398,5,6,6,3,4,854,595,152
824,92,708,861,994,133,84,104,769,867,98,0.0012594029749140542,0.01055175465468532,833,982,149,2,3,3,9,18,159,148,10
825,0,0,1,1,0,0,0,1,1,0,0.0,0.0,1,1,0,-1,-1,-1,8,1,301,554,702
826,0,206,1,949,948,0,26,1,448,447,0.0,0.0006467204465774873,1,739,738,3,-1,4,9,0,100,778,264
827,2,2,371,371,0,6,6,392,392,0,3.4037918240920386e-05,3.4037918240920386e-05,402,402,0,-1,5,5,4,1,610,878,993
828,14,630,635,997,362,26,36,653,770,117,0.0004084550188910446,0.0035059055788147996,673,933,260,2,4,3,5,3,376,616,94
829,0,101,1,905,904,0,7,1,330,329,0.0,3.4037918240920386e-05,1,406,405,5,-1,6,7,0,510,955,265
830,0,102,1,890,889,0,8,1,368,367,0.0,0.0,1,1,0,4,-1,5,5,0,719,664,661
831,2,208,379,979,600,4,9,383,541,158,3.4037918240920386e-05,0.001157289220191293,405,832,427,3,5,4,3,1,911,687,281
832,32,133,799,953,154,28,28,791,791,0,0.0010211375472276116,0.001055175465468532,819,826,7,5,3,3,3,5,958,273,931
833,7,109,525,933,408,8,8,444,444,0,0.00010211375472276115,0.00017018959120460194,484,542,58,4,5,5,4,4,891,156,829
834,40,40,736,736,0,118,118,817,817,0,0.0006126825283365669,0.0006126825283365669,744,744,0,-1,3,3,13,4,97,185,847
835,0,102,1,935,934,0,6,1,448,447,0.0,0.0008169100377820892,1,780,779,4,-1,5,3,0,639,548,193
836,0,0,1,1,0,0,0,1,1,0,0.0,0.0,1,1,0,-1,-1,-1,11,1,279,779,746
837,10,111,540,903,363,28,28,500,500,0,0.0004084550188910446,0.000442492937131965,675,686,11,5,4,4,8,3,428,307,771
838,0,206,1,973,972,0,12,1,480,479,0.0,0.00176997174852786,1,868,867,3,-1,4,4,0,735,892,119
839,0,206,1,971,970,0,8,1,438,437,0.0,0.0005786446100956465,1,731,730,3,-1,4,2,0,893,887,612
840,134,236,940,975,35,54,54,913,913,0,0.0040845501889104465,0.004220701861874128,945,945,0,4,3,3,4,24,631,8,451
841,26,232,782,983,201,24,24,813,813,0,0.001055175465468532,0.001497668402600497,812,850,38,3,3,3,3,6,867,234,480
842,538,744,985,995,10,340,340,996,996,0,0.007556417849484326,0.007794683277170768,969,969,0,3,2,2,15,61,95,14,237
843,2,103,358,913,555,8,8,409,409,0,0.00013615167296368154,0.0002042275094455223,514,576,62,5,5,5,4,2,623,550,274
844,0,0,1,1,0,0,0,1,1,0,0.0,0.0,1,1,0,-1,-1,-1,2,0,681,959,996
845,0,206,1,966,965,0,30,1,565,564,0.0,0.0026549576227917903,1,911,910,3,-1,4,7,1,413,650,56
846,52,153,862,962,100,22,22,773,773,0,0.0013615167296368155,0.0014295925661186562,853,860,7,5,3,3,2,14,598,139,385
847,16,222,580,961,381,50,50,669,669,0,0.0002382654276864427,0.0002723033459273631,605,628,23,3,3,3,8,1,186,420,152
848,0,0,1,1,0,0,0,1,1,0,0.0,0.0,1,1,0,-1,-1,-1,17,0,6,845,650
849,12,114,463,878,415,60,60,455,455,0,0.00010211375472276115,0.00017018959120460194,471,535,64,4,4,4,20,2,5,579,870
850,76,282,873,975,102,76,76,915,915,0,0.0020763130126961434,0.002382654276864427,896,909,13,3,3,3,6,13,341,42,208
851,14,116,508,884,376,57,57,503,503,0,6.807583648184077e-05,0.00010211375472276115,447,477,30,4,4,4,17,3,210,485,549
852,1,207,331,979,648,2,8,331,519,188,3.4037918240920386e-05,0.00176997174852786,406,882,476,3,7,4,2,1,947,640,81
853,0,616,1,998,997,0,30,1,748,747,0.0,0.005616256509751864,1,956,955,2,-1,3,4,0,344,696,78
854,68,68,863,863,0,34,34,740,740,0,0.0015317063208414173,0.0015317063208414173,862,862,0,-1,3,3,4,14,917,84,489
855,0,206,1,951,950,0,42,1,578,577,0.0,0.0013615167296368155,1,835,834,3,-1,4,9,1,249,767,63
856,0,0,1,1,0,0,0,1,1,0,0.0,0.0,1,1,0,-1,-1,-1,8,0,334,571,735
857,606,1222,991,999,8,348,348,991,991,0,0.011096361346540046,0.012798257258586064,982,986,4,2,2,2,17,59,210,6,255
858,0,0,1,1,0,0,0,1,1,0,0.0,0.0,1,1,0,-1,-1,-1,23,0,43,754,478
859,73,73,845,845,0,88,88,841,841,0,0.0010892133837094523,0.0010892133837094523,808,808,0,-1,3,3,8,9,357,294,685
860,2,208,363,976,613,3,7,366,497,131,0.0,0.00013615167296368154,1,510,509,3,5,4,2,2,816,662,107
861,0,101,1,873,872,0,20,1,332,331,0.0,3.4037918240920386e-05,1,383,382,5,-1,6,20,0,70,868,605
862,0,101,1,969,968,0,2,1,330,329,0.0,0.00017018959120460194,1,555,554,5,-1,6,2,0,884,821,718
863,0,0,1,1,0,0,0,1,1,0,0.0,0.0,1,1,0,-1,-1,-1,10,0,75,707,992
864,12,113,547,904,357,28,28,518,518,0,6.807583648184077e-05,6.807583648184077e-05,452,452,0,6,4,4,8,2,508,680,603
865,96,96,874,874,0,96,96,775,775,0,0.0012253650566731338,0.0012253650566731338,832,832,0,-1,3,3,11,18,76,147,712
866,7,623,511,997,486,18,28,529,682,153,0.0002382654276864427,0.001497668402600497,595,853,258,2,4,3,5,4,284,305,219
867,0,616,1,992,991,0,74,1,672,671,0.0,0.0024507301133462676,1,899,898,2,-1,3,12,0,187,635,142
868,0,0,1,1,0,0,0,1,1,0,0.0,0.0,1,1,0,-1,-1,-1,6,0,368,858,672
869,0,616,1,991,990,0,46,1,475,474,0.0,0.001055175465468532,1,796,795,2,-1,3,15,0,107,228,291
870,143,245,928,972,44,66,66,818,818,0,0.0016678579938050988,0.002144388849177984,865,894,29,4,3,3,6,23,378,106,336
871,100,100,889,889,0,100,100,934,934,0,0.041253956907995507,0.041253956907995507,1000,1000,0,-1,1,1,7,130,450,3,757
872,16,16,691,691,0,17,17,800,800,0,0.0005446066918547262,0.0005446066918547262,745,745,0,-1,3,3,2,1,283,869,940
873,0,101,1,942,941,0,2,1,332,331,0.0,0.0,1,1,0,6,-1,7,2,0,771,993,708
874,0,0,1,1,0,0,0,1,1,0,0.0,0.0,1,1,0,-1,-1,-1,5,0,571,971,564
875,38,38,712,712,0,184,184,918,918,0,0.0015657442390823377,0.0015657442390823377,855,855,0,-1,3,3,14,5,203,393,568
876,0,206,1,930,929,0,43,1,366,365,0.0,3.4037918240920386e-05,1,382,381,3,-1,4,33,3,9,348,225
877,12,12,638,638,0,14,14,631,631,0,0.00010211375472276115,0.00010211375472276115,492,492,0,-1,4,4,3,6,797,275,834
878,28,130,751,947,196,30,30,758,758,0,0.0004084550188910446,0.0011232513019503727,667,825,158,4,3,3,4,7,545,303,284
879,44,146,870,976,106,41,41,983,983,0,0.005207801490860819,0.0053439531638245,964,964,0,4,2,2,2,3,666,347,208
880,34,240,743,970,227,44,44,643,643,0,0.0007488342013002485,0.0020082371762143027,765,887,122,3,4,4,8,9,499,245,78
881,37,139,759,933,174,66,66,700,700,0,0.0007828721195411688,0.0008169100377820892,762,770,8,4,3,3,10,7,293,399,566
882,6,6,501,501,0,8,8,517,517,0,3.4037918240920386e-05,3.4037918240920386e-05,409,409,0,-1,4,4,2,1,771,609,517
883,106,312,916,981,65,50,50,865,865,0,0.002825147213996392,0.003267640151128357,920,928,8,3,3,3,5,17,412,45,459
884,56,158,837,954,117,76,76,902,902,0,0.0012594029749140542,0.0012934408931549745,838,843,5,4,2,2,6,6,451,494,935
885,192,398,955,984,29,122,122,955,955,0,0.003199564314646516,0.003982436434187685,929,943,14,3,2,2,8,30,383,39,145
886,2,104,352,883,531,31,31,405,405,0,3.4037918240920386e-05,3.4037918240920386e-05,399,399,0,4,5,5,16,2,78,518,357
887,0,206,1,977,976,0,14,1,628,627,0.0,0.002212464685659825,1,899,898,3,-1,4,3,0,871,815,25
888,38,244,684,955,271,198,198,813,813,0,0.0011913271384322134,0.0012934408931549745,813,827,14,3,3,3,23,3,30,438,199
889,0,206,1,958,957,0,38,1,577,576,0.0,0.0024166921951053475,1,900,899,3,-1,4,9,0,278,937,17
890,0,0,1,1,0,0,0,1,1,0,0.0,0.0,1,1,0,-1,-1,-1,12,0,106,983,839
891,46,46,752,752,0,150,150,870,870,0,0.0009190237925048504,0.0009190237925048504,784,784,0,-1,3,3,15,6,124,114,933
892,50,50,768,768,0,94,94,679,679,0,0.0007488342013002485,0.0007488342013002485,757,757,0,-1,3,3,13,6,165,46,794
893,65,681,795,991,196,202,242,832,886,54,0.00088498587426393,0.005241839409101739,771,951,180,2,2,2,22,6,22,232,16
894,0,102,1,874,873,0,20,1,364,363,0.0,3.4037918240920386e-05,1,398,397,4,-1,5,16,1,50,693,506
895,0,0,1,1,0,0,0,1,1,0,0.0,0.0,1,1,0,-1,-1,-1,12,0,292,678,990
896,38,244,670,955,285,220,220,792,792,0,0.0007147962830593281,0.0014636304843595766,748,848,100,3,3,3,25,4,17,288,83
897,6,108,468,934,466,18,18,664,664,0,0.00030634126416828345,0.0005786446100956465,636,721,85,4,4,4,3,1,712,500,266
898,28,234,734,971,237,44,44,788,788,0,0.0004765308553728854,0.0008169100377820892,686,773,87,3,3,3,6,5,575,314,612
899,0,102,1,917,916,0,5,1,355,354,0.0,0.00017018959120460194,1,540,539,4,-1,5,4,0,445,758,562
900,0,0,1,1,0,0,0,1,1,0,0.0,0.0,1,1,0,-1,-1,-1,12,1,184,841,997
901,45,146,827,953,126,40,40,797,797,0,0.0007147962830593281,0.0007488342013002485,764,770,6,5,3,3,5,13,430,340,334
902,0,101,1,880,879,0,10,1,332,331,0.0,3.4037918240920386e-05,1,395,394,5,-1,6,10,0,105,946,931
903,0,101,1,945,944,0,2,1,331,330,0.0,3.4037918240920386e-05,1,399,398,5,-1,6,2,1,760,742,555
904,0,0,1,1,0,0,0,1,1,0,0.0,0.0,1,1,0,-1,-1,-1,3,0,778,990,818
905,369,575,985,994,9,64,64,936,936,0,0.009870996289866912,0.009870996289866912,980,980,0,3,3,3,4,75,717,24,260
906,0,206,1,965,964,0,12,1,458,457,0.0,3.4037918240920386e-05,1,400,399,3,-1,4,4,0,532,880,215
907,8,110,518,918,400,26,26,548,548,0,3.4037918240920386e-05,0.00010211375472276115,407,491,84,4,4,4,7,2,477,791,720
908,85,186,854,945,91,80,80,746,746,0,0.001055175465468532,0.001055175465468532,810,810,0,5,3,3,10,12,75,99,484
909,0,206,1,949,948,0,28,1,400,399,0.0,6.807583648184077e-05,1,454,453,3,-1,4,14,1,198,806,362
910,3,3,453,453,0,4,4,377,377,0,0.00010211375472276115,0.00010211375472276115,480,480,0,-1,5,5,3,3,576,646,860
911,10,216,578,976,398,18,18,706,706,0,0.00017018959120460194,0.002144388849177984,539,895,356,3,4,4,3,3,882,485,68
912,0,616,1,991,990,0,68,1,542,541,0.0,0.0016338200755641784,1,865,864,2,-1,3,15,0,51,349,227
913,45,45,851,851,0,18,18,733,733,0,0.0015317063208414173,0.0015317063208414173,861,861,0,-1,4,4,3,17,879,269,388
914,0,206,1,964,963,0,16,1,509,508,0.0,0.0008509479560230097,1,779,778,3,-1,4,4,0,391,946,630
915,63,164,884,967,83,22,22,789,789,0,0.0018040096667687805,0.0018380475850097008,875,878,3,6,3,3,2,13,761,183,679
916,0,206,1,984,983,0,8,1,565,564,0.0,0.0026209197045508697,1,918,917,3,-1,4,2,0,666,728,142
917,0,0,1,1,0,0,0,1,1,0,0.0,0.0,1,1,0,-1,-1,-1,2,2,907,752,859
918,6,107,432,912,480,12,12,439,439,0,3.4037918240920386e-05,3.4037918240920386e-05,403,403,0,6,4,4,4,1,638,531,603
919,0,102,1,949,948,0,4,1,429,428,0.0,0.0009530617107457708,1,809,808,4,-1,5,2,1,781,742,122
920,20,20,766,766,0,18,18,769,769,0,0.0013274788113958951,0.0013274788113958951,856,856,0,-1,4,4,3,4,883,185,539
921,16,222,496,941,445,53,59,441,466,25,0.0002042275094455223,0.0005105687736138058,554,699,145,3,3,3,19,2,11,597,562
922,0,206,1,951,950,0,16,1,394,393,0.0,0.0005105687736138058,1,703,702,3,-1,4,9,0,414,907,425
923,0,616,1,998,997,0,20,1,779,778,0.0,0.0061949011198475104,1,967,966,2,-1,3,3,0,530,923,352
924,65,65,819,819,0,92,92,704,704,0,0.0007488342013002485,0.0007488342013002485,753,753,0,-1,3,3,14,10,47,366,977
925,241,343,978,985,7,70,70,946,946,0,0.006943735321147759,0.007386228258279724,969,970,1,4,3,3,5,49,765,31,170
926,10,112,700,975,275,8,8,657,657,0,0.0004084550188910446,0.0005786446100956465,700,759,59,4,4,4,2,4,813,333,192
927,0,0,1,1,0,0,0,1,1,0,0.0,0.0,1,1,0,-1,-1,-1,4,0,949,897,991
928,2,208,358,957,599,14,28,397,520,123,0.0,0.000442492937131965,1,679,678,3,5,4,8,1,236,421,169
929,32,648,741,994,253,52,62,742,813,71,0.0011232513019503727,0.0033357159876101976,827,932,105,2,3,3,7,6,329,192,60
930,2,208,364,972,608,6,18,364,528,164,0.0,0.002110350930937064,1,892,891,3,5,4,5,2,430,679,88
931,1,103,333,928,595,5,7,333,386,53,0.0,3.4037918240920386e-05,1,401,400,4,6,5,5,1,602,140,347
932,16,16,608,608,0,32,32,602,602,0,0.000442492937131965,0.000442492937131965,698,698,0,-1,4,4,6,5,345,252,737
933,2,103,358,915,557,7,7,379,379,0,0.0,0.0,1,1,0,5,5,5,5,2,538,615,590
934,18,120,594,892,298,52,52,571,571,0,0.00013615167296368154,0.00030634126416828345,514,621,107,4,3,3,11,2,307,724,504
935,0,206,1,970,969,0,11,1,461,460,0.0,0.00034037918240920387,1,651,650,3,-1,4,5,0,908,678,229
936,0,0,1,1,0,0,0,1,1,0,0.0,0.0,1,1,0,-1,-1,-1,8,0,223,608,228
937,0,102,1,954,953,0,4,1,427,426,0.0,0.0008509479560230097,1,792,791,4,-1,5,2,1,946,730,45
938,9,111,558,925,367,11,12,457,483,26,0.00010211375472276115,0.0005446066918547262,482,703,221,4,4,4,4,3,655,347,622
939,6,212,470,977,507,16,20,588,658,70,0.00013615167296368154,0.002552843868069029,523,915,392,3,4,4,4,1,679,370,13
940,6,6,479,479,0,9,9,498,498,0,0.00010211375472276115,0.00010211375472276115,481,481,0,-1,4,4,3,1,888,762,754
941,0,0,1,1,0,0,0,1,1,0,0.0,0.0,1,1,0,-1,-1,-1,10,1,272,705,633
942,1,103,332,901,569,5,6,332,357,25,0.0,0.00010211375472276115,1,483,482,4,6,5,5,3,426,181,762
943,0,206,1,936,935,0,74,1,497,496,0.0,0.0004765308553728854,1,672,671,3,-1,4,22,0,55,979,306
944,18,18,583,583,0,68,68,614,614,0,0.00037441710065012424,0.00037441710065012424,665,665,0,-1,4,4,12,3,175,173,548
945,46,148,733,915,182,142,142,810,810,0,0.0004765308553728854,0.0005786446100956465,692,715,23,4,2,2,15,3,51,300,761
946,0,206,1,964,963,0,36,1,611,610,0.0,0.002382654276864427,1,898,897,3,-1,4,8,0,541,740,26
947,133,749,913,994,81,146,146,916,916,0,0.002552843868069029,0.0053099152455835805,907,958,51,2,2,2,12,20,348,87,133
948,18,224,614,958,344,36,44,507,552,45,0.00037441710065012424,0.0009190237925048504,658,791,133,3,4,4,10,5,99,310,413
949,6,6,495,495,0,8,8,515,515,0,0.00017018959120460194,0.00017018959120460194,545,545,0,-1,4,4,2,1,713,420,996
950,2,208,354,961,607,8,16,354,436,82,0.0,0.00030634126416828345,1,630,629,3,5,4,7,1,364,437,486
951,32,648,825,999,174,18,28,695,837,142,0.0012253650566731338,0.007011811157629599,836,967,131,2,4,3,3,14,902,190,316
952,6,622,382,988,606,54,88,472,602,130,6.807583648184077e-05,0.0023486163586235067,448,903,455,2,4,3,17,2,6,805,69
953,0,206,1,976,975,0,11,1,496,495,0.0,0.0002382654276864427,1,585,584,3,-1,4,4,0,553,804,727
954,6,6,414,414,0,14,14,412,412,0,6.807583648184077e-05,6.807583648184077e-05,449,449,0,-1,4,4,7,3,156,676,767
955,0,102,1,943,942,0,3,1,373,372,0.0,3.4037918240920386e-05,1,410,409,4,-1,5,2,0,919,517,964
956,4,106,479,956,477,4,4,426,426,0,0.00010211375472276115,0.0004765308553728854,493,702,209,4,5,5,2,5,792,231,407
957,8,109,514,915,401,22,22,481,481,0,0.00037441710065012424,0.0005446066918547262,653,704,51,5,4,4,7,3,400,795,646
958,256,358,959,979,20,288,288,957,957,0,0.003914360597705844,0.003914360597705844,939,939,0,4,2,2,20,31,61,35,631
959,8,109,554,937,383,8,8,483,483,0,0.0,0.0,1,1,0,7,4,4,2,4,925,346,621
960,9,110,540,914,374,14,14,457,457,0,3.4037918240920386e-05,3.4037918240920386e-05,401,401,0,5,4,4,5,3,173,485,837
961,110,212,906,961,55,62,62,760,760,0,0.0018380475850097008,0.0018720855032506212,875,875,0,4,3,3,7,17,366,96,576
962,52,52,776,776,0,158,158,831,831,0,0.0008169100377820892,0.0008169100377820892,775,775,0,-1,2,2,17,3,24,519,996
963,6,108,527,960,433,4,4,452,452,0,0.00030634126416828345,0.0007488342013002485,650,782,132,4,5,5,2,4,974,208,612
964,24,126,714,936,222,36,36,716,716,0,0.0005105687736138058,0.0005105687736138058,724,724,0,4,3,3,5,4,665,288,631
965,0,0,1,1,0,0,0,1,1,0,0.0,0.0,1,1,0,-1,-1,-1,12,0,184,520,522
966,0,616,1,995,994,0,29,1,515,514,0.0,0.00088498587426393,1,783,782,2,-1,3,8,0,225,944,432
967,0,102,1,935,934,0,4,1,405,404,0.0,0.00010211375472276115,1,491,490,4,-1,5,2,0,970,698,110
968,22,228,659,970,311,60,60,785,785,0,0.0006807583648184077,0.002586881786309949,742,908,166,3,3,3,8,2,454,475,171
969,0,0,1,1,0,0,0,1,1,0,0.0,0.0,1,1,0,-1,-1,-1,4,0,696,801,912
970,2,2,376,376,0,4,4,378,378,0,0.0,0.0,1,1,0,-1,5,5,3,1,485,421,956
971,152,152,948,948,0,78,78,960,960,0,0.004186663943633207,0.004186663943633207,945,945,0,-1,2,2,4,19,694,133,996
972,57,263,852,980,128,50,50,836,836,0,0.001055175465468532,0.002314578440382586,811,900,89,3,3,3,5,12,644,67,180
973,0,206,1,971,970,0,10,1,457,456,0.0,0.0002042275094455223,1,560,559,3,-1,4,4,2,815,775,451
974,0,0,1,1,0,0,0,1,1,0,0.0,0.0,1,1,0,-1,-1,-1,4,0,397,876,881
975,14,116,648,944,296,12,12,608,608,0,0.0009190237925048504,0.0011232513019503727,807,832,25,4,4,4,2,6,904,114,785
976,18,18,678,678,0,36,36,875,875,0,0.0009530617107457708,0.0009530617107457708,805,805,0,-1,3,3,4,3,507,559,831
977,0,0,1,1,0,0,0,1,1,0,0.0,0.0,1,1,0,-1,-1,-1,4,1,738,568,588
978,12,12,601,601,0,18,18,653,653,0,6.807583648184077e-05,6.807583648184077e-05,462,462,0,-1,4,4,3,5,833,476,651
979,17,17,721,721,0,12,12,670,670,0,0.0006807583648184077,0.0006807583648184077,757,757,0,-1,4,4,2,9,946,145,963
980,0,0,1,1,0,0,0,1,1,0,0.0,0.0,1,1,0,-1,-1,-1,3,0,568,997,850
981,33,133,772,939,167,36,36,748,748,0,0.0006807583648184077,0.0008509479560230097,755,787,32,4,3,3,5,9,284,293,191
982,110,211,891,955,64,104,104,864,864,0,0.002552843868069029,0.002552843868069029,915,915,0,5,3,3,9,15,351,158,679
983,78,78,826,826,0,160,160,858,858,0,0.0015657442390823377,0.0015657442390823377,854,854,0,-1,2,2,15,8,49,161,927
984,63,164,838,942,104,88,88,886,886,0,0.0026549576227917903,0.0026889955410327104,909,909,0,5,2,2,8,8,595,161,924
985,75,281,894,984,90,28,28,801,801,0,0.001497668402600497,0.0024166921951053475,868,904,36,3,3,3,3,17,583,79,185
986,21,123,664,920,256,68,68,842,842,0,0.0005786446100956465,0.0005786446100956465,716,716,0,4,3,3,7,7,398,427,342
987,97,97,921,921,0,38,38,891,891,0,0.002927260968719153,0.002927260968719153,922,922,0,-1,3,3,3,20,912,43,993
988,0,0,1,1,0,0,0,1,1,0,0.0,0.0,1,1,0,-1,-1,-1,12,0,375,713,426
989,13,219,620,973,353,16,20,537,608,71,0.00030634126416828345,0.0008169100377820892,632,790,158,3,4,4,4,3,403,236,379
990,2,2,375,375,0,4,4,376,376,0,3.4037918240920386e-05,3.4037918240920386e-05,404,404,0,-1,5,5,3,1,796,771,943
991,13,115,629,943,314,8,8,484,484,0,0.00013615167296368154,0.00030634126416828345,517,650,133,4,4,4,2,5,972,528,519
992,10,112,578,940,362,20,20,547,547,0,0.00017018959120460194,0.0007147962830593281,560,762,202,4,4,4,6,3,529,248,160
993,26,26,819,819,0,24,24,855,855,0,0.0009530617107457708,0.0009530617107457708,816,816,0,-1,3,3,3,6,850,377,388
994,0,102,1,883,882,0,20,1,386,385,0.0,0.00017018959120460194,1,557,556,4,-1,5,12,0,44,574,667
995,32,238,796,979,183,12,12,586,586,0,0.0011232513019503727,0.0018040096667687805,832,879,47,3,4,4,2,8,934,250,559
996,2,104,370,943,573,4,4,412,412,0,0.00013615167296368154,0.0002042275094455223,526,579,53,4,5,5,2,2,804,550,561
997,23,229,680,970,290,54,58,726,752,26,0.0007488342013002485,0.0030974505599237552,758,922,164,3,3,3,8,6,454,406,111
998,0,0,1,1,0,0,0,1,1,0,0.0,0.0,1,1,0,-1,-1,-1,9,3,803,746,767
999,1,1,333,333,0,6,6,333,333,0,0.0,0.0,1,1,0,-1,6,6,6,1,402,140,794
