,FreeNet_pre_score,FreeNet_post_score,FreeNet_pre_rank,FreeNet_post_rank,FreeNet_delta_ranks,Reversed_pre_score,Reversed_post_score,Reversed_pre_rank,Reversed_post_rank,Reversed_delta_ranks,Random_pre_score,Random_post_score,Random_pre_rank,Random_post_rank,Random_delta_ranks,dist_victim_relayer,dist_victim_vilain_pre,dist_victim_vilain_post,out_deg_victim,in_deg_villain,victim,villain,relayer
0,0,0,1,1,0,0,0,1,1,0,0.0,0.0,1,1,0,-1,-1,-1,16,0,27,813,816
1,42,42,770,770,0,68,68,727,727,0,0.0005446066918547262,0.0005446066918547262,713,713,0,-1,3,3,10,6,355,494,740
2,22,124,736,948,212,22,22,772,772,0,0.000442492937131965,0.0004765308553728854,696,709,13,4,3,3,2,2,689,827,476
3,2,103,396,967,571,4,4,467,467,0,3.4037918240920386e-05,6.807583648184077e-05,402,453,51,5,5,5,2,1,807,840,585
4,15,116,569,909,340,22,22,484,484,0,0.00030634126416828345,0.00030634126416828345,622,622,0,5,4,4,7,4,209,208,764
5,0,0,1,1,0,0,0,1,1,0,0.0,0.0,1,1,0,-1,-1,-1,2,3,974,854,701
6,150,150,954,954,0,62,62,956,956,0,0.00888389666088022,0.00888389666088022,978,978,0,-1,2,2,3,22,780,128,651
7,6,212,396,957,561,20,26,410,464,54,0.0,0.0002042275094455223,1,561,560,3,4,4,9,1,381,743,302
8,0,206,1,969,968,0,12,1,441,440,0.0,0.0004084550188910446,1,674,673,3,-1,4,4,0,870,887,465
9,0,102,1,889,888,0,11,1,350,349,0.0,0.00010211375472276115,1,483,482,4,-1,5,10,0,204,961,360
10,0,101,1,914,913,0,2,1,330,329,0.0,0.0,1,1,0,5,-1,6,2,0,769,324,540
11,0,102,1,898,897,0,12,1,367,366,0.0,3.4037918240920386e-05,1,396,395,4,-1,5,9,1,339,472,652
12,1,1,331,331,0,2,2,331,331,0,0.0,0.0,1,1,0,-1,9,9,2,1,936,857,929
13,38,38,747,747,0,74,74,765,765,0,0.0005446066918547262,0.0005446066918547262,724,724,0,-1,3,3,9,4,803,407,848
14,128,128,923,923,0,108,108,931,931,0,0.0020422750944552232,0.0020422750944552232,883,883,0,-1,3,3,8,20,443,71,985
15,100,100,852,852,0,100,100,592,592,0,0.009020048333843901,0.009496579189216788,972,975,3,3,1,1,19,17,83,226,240
16,0,0,1,1,0,0,0,1,1,0,0.0,0.0,1,1,0,-1,-1,-1,4,0,475,909,455
17,10,112,550,922,372,14,14,473,473,0,6.807583648184077e-05,0.0002382654276864427,450,605,155,4,4,4,5,4,338,567,425
18,6,108,385,879,494,56,56,505,505,0,3.4037918240920386e-05,0.00010211375472276115,402,482,80,4,4,4,14,1,133,718,315
19,0,102,1,911,910,0,6,1,372,371,0.0,0.00034037918240920387,1,646,645,4,-1,5,4,0,870,890,115
20,0,102,1,904,903,0,10,1,379,378,0.0,0.0,1,1,0,4,-1,5,7,0,343,860,369
21,23,125,820,973,153,28,28,931,931,0,0.0020763130126961434,0.002280540522141666,900,915,15,4,3,3,3,4,812,281,286
22,0,102,1,913,912,0,4,1,392,391,0.0,0.000442492937131965,1,689,688,4,-1,5,2,1,905,742,211
23,4,4,496,496,0,5,5,439,439,0,0.0002042275094455223,0.0002042275094455223,583,583,0,-1,5,5,3,2,852,549,845
24,62,268,832,971,139,128,128,948,948,0,0.002382654276864427,0.0037441710065012424,906,937,31,3,2,2,9,4,200,281,116
25,0,206,1,970,969,0,14,1,459,458,0.0,0.0002042275094455223,1,580,579,3,-1,4,5,0,766,942,329
26,46,46,793,793,0,58,58,741,741,0,0.0012594029749140542,0.0012594029749140542,829,829,0,-1,2,2,8,2,325,468,672
27,0,206,1,976,975,0,8,1,496,495,0.0,0.00030634126416828345,1,640,639,3,-1,4,2,1,750,841,291
28,30,30,683,683,0,66,66,568,568,0,0.0005786446100956465,0.0005786446100956465,731,731,0,-1,3,3,14,5,198,562,816
29,0,101,1,930,929,0,4,1,330,329,0.0,0.0,1,1,0,6,-1,7,4,0,573,883,861
30,22,124,694,934,240,30,30,692,692,0,0.0005446066918547262,0.0006807583648184077,727,750,23,4,4,4,5,6,565,192,229
31,0,102,1,864,863,0,31,1,373,372,0.0,6.807583648184077e-05,1,434,433,4,-1,5,21,0,74,952,840
32,0,102,1,930,929,0,5,1,354,353,0.0,6.807583648184077e-05,1,440,439,4,-1,5,4,0,562,776,279
33,39,245,780,969,189,52,52,783,783,0,0.0004084550188910446,0.0009870996289866913,669,790,121,3,3,3,6,7,556,176,516
34,24,24,729,729,0,18,18,638,638,0,0.00034037918240920387,0.00034037918240920387,648,648,0,-1,4,4,3,6,935,435,946
35,16,16,665,665,0,14,14,587,587,0,0.00030634126416828345,0.00030634126416828345,639,639,0,-1,4,4,3,7,748,115,998
36,1,1,333,333,0,2,2,333,333,0,0.0,0.0,1,1,0,-1,6,6,2,3,681,748,276
37,3,104,473,962,489,4,4,432,432,0,0.0002042275094455223,0.0002042275094455223,586,586,0,5,5,5,2,3,996,761,572
38,18,224,585,957,372,72,72,609,609,0,0.0002382654276864427,0.0005446066918547262,583,710,127,3,4,4,14,6,79,247,212
39,0,101,1,949,948,0,2,1,330,329,0.0,3.4037918240920386e-05,1,401,400,5,-1,6,2,1,702,573,444
40,0,0,1,1,0,0,0,1,1,0,0.0,0.0,1,1,0,-1,-1,-1,4,0,462,942,738
41,6,212,449,968,519,14,18,475,532,57,0.0,0.0005105687736138058,1,707,706,3,4,4,5,1,551,878,155
42,6,107,436,916,480,15,15,503,503,0,0.0,3.4037918240920386e-05,1,401,400,5,4,4,4,2,717,342,298
43,16,222,489,945,456,68,72,475,487,12,0.0005786446100956465,0.0007488342013002485,713,746,33,3,3,3,23,2,43,805,722
44,0,102,1,881,880,0,12,1,360,359,0.0,3.4037918240920386e-05,1,399,398,4,-1,5,10,0,99,872,441
45,1,1,333,333,0,3,3,333,333,0,0.0,0.0,1,1,0,-1,6,6,3,1,670,603,946
46,88,88,879,879,0,92,92,924,924,0,0.0011913271384322134,0.0011913271384322134,823,823,0,-1,3,3,7,11,207,97,574
47,0,0,1,1,0,0,0,1,1,0,0.0,0.0,1,1,0,-1,-1,-1,4,0,384,887,554
48,0,206,1,954,953,0,32,1,475,474,0.0,0.0012253650566731338,1,829,828,3,-1,4,10,1,153,792,66
49,185,286,968,983,15,44,44,916,916,0,0.004969536063174376,0.005037611899656217,954,954,0,6,3,3,4,50,610,33,603
50,0,101,1,920,919,0,4,1,332,331,0.0,0.0,1,1,0,6,-1,7,4,0,344,774,540
51,6,108,427,918,491,12,12,543,543,0,0.00017018959120460194,0.0002723033459273631,556,604,48,4,4,4,2,1,769,609,385
52,510,612,994,996,2,118,118,989,989,0,0.013887470642295518,0.013921508560536438,991,991,0,4,2,2,5,85,531,0,499
53,82,184,901,969,68,44,44,880,880,0,0.0015317063208414173,0.0016678579938050988,857,865,8,4,3,3,4,12,562,163,376
54,62,678,815,994,179,86,96,718,753,35,0.00088498587426393,0.0017018959120460194,780,865,85,2,3,3,11,9,188,242,327
55,31,237,773,977,204,34,34,784,784,0,0.0009870996289866913,0.0026889955410327104,803,911,108,3,3,3,4,8,659,257,122
56,0,101,1,906,905,0,6,1,332,331,0.0,0.0,1,1,0,5,-1,6,6,0,518,774,656
57,592,592,996,996,0,104,104,990,990,0,0.015555328636100617,0.015555328636100617,992,992,0,-1,2,2,5,98,284,23,574
58,7,108,548,942,394,10,10,537,537,0,3.4037918240920386e-05,0.00013615167296368154,395,518,123,5,4,4,3,2,961,697,378
59,0,206,1,964,963,0,19,1,474,473,0.0,0.000442492937131965,1,691,690,3,-1,4,6,0,498,635,329
60,1,207,332,986,654,2,8,332,580,248,3.4037918240920386e-05,0.0026889955410327104,407,919,512,3,6,4,2,1,985,618,111
61,9,110,526,913,387,14,14,435,435,0,0.0002042275094455223,0.0002042275094455223,561,561,0,5,4,4,5,6,349,406,540
62,6,212,467,974,507,11,15,483,547,64,0.0,0.00037441710065012424,1,670,669,3,4,4,4,2,891,313,233
63,0,616,1,993,992,0,62,1,629,628,0.0,0.0018720855032506212,1,878,877,2,-1,3,12,0,93,953,129
64,2,102,373,932,559,6,6,424,424,0,0.00010211375472276115,0.0013955546478777359,495,860,365,4,5,5,3,1,745,110,36
65,18,120,667,931,264,18,18,608,608,0,0.0002723033459273631,0.00030634126416828345,612,630,18,4,4,4,3,3,989,519,680
66,0,0,1,1,0,0,0,1,1,0,0.0,0.0,1,1,0,-1,-1,-1,4,0,917,911,478
67,86,86,892,892,0,38,38,852,852,0,0.002586881786309949,0.002586881786309949,903,903,0,-1,3,3,3,17,554,85,515
68,22,22,698,698,0,30,30,724,724,0,0.00030634126416828345,0.00030634126416828345,630,630,0,-1,3,3,4,4,384,551,787
69,58,160,899,975,76,22,22,855,855,0,0.0013274788113958951,0.0013955546478777359,853,857,4,4,3,3,2,18,991,147,241
70,8,8,556,556,0,10,10,501,501,0,0.0002042275094455223,0.0002042275094455223,582,582,0,-1,4,4,3,5,699,401,517
71,24,230,637,954,317,98,102,658,692,34,0.0005105687736138058,0.0013955546478777359,692,841,149,3,3,3,16,3,60,236,179
72,198,404,938,980,42,202,202,937,937,0,0.0031314884781646754,0.0032336022328874367,926,930,4,3,2,2,14,16,127,78,447
73,0,206,1,957,956,0,12,1,417,416,0.0,0.00013615167296368154,1,501,500,3,-1,4,5,0,496,849,251
74,6,107,476,933,457,9,9,488,488,0,6.807583648184077e-05,6.807583648184077e-05,453,453,0,6,4,4,3,1,288,592,331
75,119,325,911,979,68,88,88,835,835,0,0.002314578440382586,0.0028591851322373124,906,928,22,3,3,3,8,23,186,122,616
76,59,59,801,801,0,96,96,682,682,0,0.0008509479560230097,0.0008509479560230097,779,779,0,-1,3,3,14,9,198,212,820
77,17,223,676,976,300,16,16,569,569,0,0.000442492937131965,0.0010211375472276116,705,819,114,3,4,4,4,5,673,636,326
78,32,134,767,937,170,34,34,750,750,0,0.001157289220191293,0.0014636304843595766,845,859,14,4,3,3,4,7,444,224,262
79,179,281,934,963,29,196,196,906,906,0,0.0027911092957554717,0.002927260968719153,913,917,4,4,2,2,17,22,63,128,188
80,7,108,522,924,402,8,8,423,423,0,0.00030634126416828345,0.00034037918240920387,639,656,17,5,5,5,4,6,784,613,618
81,116,116,914,914,0,60,60,852,852,0,0.0019741992579733825,0.0019741992579733825,878,878,0,-1,3,3,5,24,571,129,877
82,24,24,706,706,0,35,35,677,677,0,0.00034037918240920387,0.00034037918240920387,648,648,0,-1,3,3,7,6,697,392,388
83,4,210,401,964,563,13,31,389,535,146,0.0,0.0005786446100956465,1,726,725,3,5,4,8,2,499,694,759
84,6,6,400,400,0,40,40,496,496,0,0.00010211375472276115,0.00010211375472276115,473,473,0,-1,4,4,12,2,58,691,650
85,6,6,400,400,0,31,31,513,513,0,0.00013615167296368154,0.00013615167296368154,512,512,0,-1,4,4,9,1,306,899,998
86,17,17,653,653,0,18,18,530,530,0,0.00017018959120460194,0.00017018959120460194,537,537,0,-1,4,4,5,5,519,362,966
87,0,206,1,949,948,0,27,1,400,399,0.0,0.00013615167296368154,1,520,519,3,-1,4,14,2,198,684,450
88,66,272,805,962,157,124,124,740,740,0,0.00088498587426393,0.0012934408931549745,768,824,56,3,3,3,17,10,94,413,418
89,100,100,902,902,0,100,100,968,968,0,0.028591851322373123,0.028659927158854966,999,999,0,3,1,1,6,29,455,142,379
90,118,324,919,977,58,54,54,860,860,0,0.002314578440382586,0.0028591851322373124,896,919,23,3,3,3,4,12,385,58,219
91,184,800,960,999,39,70,70,935,935,0,0.00439089145307873,0.007318152421797883,947,974,27,2,3,3,5,38,457,111,35
92,0,102,1,892,891,0,13,1,376,375,0.0,0.00013615167296368154,1,508,507,4,-1,5,9,0,394,200,634
93,0,102,1,880,879,0,16,1,369,368,0.0,3.4037918240920386e-05,1,397,396,4,-1,5,12,0,175,961,791
94,47,149,778,928,150,66,66,673,673,0,0.0014295925661186562,0.0014636304843595766,841,844,3,4,3,3,10,10,152,366,598
95,0,102,1,914,913,0,11,1,411,410,0.0,0.00017018959120460194,1,544,543,4,-1,5,6,0,253,624,681
96,31,133,808,956,148,18,18,692,692,0,0.0006126825283365669,0.0006467204465774873,733,746,13,4,4,4,3,8,770,284,508
97,16,222,566,960,394,36,48,528,596,68,0.00013615167296368154,0.0004765308553728854,507,710,203,3,3,3,9,2,213,714,169
98,1,617,333,993,660,15,76,333,625,292,0.0,0.003437829742332959,1,930,929,2,9,3,15,1,138,647,14
99,76,282,895,984,89,64,64,962,962,0,0.00527587732734266,0.005888559855679227,964,967,3,3,2,2,4,9,573,130,211
100,4,620,450,1000,550,4,18,413,782,369,0.00017018959120460194,0.005616256509751864,538,963,425,2,5,3,2,4,816,319,879
101,1,207,333,968,635,5,12,333,450,117,0.0,0.00010211375472276115,1,478,477,3,7,4,5,2,386,448,741
102,19,120,622,909,287,38,38,566,566,0,0.0002042275094455223,0.0002042275094455223,570,570,0,5,3,3,9,4,315,442,466
103,8,110,537,933,396,28,28,672,672,0,0.0002723033459273631,0.0005786446100956465,620,737,117,4,4,4,6,2,486,697,90
104,86,188,884,958,74,78,78,952,952,0,0.0024507301133462676,0.0026209197045508697,899,908,9,4,2,2,4,14,509,243,458
105,146,248,937,971,34,122,122,971,971,0,0.005071649817897137,0.00527587732734266,954,955,1,4,2,2,8,21,440,157,785
106,34,34,687,687,0,88,88,622,622,0,0.00030634126416828345,0.00030634126416828345,635,635,0,-1,3,3,15,4,40,167,620
107,0,101,1,915,914,0,4,1,330,329,0.0,0.0,1,1,0,8,-1,9,4,0,675,950,626
108,100,100,912,912,0,100,100,989,989,0,0.04081146397086354,0.04081146397086354,999,999,0,-1,1,1,4,48,736,56,844
109,0,206,1,967,966,0,21,1,524,523,0.0,0.0005786446100956465,1,731,730,3,-1,4,7,0,697,546,189
110,14,14,701,701,0,12,12,745,745,0,0.0002042275094455223,0.0002042275094455223,570,570,0,-1,4,4,2,4,950,450,965
111,0,206,1,975,974,0,16,1,538,537,0.0,0.0010892133837094523,1,823,822,3,-1,4,4,0,475,866,255
112,0,206,1,964,963,0,16,1,431,430,0.0,0.00037441710065012424,1,659,658,3,-1,4,8,0,323,926,487
113,7,213,549,982,433,4,8,424,518,94,0.0002042275094455223,0.0014636304843595766,568,856,288,3,5,4,2,5,938,362,94
114,30,131,705,918,213,80,80,761,761,0,0.0010211375472276116,0.001055175465468532,802,802,0,5,3,3,10,4,409,207,931
115,0,0,1,1,0,0,0,1,1,0,0.0,0.0,1,1,0,-1,-1,-1,17,0,6,926,657
116,0,206,1,975,974,0,10,1,515,514,0.0,0.0008169100377820892,1,791,790,3,-1,4,3,0,710,844,470
117,42,144,791,942,151,48,48,729,729,0,0.0004084550188910446,0.0007147962830593281,674,752,78,4,3,3,7,13,141,217,613
118,46,148,819,949,130,40,40,777,777,0,0.0012934408931549745,0.0016678579938050988,838,866,28,4,3,3,5,12,691,100,107
119,84,290,915,987,72,22,22,805,805,0,0.0028591851322373124,0.0036760951700194017,925,943,18,3,3,3,2,19,939,133,326
120,12,218,512,956,444,39,44,476,493,17,3.4037918240920386e-05,0.001055175465468532,392,810,418,3,4,4,14,5,79,231,148
121,2,2,359,359,0,11,11,419,419,0,3.4037918240920386e-05,3.4037918240920386e-05,392,392,0,-1,5,5,6,1,575,618,478
122,6,212,428,968,540,10,14,440,500,60,0.00010211375472276115,0.0012253650566731338,491,835,344,3,4,4,3,1,634,531,106
123,0,206,1,952,951,0,27,1,437,436,0.0,0.0002723033459273631,1,609,608,3,-1,4,10,0,135,812,637
124,24,24,651,651,0,108,108,729,729,0,0.0004765308553728854,0.0004765308553728854,691,691,0,-1,3,3,16,3,78,268,815
125,9,215,567,973,406,14,18,548,613,65,3.4037918240920386e-05,0.0013274788113958951,397,849,452,3,4,4,3,5,743,395,183
126,2,104,365,926,561,5,7,366,396,30,3.4037918240920386e-05,6.807583648184077e-05,415,454,39,4,5,5,4,1,475,437,797
127,0,206,1,964,963,0,15,1,448,447,0.0,0.00037441710065012424,1,664,663,3,-1,4,6,0,587,881,343
128,0,0,1,1,0,0,0,1,1,0,0.0,0.0,1,1,0,-1,-1,-1,3,0,699,808,489
129,0,0,1,1,0,0,0,1,1,0,0.0,0.0,1,1,0,-1,-1,-1,9,1,178,828,832
130,0,0,1,1,0,0,0,1,1,0,0.0,0.0,1,1,0,-1,-1,-1,3,0,730,912,732
131,0,102,1,890,889,0,9,1,381,380,0.0,6.807583648184077e-05,1,448,447,4,-1,5,5,0,719,751,810
132,16,16,605,605,0,32,32,588,588,0,0.0002382654276864427,0.0002382654276864427,592,592,0,-1,3,3,7,2,364,719,962
133,52,52,806,806,0,68,68,813,813,0,0.0006467204465774873,0.0006467204465774873,733,733,0,-1,3,3,7,6,346,136,356
134,50,152,799,930,131,72,72,761,761,0,0.0019061234214915416,0.002314578440382586,872,897,25,4,2,2,9,5,208,350,46
135,56,262,852,979,127,58,58,956,956,0,0.0019061234214915416,0.0021784267674189047,881,898,17,3,2,2,4,6,511,494,93
136,16,222,565,966,401,98,98,874,874,0,0.0011232513019503727,0.0014295925661186562,816,840,24,3,3,3,8,1,218,612,208
137,0,0,1,1,0,0,0,1,1,0,0.0,0.0,1,1,0,-1,-1,-1,6,0,473,877,678
138,2,1642,354,1000,646,14,78,397,829,432,3.4037918240920386e-05,0.01320671227747711,390,985,595,1,5,2,8,1,301,606,39
139,4,106,536,973,437,3,4,425,521,96,6.807583648184077e-05,0.001055175465468532,459,830,371,4,5,5,2,3,920,580,227
140,197,197,932,932,0,264,264,932,932,0,0.002314578440382586,0.002314578440382586,901,901,0,-1,2,2,20,24,61,129,657
141,6,622,376,991,615,39,154,402,764,362,0.0,0.004220701861874128,1,945,944,2,4,3,19,1,19,771,77
142,50,50,863,863,0,22,22,838,838,0,0.0020082371762143027,0.0020082371762143027,893,893,0,-1,3,3,2,15,702,151,669
143,137,343,940,983,43,44,44,841,841,0,0.0026549576227917903,0.00353994349705572,921,939,18,3,3,3,4,26,858,127,62
144,26,128,781,958,177,12,12,625,625,0,0.0002723033459273631,0.0005446066918547262,625,723,98,4,4,4,2,7,960,303,688
145,98,199,952,984,32,12,12,696,696,0,0.0026209197045508697,0.0026549576227917903,910,912,2,5,4,4,2,33,982,15,342
146,2,104,367,936,569,3,4,368,415,47,0.00013615167296368154,0.0007488342013002485,523,773,250,4,5,5,2,1,993,799,805
147,13,114,624,939,315,16,16,573,573,0,0.0002042275094455223,0.0002042275094455223,591,591,0,5,4,4,4,5,573,362,152
148,120,222,930,969,39,80,80,929,929,0,0.0030634126416828346,0.003199564314646516,923,925,2,4,2,2,6,17,587,96,809
149,8,214,491,950,459,58,58,598,598,0,0.00010211375472276115,0.00017018959120460194,487,542,55,3,4,4,11,2,279,323,442
150,0,102,1,923,922,0,7,1,363,362,0.0,6.807583648184077e-05,1,449,448,4,-1,5,6,3,594,882,238
151,0,0,1,1,0,0,0,1,1,0,0.0,0.0,1,1,0,-1,-1,-1,8,0,418,933,889
152,150,150,926,926,0,164,164,890,890,0,0.002586881786309949,0.002586881786309949,910,910,0,-1,3,3,14,18,121,171,456
153,136,238,928,969,41,108,108,939,939,0,0.0030293747234419145,0.003165526396405596,923,926,3,4,3,3,8,25,257,47,666
154,53,155,916,978,62,42,42,988,988,0,0.008713707069675619,0.00881582082439838,978,978,0,4,2,2,2,7,987,188,220
155,2,104,374,937,563,4,4,405,405,0,3.4037918240920386e-05,0.00013615167296368154,407,531,124,4,5,5,2,1,907,853,682
156,0,616,1,998,997,0,30,1,754,753,0.0,0.003880322679464924,1,942,941,2,-1,3,4,1,767,568,65
157,1,103,333,945,612,3,4,333,380,47,3.4037918240920386e-05,0.0004765308553728854,409,707,298,4,6,5,3,3,654,484,351
158,0,101,1,949,948,0,2,1,331,330,0.0,3.4037918240920386e-05,1,401,400,5,-1,6,2,0,702,793,140
159,0,102,1,954,953,0,3,1,389,388,0.0,0.0006126825283365669,1,764,763,4,-1,5,2,0,914,812,242
160,6,6,399,399,0,56,56,506,506,0,0.00037441710065012424,0.00037441710065012424,662,662,0,-1,4,4,16,4,78,409,852
161,6,6,433,433,0,13,13,445,445,0,6.807583648184077e-05,6.807583648184077e-05,456,456,0,-1,4,4,5,1,501,552,254
162,5,107,450,933,483,9,9,433,433,0,0.00010211375472276115,0.00030634126416828345,471,623,152,4,5,5,5,3,557,311,395
163,41,247,764,966,202,52,56,584,608,24,0.0005786446100956465,0.0010892133837094523,727,813,86,3,4,4,12,10,219,366,234
164,0,0,1,1,0,0,0,1,1,0,0.0,0.0,1,1,0,-1,-1,-1,5,0,571,967,971
165,0,0,1,1,0,0,0,1,1,0,0.0,0.0,1,1,0,-1,-1,-1,2,0,905,726,433
166,18,18,680,680,0,22,22,750,750,0,0.0012253650566731338,0.0012253650566731338,831,831,0,-1,3,3,2,3,966,559,624
167,0,102,1,901,900,0,9,1,381,380,0.0,0.00017018959120460194,1,541,540,4,-1,5,6,0,536,941,210
168,0,0,1,1,0,0,0,1,1,0,0.0,0.0,1,1,0,-1,-1,-1,8,1,449,962,740
169,3,3,458,458,0,6,6,447,447,0,6.807583648184077e-05,6.807583648184077e-05,455,455,0,-1,5,5,3,3,707,434,817
170,0,206,1,976,975,0,8,1,499,498,0.0,0.0005446066918547262,1,729,728,3,-1,4,2,1,880,641,382
171,19,635,663,997,334,36,36,735,735,0,0.0002723033459273631,0.002144388849177984,616,896,280,2,3,3,5,3,669,458,791
172,19,121,627,908,281,34,34,526,526,0,0.00010211375472276115,0.0002042275094455223,482,570,88,4,3,3,8,3,434,580,363
173,61,61,841,841,0,54,54,730,730,0,0.0004765308553728854,0.0004765308553728854,693,693,0,-1,3,3,8,17,158,327,367
174,0,0,1,1,0,0,0,1,1,0,0.0,0.0,1,1,0,-1,-1,-1,4,0,772,520,796
175,42,144,776,930,154,48,48,671,671,0,0.0008509479560230097,0.001055175465468532,787,813,26,4,3,3,7,10,209,195,285
176,0,102,1,909,908,0,7,1,349,348,0.0,0.0,1,1,0,4,-1,5,6,0,341,921,313
177,16,632,489,987,498,120,138,619,654,35,3.4037918240920386e-05,0.0009530617107457708,402,784,382,2,3,3,23,1,8,720,245
178,1,103,333,924,591,6,8,333,375,42,0.0,0.0002042275094455223,1,571,570,4,9,5,6,1,594,647,90
179,0,206,1,959,958,0,24,1,490,489,0.0,0.00030634126416828345,1,634,633,3,-1,4,6,0,312,569,327
180,10,216,570,971,401,10,14,460,543,83,0.00013615167296368154,0.0011232513019503727,516,826,310,3,4,4,3,4,577,156,144
181,2,208,374,977,603,4,12,405,605,200,0.0,0.0007488342013002485,1,780,779,3,5,4,2,2,907,575,471
182,0,206,1,969,968,0,10,1,457,456,0.0,0.0004084550188910446,1,678,677,3,-1,4,3,2,726,431,480
183,0,206,1,978,977,0,10,1,508,507,0.0,0.0010211375472276116,1,810,809,3,-1,4,3,0,676,675,64
184,8,110,561,946,385,14,14,581,581,0,0.00010211375472276115,0.000442492937131965,487,701,214,4,4,4,3,2,800,408,500
185,112,318,916,980,64,98,98,941,941,0,0.0033016780693692774,0.004833384390210695,934,953,19,3,2,2,8,12,442,179,72
186,10,112,587,937,350,12,12,567,567,0,0.00017018959120460194,0.0002382654276864427,541,599,58,4,4,4,2,3,828,222,689
187,23,124,823,977,154,8,8,644,644,0,0.0014295925661186562,0.0019741992579733825,855,892,37,5,4,4,2,15,884,137,92
188,23,125,692,934,242,18,18,505,505,0,0.0005786446100956465,0.0005786446100956465,719,719,0,4,4,4,5,10,605,296,623
189,0,102,1,938,937,0,4,1,372,371,0.0,6.807583648184077e-05,1,445,444,4,-1,5,3,0,888,844,566
190,0,206,1,966,965,0,28,1,550,549,0.0,0.001157289220191293,1,825,824,3,-1,4,6,0,514,986,180
191,2,2,364,364,0,12,12,447,447,0,0.0004084550188910446,0.0004084550188910446,673,673,0,-1,5,5,6,1,661,500,976
192,22,228,772,976,204,12,12,597,597,0,0.0006126825283365669,0.0018040096667687805,752,886,134,3,4,4,2,5,771,418,58
193,61,163,859,959,100,38,38,869,869,0,0.0019061234214915416,0.0020422750944552232,883,890,7,4,3,3,3,17,626,213,332
194,2,208,376,977,601,3,12,378,615,237,3.4037918240920386e-05,0.0013615167296368155,408,856,448,3,5,4,2,1,779,788,203
195,30,236,772,975,203,20,20,621,621,0,0.0006807583648184077,0.0015317063208414173,758,868,110,3,4,4,4,9,423,245,67
196,0,206,1,958,957,0,17,1,432,431,0.0,0.00030634126416828345,1,632,631,3,-1,4,7,0,118,855,473
197,0,206,1,948,947,0,29,1,417,416,0.0,0.00017018959120460194,1,542,541,3,-1,4,15,0,110,908,107
198,12,218,512,950,438,29,46,426,521,95,6.807583648184077e-05,0.0006467204465774873,441,737,296,3,4,4,13,2,185,576,267
199,20,226,700,975,275,20,20,649,649,0,0.00034037918240920387,0.001497668402600497,662,856,194,3,4,4,4,7,573,389,146
200,8,110,514,921,407,11,11,441,441,0,0.00017018959120460194,0.00017018959120460194,545,545,0,4,4,4,4,2,632,549,419
201,0,0,1,1,0,0,0,1,1,0,0.0,0.0,1,1,0,-1,-1,-1,17,1,112,949,760
202,58,264,845,980,135,40,40,799,799,0,0.0007147962830593281,0.001055175465468532,758,817,59,3,3,3,4,9,762,242,294
203,1,103,333,925,592,4,8,333,437,104,0.0,0.00034037918240920387,1,660,659,4,8,5,4,1,543,857,52
204,0,0,1,1,0,0,0,1,1,0,0.0,0.0,1,1,0,-1,-1,-1,8,0,158,860,431
205,6,6,397,397,0,32,32,463,463,0,6.807583648184077e-05,6.807583648184077e-05,444,444,0,-1,4,4,12,1,292,394,880
206,6,108,441,922,481,7,7,395,395,0,3.4037918240920386e-05,0.00037441710065012424,409,667,258,4,5,5,4,3,453,526,287
207,16,16,714,714,0,12,12,686,686,0,0.0002723033459273631,0.0002723033459273631,623,623,0,-1,4,4,2,9,991,293,942
208,0,0,1,1,0,0,0,1,1,0,0.0,0.0,1,1,0,-1,-1,-1,4,0,566,914,564
209,6,107,418,904,486,17,17,409,409,0,6.807583648184077e-05,6.807583648184077e-05,443,443,0,5,4,4,9,3,395,460,563
210,100,100,864,864,0,100,100,770,770,0,0.012083460975526737,0.012934408931549747,985,988,3,2,1,1,13,8,113,417,162
211,2,2,354,354,0,4,4,355,355,0,0.0,0.0,1,1,0,-1,5,5,3,1,737,736,841
212,0,206,1,957,956,0,12,1,400,399,0.0,0.00017018959120460194,1,546,545,3,-1,4,6,0,560,838,575
213,0,102,1,893,892,0,16,1,388,387,0.0,6.807583648184077e-05,1,453,452,4,-1,5,10,0,161,930,435
214,0,616,1,992,991,0,73,1,584,583,0.0,0.0011913271384322134,1,817,816,2,-1,3,18,0,29,790,155
215,0,102,1,951,950,0,4,1,412,411,0.0,0.000442492937131965,1,696,695,4,-1,5,2,0,681,774,268
216,14,220,582,967,385,16,16,509,509,0,0.0002042275094455223,0.0006807583648184077,585,752,167,3,4,4,4,5,516,710,396
217,66,66,856,856,0,70,70,894,894,0,0.0019061234214915416,0.0019061234214915416,875,875,0,-1,2,2,6,8,387,187,457
218,0,206,1,975,974,0,14,1,576,575,0.0,0.0013274788113958951,1,853,852,3,-1,4,3,0,670,944,218
219,202,304,947,973,26,150,150,941,941,0,0.005412029000306341,0.005650294427992784,961,963,2,4,2,2,11,25,163,105,256
220,0,206,1,987,986,0,8,1,613,612,0.0,0.0014295925661186562,1,869,868,3,-1,4,2,0,987,942,628
221,16,222,586,964,378,52,56,699,725,26,0.00030634126416828345,0.0006467204465774873,634,743,109,3,3,3,8,1,301,840,175
222,0,206,1,973,972,0,15,1,551,550,0.0,0.0014295925661186562,1,854,853,3,-1,4,4,0,573,604,42
223,0,616,1,993,992,0,96,1,763,762,0.0,0.010143299635794275,1,978,977,2,-1,3,11,0,167,784,37
224,22,638,604,989,385,102,110,641,659,18,0.00037441710065012424,0.0013615167296368155,647,834,187,2,3,3,20,3,70,795,130
225,0,102,1,961,960,0,5,1,428,427,0.0,0.00010211375472276115,1,486,485,4,-1,5,3,0,730,938,493
226,12,12,629,629,0,14,14,625,625,0,0.00017018959120460194,0.00017018959120460194,538,538,0,-1,4,4,3,6,693,199,254
227,0,102,1,936,935,0,4,1,396,395,0.0,0.00037441710065012424,1,667,666,4,-1,5,2,0,849,973,253
228,113,113,964,964,0,32,32,965,965,0,0.005922597773920147,0.005922597773920147,968,968,0,-1,3,3,2,29,995,17,848
229,118,734,938,999,61,48,48,918,918,0,0.002144388849177984,0.0057524081827155455,881,965,84,2,3,3,3,16,554,78,83
230,114,114,920,920,0,40,40,735,735,0,0.0018380475850097008,0.0018380475850097008,872,872,0,-1,3,3,5,22,492,203,956
231,0,0,1,1,0,0,0,1,1,0,0.0,0.0,1,1,0,-1,-1,-1,11,0,248,995,984
232,100,100,841,841,0,100,100,600,600,0,0.01681473161101467,0.016882807447496512,996,996,0,3,1,1,20,70,88,18,491
233,0,101,1,942,941,0,2,1,331,330,0.0,3.4037918240920386e-05,1,417,416,5,-1,6,2,0,802,712,547
234,32,32,804,804,0,32,32,903,903,0,0.0006807583648184077,0.0006807583648184077,760,760,0,-1,3,3,2,2,598,827,977
235,0,102,1,886,885,0,12,1,348,347,0.0,3.4037918240920386e-05,1,400,399,4,-1,5,11,0,139,588,398
236,14,115,607,931,324,16,16,512,512,0,0.0002042275094455223,0.0002382654276864427,576,604,28,6,4,4,4,5,504,688,292
237,0,102,1,892,891,0,16,1,398,397,0.0,0.00017018959120460194,1,537,536,4,-1,5,8,0,357,921,351
238,0,0,1,1,0,0,0,1,1,0,0.0,0.0,1,1,0,-1,-1,-1,5,0,238,991,854
239,0,206,1,968,967,0,12,1,457,456,0.0,0.0005446066918547262,1,730,729,3,-1,4,4,0,444,254,382
240,12,12,585,585,0,16,16,547,547,0,0.00034037918240920387,0.00034037918240920387,655,655,0,-1,4,4,4,3,401,197,881
241,2,104,349,881,532,28,34,392,414,22,0.0,0.00010211375472276115,1,472,471,4,5,5,18,1,29,503,368
242,2,2,355,355,0,11,11,381,381,0,0.0,0.0,1,1,0,-1,5,5,7,2,417,692,996
243,2,2,389,389,0,3,3,397,397,0,3.4037918240920386e-05,3.4037918240920386e-05,395,395,0,-1,5,5,2,2,933,648,709
244,3,105,452,951,499,6,6,449,449,0,0.00010211375472276115,0.0018040096667687805,489,883,394,4,5,5,3,3,854,631,111
245,137,343,907,980,73,102,102,823,823,0,0.0026209197045508697,0.0028932230504782326,905,920,15,3,3,3,11,20,307,94,145
246,0,102,1,938,937,0,3,1,371,370,0.0,0.00010211375472276115,1,497,496,4,-1,5,2,0,734,887,419
247,14,14,707,707,0,12,12,746,746,0,0.00034037918240920387,0.00034037918240920387,663,663,0,-1,4,4,2,4,799,233,660
248,0,616,1,993,992,0,106,1,732,731,0.0,0.004901460226692535,1,953,952,2,-1,3,15,0,104,696,16
249,12,114,555,917,362,20,20,532,532,0,0.00030634126416828345,0.0004765308553728854,630,700,70,4,4,4,4,2,385,453,637
250,160,366,921,978,57,184,188,920,925,5,0.002110350930937064,0.002212464685659825,895,897,2,3,2,2,14,15,122,153,441
251,6,6,385,385,0,35,35,392,392,0,0.0,0.0,1,1,0,-1,4,4,20,1,88,853,818
252,2,2,379,379,0,5,5,399,399,0,0.0,0.0,1,1,0,-1,5,5,3,2,530,509,839
253,236,236,962,962,0,124,124,932,932,0,0.0038462847612240037,0.0038462847612240037,941,941,0,-1,3,3,9,38,191,111,824
254,2,208,365,970,605,7,16,391,518,127,0.00010211375472276115,0.0014636304843595766,486,858,372,3,5,4,4,2,304,690,84
255,2,618,368,997,629,6,28,407,736,329,0.0,0.005207801490860819,1,963,962,2,5,3,3,1,680,924,76
256,16,222,659,977,318,22,22,790,790,0,0.0006807583648184077,0.0013615167296368155,760,860,100,3,3,3,2,2,880,482,407
257,0,102,1,951,950,0,3,1,369,368,0.0,0.0002382654276864427,1,600,599,4,-1,5,2,0,702,881,246
258,0,101,1,910,909,0,5,1,332,331,0.0,0.0,1,1,0,5,-1,6,5,0,667,728,509
259,6,212,441,971,530,28,32,606,656,50,0.00017018959120460194,0.001599782157323258,547,864,317,3,4,4,6,2,237,223,122
260,0,102,1,959,958,0,3,1,390,389,0.0,0.00017018959120460194,1,560,559,4,-1,5,2,0,996,254,285
261,47,47,810,810,0,48,48,751,751,0,0.0014636304843595766,0.0014636304843595766,847,847,0,-1,3,3,7,11,722,193,620
262,162,264,961,980,19,44,44,872,872,0,0.003812246842983083,0.00442492937131965,943,948,5,4,3,3,4,30,891,75,827
263,0,102,1,966,965,0,3,1,395,394,0.0,6.807583648184077e-05,1,449,448,4,-1,5,2,0,873,957,443
264,0,101,1,908,907,0,5,1,332,331,0.0,0.0,1,1,0,6,-1,7,5,0,479,859,663
265,14,14,509,509,0,50,50,500,500,0,0.0,0.0,1,1,0,-1,4,4,13,3,115,214,783
266,122,738,913,996,83,90,104,841,891,50,0.002484768031587188,0.00616086320160659,901,966,65,2,3,3,9,22,126,128,171
267,56,262,825,975,150,84,84,846,846,0,0.001497668402600497,0.0021784267674189047,856,892,36,3,3,3,9,10,278,227,396
268,2,104,368,939,571,5,5,393,393,0,3.4037918240920386e-05,0.00013615167296368154,415,524,109,4,5,5,3,1,825,577,241
269,16,16,485,485,0,144,144,712,712,0,0.0004084550188910446,0.0004084550188910446,663,663,0,-1,3,3,21,1,74,741,522
270,17,633,768,1000,232,8,18,596,879,283,0.0006467204465774873,0.009054086252084823,761,977,216,2,4,3,2,10,749,296,375
271,41,41,848,848,0,8,8,511,511,0,0.0007488342013002485,0.0007488342013002485,763,763,0,-1,4,4,2,17,838,327,686
272,82,184,921,974,53,52,52,974,974,0,0.010619830491167161,0.010721944245889922,983,983,0,4,2,2,3,13,674,261,505
273,0,0,1,1,0,0,0,1,1,0,0.0,0.0,1,1,0,-1,-1,-1,12,0,52,538,431
274,0,0,1,1,0,0,0,1,1,0,0.0,0.0,1,1,0,-1,-1,-1,3,0,825,875,965
275,0,101,1,956,955,0,3,1,330,329,0.0,3.4037918240920386e-05,1,399,398,5,-1,6,3,0,922,936,662
276,1,1,333,333,0,5,5,333,333,0,0.0,0.0,1,1,0,-1,8,8,5,3,727,626,948
277,246,452,973,987,14,120,120,968,968,0,0.00707988699411144,0.007147962830593281,977,977,0,3,2,2,6,24,368,8,443
278,43,43,840,840,0,18,18,692,692,0,0.0008509479560230097,0.0008509479560230097,786,786,0,-1,4,4,3,14,845,139,839
279,1,207,333,965,632,8,18,333,432,99,0.0,0.0002042275094455223,1,559,558,3,6,4,8,1,302,640,727
280,3,104,418,916,498,7,7,382,382,0,0.00010211375472276115,0.00010211375472276115,500,500,0,7,5,5,4,3,870,761,972
281,2,2,354,354,0,6,6,394,394,0,0.0,0.0,1,1,0,-1,5,5,3,1,737,607,728
282,0,206,1,974,973,0,8,1,488,487,0.0,0.0015317063208414173,1,862,861,3,-1,4,2,3,886,478,95
283,0,0,1,1,0,0,0,1,1,0,0.0,0.0,1,1,0,-1,-1,-1,3,0,879,955,514
284,30,30,702,702,0,50,50,642,642,0,0.0008169100377820892,0.0008169100377820892,780,780,0,-1,4,4,9,10,394,195,856
285,8,8,573,573,0,14,14,592,592,0,0.0002042275094455223,0.0002042275094455223,591,591,0,-1,4,4,3,4,732,319,843
286,100,100,914,914,0,100,100,970,970,0,0.02658361414615882,0.02658361414615882,998,998,0,-1,1,1,6,9,494,375,938
287,18,18,668,668,0,10,10,458,458,0,0.00010211375472276115,0.00010211375472276115,488,488,0,-1,4,4,3,6,726,247,429
288,45,147,764,925,161,62,62,648,648,0,0.001055175465468532,0.001157289220191293,809,821,12,4,3,3,10,8,153,284,425
289,0,102,1,874,873,0,17,1,347,346,0.0,3.4037918240920386e-05,1,400,399,4,-1,5,16,0,27,950,896
290,0,206,1,967,966,0,9,1,442,441,0.0,6.807583648184077e-05,1,448,447,3,-1,4,3,0,459,954,935
291,2,2,350,350,0,25,25,370,370,0,3.4037918240920386e-05,3.4037918240920386e-05,397,397,0,-1,5,5,19,1,148,781,952
292,12,114,607,936,329,14,14,563,563,0,0.00010211375472276115,0.0007488342013002485,478,771,293,4,4,4,3,3,829,441,190
293,6,212,441,969,528,36,36,697,697,0,0.0005786446100956465,0.0017018959120460194,735,868,133,3,4,4,6,1,522,439,166
294,0,206,1,975,974,0,12,1,496,495,0.0,0.001599782157323258,1,858,857,3,-1,4,4,0,491,865,127
295,0,0,1,1,0,0,0,1,1,0,0.0,0.0,1,1,0,-1,-1,-1,8,3,301,746,732
296,34,136,700,914,214,48,48,581,581,0,0.00017018959120460194,0.00034037918240920387,537,644,107,4,3,3,9,6,351,424,278
297,22,123,683,929,246,29,29,710,710,0,0.0005105687736138058,0.0006126825283365669,716,749,33,5,3,3,4,2,949,453,214
298,23,229,694,969,275,34,38,640,698,58,0.00034037918240920387,0.0013615167296368155,650,841,191,3,3,3,6,3,489,291,193
299,0,616,1,988,987,0,80,1,554,553,0.0,0.0014295925661186562,1,844,843,2,-1,3,18,0,64,620,264
300,18,119,688,937,249,14,14,568,568,0,0.0004084550188910446,0.0004084550188910446,678,678,0,7,4,4,3,4,583,637,671
301,0,0,1,1,0,0,0,1,1,0,0.0,0.0,1,1,0,-1,-1,-1,16,0,145,801,942
302,38,244,841,987,146,22,22,820,820,0,0.0011913271384322134,0.007250076585316042,837,971,134,3,3,3,2,8,928,186,24
303,0,101,1,915,914,0,4,1,331,330,0.0,0.0,1,1,0,5,-1,6,4,0,675,774,531
304,2,104,386,958,572,4,5,393,426,33,6.807583648184077e-05,0.0007147962830593281,452,767,315,4,5,5,3,2,883,597,130
305,36,242,707,957,250,56,56,576,576,0,0.000442492937131965,0.0006467204465774873,677,733,56,3,4,4,12,9,252,198,379
306,18,18,777,777,0,22,22,897,897,0,0.0009870996289866913,0.0009870996289866913,820,820,0,-1,3,3,2,4,749,143,254
307,58,159,930,985,55,12,12,833,833,0,0.0024166921951053475,0.0024166921951053475,913,913,0,7,4,4,2,30,920,65,357
308,6,107,395,889,494,15,15,378,378,0,0.0,0.0,1,1,0,5,4,4,9,1,351,402,460
309,0,102,1,919,918,0,10,1,417,416,0.0,3.4037918240920386e-05,1,398,397,4,-1,5,5,1,386,693,202
310,2,104,372,944,572,6,6,451,451,0,0.00013615167296368154,0.0002723033459273631,524,624,100,4,5,5,3,2,674,532,697
311,292,908,973,999,26,152,152,974,974,0,0.00616086320160659,0.007760645358929848,965,973,8,2,2,2,9,48,319,56,217
312,0,0,1,1,0,0,0,1,1,0,0.0,0.0,1,1,0,-1,-1,-1,4,0,558,845,348
313,50,151,857,959,102,18,18,658,658,0,0.00037441710065012424,0.00037441710065012424,671,671,0,5,4,4,3,15,748,219,337
314,0,102,1,929,928,0,6,1,392,391,0.0,0.00017018959120460194,1,556,555,4,-1,5,4,0,491,760,134
315,22,228,662,965,303,78,78,847,847,0,0.0012253650566731338,0.0015657442390823377,824,854,30,3,3,3,8,3,488,559,482
316,0,0,1,1,0,0,0,1,1,0,0.0,0.0,1,1,0,-1,-1,-1,9,0,202,777,871
317,63,269,874,978,104,40,40,817,817,0,0.0013615167296368155,0.0020763130126961434,855,891,36,3,3,3,5,17,376,60,120
318,57,263,852,981,129,34,34,767,767,0,0.0009870996289866913,0.002757071377514551,815,920,105,3,3,3,4,15,649,219,15
319,12,114,627,944,317,14,14,590,590,0,0.0002723033459273631,0.0004765308553728854,628,697,69,4,4,4,3,6,716,424,272
320,40,40,797,797,0,36,36,716,716,0,0.0008169100377820892,0.0008169100377820892,776,776,0,-1,3,3,5,6,528,46,698
321,68,68,817,817,0,140,140,832,832,0,0.0013274788113958951,0.0013274788113958951,833,833,0,-1,2,2,16,6,60,377,678
322,20,20,704,704,0,34,34,792,792,0,0.00034037918240920387,0.00034037918240920387,641,641,0,-1,3,3,4,4,563,545,783
323,34,34,761,761,0,32,32,645,645,0,0.0005786446100956465,0.0005786446100956465,724,724,0,-1,4,4,6,10,251,413,348
324,1,1,332,332,0,4,4,332,332,0,0.0,0.0,1,1,0,-1,6,6,4,2,423,721,789
325,9,110,577,937,360,14,14,530,530,0,0.0002382654276864427,0.0002723033459273631,602,618,16,5,4,4,5,4,695,278,537
326,0,102,1,874,873,0,26,1,382,381,0.0,0.00010211375472276115,1,478,477,4,-1,5,17,0,112,999,378
327,32,32,651,651,0,192,192,815,815,0,0.0009870996289866913,0.0009870996289866913,792,792,0,-1,3,3,22,4,22,143,515
328,40,142,836,957,121,14,14,615,615,0,0.0018720855032506212,0.0020422750944552232,893,900,7,4,4,4,3,14,823,84,622
329,0,0,1,1,0,0,0,1,1,0,0.0,0.0,1,1,0,-1,-1,-1,5,0,314,514,933
330,20,122,714,944,230,26,26,697,697,0,0.0008169100377820892,0.0011232513019503727,787,821,34,4,4,4,5,10,629,272,795
331,6,212,404,949,545,22,42,408,517,109,6.807583648184077e-05,0.0002042275094455223,445,581,136,3,4,4,11,1,279,743,541
332,0,206,1,964,963,0,15,1,502,501,0.0,0.00013615167296368154,1,514,513,3,-1,4,4,0,717,980,541
333,6,212,421,969,548,20,20,567,567,0,0.00010211375472276115,0.000442492937131965,480,689,209,3,4,4,4,1,614,711,381
334,0,206,1,945,944,0,39,1,423,422,0.0,0.00010211375472276115,1,475,474,3,-1,4,17,0,73,892,545
335,6,212,504,977,473,8,12,521,633,112,0.00017018959120460194,0.004833384390210695,562,956,394,3,4,4,2,1,681,420,18
336,30,132,836,965,129,12,12,685,685,0,0.0008169100377820892,0.001157289220191293,789,838,49,4,4,4,2,11,792,83,284
337,0,102,1,897,896,0,11,1,383,382,0.0,0.0004765308553728854,1,700,699,4,-1,5,6,0,312,783,245
338,43,1683,746,1000,254,84,130,653,839,186,0.0002042275094455223,0.010687906327649,566,977,411,1,3,2,14,9,172,191,12
339,158,259,966,980,14,38,38,923,923,0,0.00442492937131965,0.00445896728956057,949,950,1,5,3,3,3,31,823,76,601
340,14,14,715,715,0,12,12,692,692,0,0.0005786446100956465,0.0005786446100956465,743,743,0,-1,4,4,2,4,751,407,814
341,106,208,897,961,64,104,104,887,887,0,0.0024166921951053475,0.0028591851322373124,903,917,14,4,3,3,9,15,367,151,366
342,8,110,593,957,364,4,4,428,428,0,0.000442492937131965,0.0006467204465774873,680,745,65,4,5,5,2,8,946,302,479
343,2,618,354,994,640,12,58,379,740,361,0.0,0.0061949011198475104,1,968,967,2,5,3,8,3,415,466,19
344,1,1,333,333,0,2,2,333,333,0,3.4037918240920386e-05,3.4037918240920386e-05,400,400,0,-1,6,6,2,1,781,421,916
345,71,173,921,977,56,30,30,864,864,0,0.0015657442390823377,0.001599782157323258,866,867,1,4,3,3,4,20,860,109,395
346,0,102,1,868,867,0,18,1,360,359,0.0,3.4037918240920386e-05,1,396,395,4,-1,5,15,0,77,921,581
347,69,171,930,984,54,12,12,769,769,0,0.002927260968719153,0.0030634126416828346,929,934,5,4,4,4,2,27,981,69,770
348,0,206,1,941,940,0,53,1,459,458,0.0,0.0004765308553728854,1,692,691,3,-1,4,19,0,36,673,289
349,0,0,1,1,0,0,0,1,1,0,0.0,0.0,1,1,0,-1,-1,-1,14,0,85,865,651
350,4,106,432,925,493,6,6,419,419,0,6.807583648184077e-05,0.0002382654276864427,451,611,160,4,5,5,3,3,672,646,368
351,16,222,510,943,433,124,132,654,683,29,0.0002723033459273631,0.0015317063208414173,591,853,262,3,3,3,22,1,55,810,335
352,0,101,1,877,876,0,15,1,331,330,0.0,3.4037918240920386e-05,1,391,390,5,-1,6,15,0,51,916,615
353,41,41,797,797,0,56,56,816,816,0,0.0008169100377820892,0.0008169100377820892,777,777,0,-1,3,3,6,6,515,114,851
354,2,208,349,946,597,22,66,368,521,153,3.4037918240920386e-05,0.0012253650566731338,401,820,419,3,5,4,17,1,10,593,281
355,68,274,866,979,113,54,54,887,887,0,0.0024507301133462676,0.0030974505599237552,904,931,27,3,2,2,4,9,652,375,412
356,0,0,1,1,0,0,0,1,1,0,0.0,0.0,1,1,0,-1,-1,-1,4,0,385,664,698
357,0,0,1,1,0,0,0,1,1,0,0.0,0.0,1,1,0,-1,-1,-1,3,0,831,587,709
358,0,206,1,950,949,0,54,1,547,546,0.0,0.001497668402600497,1,844,843,3,-1,4,13,0,228,520,146
359,0,101,1,963,962,0,2,1,332,331,0.0,0.00030634126416828345,1,654,653,5,-1,6,2,0,749,632,121
360,16,222,587,965,378,45,50,614,633,19,0.0002382654276864427,0.00088498587426393,590,790,200,3,3,3,10,2,427,532,120
361,6,6,485,485,0,12,12,517,517,0,0.0002382654276864427,0.0002382654276864427,595,595,0,-1,4,4,4,2,794,670,917
362,10,111,687,972,285,4,4,510,510,0,0.0002723033459273631,0.00030634126416828345,634,649,15,6,5,5,2,8,962,521,878
363,34,240,738,972,234,54,54,717,717,0,0.0002382654276864427,0.0009530617107457708,589,804,215,3,3,3,8,4,297,259,351
364,4,620,419,997,578,7,30,396,706,310,0.0,0.003267640151128357,1,928,927,2,5,3,4,3,623,829,47
365,6,107,390,888,498,38,38,478,478,0,0.00013615167296368154,0.00017018959120460194,510,533,23,6,4,4,13,1,185,370,640
366,18,18,695,695,0,24,24,735,735,0,0.00030634126416828345,0.00030634126416828345,645,645,0,-1,4,4,4,3,811,280,871
367,1,1,333,333,0,6,6,333,333,0,0.0,0.0,1,1,0,-1,6,6,6,3,425,708,884
368,386,386,981,981,0,192,192,986,986,0,0.00793083495013445,0.00793083495013445,971,971,0,-1,2,2,9,50,147,33,568
369,48,149,920,987,67,22,22,946,946,0,0.004220701861874128,0.004220701861874128,954,954,0,6,3,3,2,21,944,123,687
370,12,114,592,934,342,24,24,675,675,0,0.0004084550188910446,0.0005105687736138058,681,706,25,4,4,4,4,3,787,209,711
371,24,24,634,634,0,64,64,611,611,0,0.0004084550188910446,0.0004084550188910446,663,663,0,-1,4,4,12,4,348,333,887
372,13,115,570,921,351,34,34,597,597,0,0.00017018959120460194,0.00034037918240920387,529,642,113,4,4,4,7,4,141,339,378
373,0,0,1,1,0,0,0,1,1,0,0.0,0.0,1,1,0,-1,-1,-1,24,1,28,742,513
374,0,102,1,886,885,0,17,1,398,397,0.0,0.00030634126416828345,1,623,622,4,-1,5,9,0,276,772,204
375,0,101,1,944,943,0,3,1,331,330,0.0,6.807583648184077e-05,1,445,444,5,-1,6,3,0,642,522,477
376,0,102,1,898,897,0,15,1,411,410,0.0,0.00010211375472276115,1,472,471,4,-1,5,8,0,443,569,727
377,276,482,972,989,17,114,114,889,889,0,0.004220701861874128,0.004322815616596889,948,950,2,3,3,3,9,44,351,27,354
378,96,302,898,976,78,28,28,700,700,0,0.0020422750944552232,0.003710133088260322,889,946,57,3,3,3,3,16,837,78,47
379,96,197,919,969,50,48,48,930,930,0,0.0029612988869600733,0.0029612988869600733,928,928,0,5,3,3,3,17,801,81,606
380,142,348,939,983,44,102,102,956,956,0,0.0021784267674189047,0.0026889955410327104,897,917,20,3,2,2,7,16,400,78,233
381,2,104,371,938,567,4,5,372,393,21,0.0,0.00037441710065012424,1,676,675,4,5,5,3,2,683,739,249
382,7,7,458,458,0,61,61,456,456,0,0.00010211375472276115,0.00010211375472276115,485,485,0,-1,4,4,21,2,12,627,883
383,0,206,1,969,968,0,26,1,603,602,0.0,0.0010211375472276116,1,807,806,3,-1,4,5,0,528,890,255
384,45,251,801,971,170,72,72,815,815,0,0.0010211375472276116,0.001940161339732462,807,876,69,3,3,3,7,5,118,216,630
385,7,1647,518,1000,482,27,66,537,819,282,6.807583648184077e-05,0.012696143503863304,449,985,536,1,4,2,8,2,318,627,504
386,21,123,744,947,203,10,10,535,535,0,0.000442492937131965,0.0006126825283365669,692,740,48,4,4,4,3,6,856,516,383
387,0,0,1,1,0,0,0,1,1,0,0.0,0.0,1,1,0,-1,-1,-1,7,1,342,573,729
388,0,102,1,967,966,0,4,1,466,465,0.0,0.000442492937131965,1,696,695,4,-1,5,2,0,807,772,438
389,0,102,1,922,921,0,7,1,383,382,0.0,0.0002042275094455223,1,576,575,4,-1,5,4,0,652,803,307
390,26,26,700,700,0,38,38,678,678,0,0.0002382654276864427,0.0002382654276864427,593,593,0,-1,3,3,6,4,498,557,778
391,0,0,1,1,0,0,0,1,1,0,0.0,0.0,1,1,0,-1,-1,-1,4,0,607,604,693
392,0,102,1,956,955,0,3,1,392,391,0.0,0.0002382654276864427,1,605,604,4,-1,5,2,0,890,760,691
393,6,6,424,424,0,19,19,445,445,0,0.0002042275094455223,0.0002042275094455223,569,569,0,-1,4,4,8,2,158,670,431
394,0,102,1,960,959,0,4,1,452,451,0.0,0.0007828721195411688,1,786,785,4,-1,5,2,0,847,772,193
395,14,14,651,651,0,18,18,679,679,0,0.0007488342013002485,0.0007488342013002485,764,764,0,-1,4,4,3,4,716,407,772
396,0,0,1,1,0,0,0,1,1,0,0.0,0.0,1,1,0,-1,-1,-1,4,0,811,821,747
397,52,153,763,916,153,196,196,909,909,0,0.001055175465468532,0.001055175465468532,804,804,0,7,2,2,16,5,26,589,448
398,0,206,1,959,958,0,28,1,488,487,0.0,0.0008169100377820892,1,768,767,3,-1,4,8,0,197,903,137
399,0,102,1,881,880,0,16,1,358,357,0.0,0.0,1,1,0,4,-1,5,14,1,21,641,575
400,2,2,366,366,0,3,3,368,368,0,0.0,0.0,1,1,0,-1,5,5,2,1,586,899,588
401,0,0,1,1,0,0,0,1,1,0,0.0,0.0,1,1,0,-1,-1,-1,7,0,497,731,773
402,30,236,757,977,220,22,26,595,653,58,0.0008509479560230097,0.004016474352428605,780,946,166,3,4,4,5,10,421,195,77
403,0,102,1,931,930,0,4,1,369,368,0.0,0.0002382654276864427,1,603,602,4,-1,5,3,0,774,786,350
404,0,101,1,877,876,0,21,1,331,330,0.0,3.4037918240920386e-05,1,402,401,5,-1,6,21,0,12,915,896
405,0,102,1,891,890,0,16,1,359,358,0.0,0.0,1,1,0,4,-1,5,14,0,84,998,325
406,0,206,1,971,970,0,14,1,481,480,0.0,0.0006126825283365669,1,739,738,3,-1,4,5,2,517,633,559
407,9,9,481,481,0,32,32,398,398,0,3.4037918240920386e-05,3.4037918240920386e-05,392,392,0,-1,4,4,17,3,94,572,902
408,0,206,1,973,972,0,16,1,570,569,0.0,0.0019741992579733825,1,889,888,3,-1,4,4,0,824,901,56
409,0,0,1,1,0,0,0,1,1,0,0.0,0.0,1,1,0,-1,-1,-1,3,1,725,705,715
410,16,16,519,519,0,50,50,473,473,0,6.807583648184077e-05,6.807583648184077e-05,451,451,0,-1,3,3,17,1,10,879,520
411,186,287,975,990,15,46,46,979,979,0,0.008645631233193778,0.00878178290615746,977,978,1,5,2,2,2,48,895,56,718
412,26,26,788,788,0,22,22,824,824,0,0.0011232513019503727,0.0011232513019503727,833,833,0,-1,3,3,2,4,910,185,783
413,51,51,813,813,0,52,52,768,768,0,0.0007828721195411688,0.0007828721195411688,776,776,0,-1,3,3,6,7,498,329,254
414,1,1,332,332,0,2,2,332,332,0,0.0,0.0,1,1,0,-1,6,6,2,2,982,374,757
415,22,124,646,915,269,62,62,699,699,0,0.00034037918240920387,0.00037441710065012424,653,662,9,4,3,3,9,2,803,453,443
416,42,42,854,854,0,8,8,567,567,0,0.00088498587426393,0.00088498587426393,805,805,0,-1,4,4,2,19,868,184,698
417,0,206,1,936,935,0,32,1,384,383,0.0,0.00017018959120460194,1,540,539,3,-1,4,19,0,35,977,156
418,6,6,509,509,0,5,5,416,416,0,0.00017018959120460194,0.00017018959120460194,565,565,0,-1,5,5,3,3,911,677,678
419,0,101,1,940,939,0,2,1,331,330,0.0,0.00013615167296368154,1,529,528,5,-1,6,2,0,980,867,385
420,89,89,891,891,0,50,50,850,850,0,0.0017359338302869397,0.0017359338302869397,868,868,0,-1,3,3,5,19,519,91,866
421,6,212,417,962,545,42,42,646,646,0,6.807583648184077e-05,0.000442492937131965,444,686,242,3,4,4,7,3,216,309,435
422,12,113,630,951,321,8,8,500,500,0,0.00013615167296368154,0.0002723033459273631,534,636,102,5,4,4,2,4,983,164,444
423,34,34,823,823,0,32,32,913,913,0,0.0014295925661186562,0.0014295925661186562,859,859,0,-1,3,3,2,8,977,386,462
424,40,246,779,970,191,48,52,729,759,30,0.00034037918240920387,0.0007488342013002485,642,761,119,3,3,3,7,10,141,262,107
425,0,206,1,977,976,0,10,1,497,496,0.0,0.0002723033459273631,1,622,621,3,-1,4,4,0,607,632,371
426,0,0,1,1,0,0,0,1,1,0,0.0,0.0,1,1,0,-1,-1,-1,11,2,76,775,911
427,0,206,1,932,931,0,54,1,436,435,0.0,0.0002723033459273631,1,608,607,3,-1,4,21,0,74,498,259
428,2,2,376,376,0,5,5,404,404,0,0.0,0.0,1,1,0,-1,5,5,3,1,485,606,956
429,23,23,656,656,0,74,74,758,758,0,0.00013615167296368154,0.00013615167296368154,509,509,0,-1,3,3,9,5,263,619,930
430,4,106,420,906,486,13,14,415,432,17,0.0,0.0002382654276864427,1,604,603,4,5,5,7,3,342,441,418
431,16,632,560,993,433,48,62,623,714,91,0.00030634126416828345,0.0017359338302869397,631,866,235,2,3,3,9,1,178,840,125
432,0,0,1,1,0,0,0,1,1,0,0.0,0.0,1,1,0,-1,-1,-1,2,0,997,932,971
433,112,112,902,902,0,100,100,811,811,0,0.0018040096667687805,0.0018040096667687805,881,881,0,-1,3,3,10,15,153,53,228
434,153,254,938,967,29,92,92,900,900,0,0.002757071377514551,0.0027911092957554717,912,912,0,5,3,3,7,24,472,119,577
435,0,102,1,881,880,0,11,1,350,349,0.0,0.0,1,1,0,4,-1,5,10,0,99,818,575
436,2,208,358,957,599,10,40,371,602,231,6.807583648184077e-05,0.002586881786309949,446,906,460,3,5,4,8,1,236,687,88
437,92,298,889,979,90,66,66,864,864,0,0.0020763130126961434,0.005446066918547262,885,965,80,3,3,3,6,20,267,49,126
438,13,629,555,996,441,28,46,551,708,157,0.0002382654276864427,0.0026889955410327104,581,909,328,2,4,3,6,3,514,385,47
439,62,62,803,803,0,102,102,807,807,0,0.0006807583648184077,0.0006807583648184077,741,741,0,-1,3,3,12,7,62,169,744
440,0,616,1,990,989,0,80,1,547,546,0.0,0.0006467204465774873,1,731,730,2,-1,3,19,0,48,907,440
441,0,102,1,946,945,0,5,1,414,413,0.0,0.00017018959120460194,1,550,549,4,-1,5,3,0,796,943,237
442,0,102,1,902,901,0,17,1,417,416,0.0,0.00013615167296368154,1,525,524,4,-1,5,9,0,119,875,256
443,22,22,626,626,0,38,38,543,543,0,0.00030634126416828345,0.00030634126416828345,610,610,0,-1,3,3,8,4,370,208,789
444,0,0,1,1,0,0,0,1,1,0,0.0,0.0,1,1,0,-1,-1,-1,5,0,843,815,928
445,0,102,1,943,942,0,4,1,442,441,0.0,0.000442492937131965,1,697,696,4,-1,5,2,0,876,733,46
446,6,107,506,954,448,10,10,544,544,0,0.00010211375472276115,0.00017018959120460194,489,554,65,5,4,4,3,2,608,719,935
447,196,298,966,980,14,40,40,775,775,0,0.003437829742332959,0.0034718676605738795,930,930,0,4,3,3,5,48,290,56,508
448,10,112,533,907,374,20,20,477,477,0,0.00010211375472276115,0.00010211375472276115,489,489,0,4,4,4,6,3,255,596,578
449,100,100,894,894,0,100,100,969,969,0,0.036488648354266656,0.03876918887640832,999,999,0,2,1,1,5,49,571,31,171
450,20,122,639,908,269,32,32,494,494,0,0.0005105687736138058,0.0007147962830593281,705,755,50,4,4,4,10,5,355,562,332
451,98,199,919,971,52,54,54,954,954,0,0.002382654276864427,0.0024166921951053475,908,909,1,5,3,3,4,19,777,144,615
452,8,214,518,966,448,18,22,509,562,53,0.00010211375472276115,0.0002723033459273631,473,626,153,3,4,4,5,2,396,408,188
453,0,206,1,971,970,0,20,1,552,551,0.0,0.00176997174852786,1,868,867,3,-1,4,4,0,822,696,69
454,204,306,935,968,33,254,254,931,931,0,0.002586881786309949,0.002723033459273631,909,913,4,4,3,3,19,20,35,38,244
455,16,222,625,970,345,28,32,679,723,44,0.00013615167296368154,0.0005446066918547262,527,719,192,3,3,3,5,1,478,394,302
456,11,11,647,647,0,6,6,441,441,0,0.0006126825283365669,0.0006126825283365669,745,745,0,-1,5,5,3,7,654,396,983
457,6,107,404,894,490,26,26,433,433,0,3.4037918240920386e-05,3.4037918240920386e-05,403,403,0,5,4,4,11,2,76,575,331
458,14,116,645,946,301,10,10,506,506,0,0.00037441710065012424,0.0004765308553728854,665,702,37,4,4,4,3,5,564,418,501
459,0,206,1,949,948,0,34,1,445,444,0.0,0.0004765308553728854,1,702,701,3,-1,4,14,0,47,965,217
460,0,101,1,902,901,0,4,1,332,331,0.0,0.0,1,1,0,9,-1,10,4,0,410,716,647
461,28,234,731,973,242,29,29,710,710,0,0.0006807583648184077,0.0011913271384322134,769,838,69,3,3,3,4,7,949,170,150
462,24,126,607,884,277,134,134,706,706,0,0.00017018959120460194,0.00017018959120460194,542,542,0,4,3,3,19,4,35,617,870
463,0,101,1,938,937,0,2,1,329,328,0.0,0.0,1,1,0,5,-1,6,2,0,906,778,602
464,3,3,411,411,0,6,6,360,360,0,0.0,0.0,1,1,0,-1,5,5,5,5,701,605,569
465,271,271,966,966,0,234,234,981,981,0,0.005582218591510943,0.005582218591510943,959,959,0,-1,2,2,12,27,226,88,757
466,0,0,1,1,0,0,0,1,1,0,0.0,0.0,1,1,0,-1,-1,-1,3,0,654,811,978
467,0,0,1,1,0,0,0,1,1,0,0.0,0.0,1,1,0,-1,-1,-1,2,0,924,514,651
468,0,616,1,992,991,0,52,1,706,705,0.0,0.0022465026039007454,1,895,894,2,-1,3,7,0,436,858,13
469,57,673,817,992,175,84,94,787,836,49,0.0007488342013002485,0.0017018959120460194,759,871,112,2,3,3,9,6,164,432,341
470,18,18,602,602,0,26,26,501,501,0,0.00010211375472276115,0.00010211375472276115,485,485,0,-1,4,4,7,6,447,486,644
471,0,616,1,999,998,0,20,1,782,781,0.0,0.0024166921951053475,1,904,903,2,-1,3,3,0,814,822,370
472,34,136,824,958,134,22,22,816,816,0,0.0009190237925048504,0.0009870996289866913,798,811,13,4,3,3,2,8,739,186,566
473,7,109,504,918,414,12,12,421,421,0,0.00010211375472276115,0.000442492937131965,484,693,209,4,5,5,6,4,251,208,413
474,80,182,819,924,105,150,150,766,766,0,0.0012253650566731338,0.0014636304843595766,824,845,21,4,3,3,20,9,88,130,500
475,13,13,660,660,0,8,8,508,508,0,0.00010211375472276115,0.00010211375472276115,502,502,0,-1,4,4,2,5,776,310,941
476,0,206,1,950,949,0,24,1,421,420,0.0,0.00013615167296368154,1,512,511,3,-1,4,11,0,307,997,389
477,17,633,637,995,358,36,50,696,789,93,0.00017018959120460194,0.001599782157323258,533,861,328,2,3,3,5,4,506,305,120
478,0,206,1,963,962,0,18,1,454,453,0.0,0.0007147962830593281,1,762,761,3,-1,4,8,0,318,845,131
479,9,110,609,953,344,10,10,534,534,0,6.807583648184077e-05,0.0004765308553728854,454,705,251,5,4,4,3,4,654,332,396
480,0,0,1,1,0,0,0,1,1,0,0.0,0.0,1,1,0,-1,-1,-1,3,2,780,271,912
481,12,114,627,944,317,18,18,679,679,0,0.00034037918240920387,0.0007147962830593281,653,757,104,4,4,4,3,2,716,465,199
482,0,101,1,888,887,0,8,1,332,331,0.0,0.0,1,1,0,5,-1,6,8,3,244,746,734
483,50,152,856,963,107,32,32,900,900,0,0.001157289220191293,0.0017018959120460194,844,872,28,4,3,3,2,12,886,67,184
484,0,616,1,989,988,0,52,1,445,444,0.0,0.0005786446100956465,1,702,701,2,-1,3,20,1,70,792,316
485,6,212,463,973,510,11,16,482,573,91,6.807583648184077e-05,0.0013615167296368155,459,854,395,3,4,4,4,1,423,592,122
486,85,291,865,975,110,88,88,881,881,0,0.0016678579938050988,0.0031314884781646754,859,923,64,3,3,3,8,14,302,139,89
487,34,34,769,769,0,30,30,675,675,0,0.0002382654276864427,0.0002382654276864427,593,593,0,-1,4,4,5,11,534,52,587
488,21,21,709,709,0,17,17,541,541,0,0.00037441710065012424,0.00037441710065012424,665,665,0,-1,4,4,5,8,612,417,948
489,1,1,332,332,0,3,3,332,332,0,3.4037918240920386e-05,3.4037918240920386e-05,403,403,0,-1,6,6,3,2,923,692,922
490,74,74,859,859,0,62,62,800,800,0,0.0007828721195411688,0.0007828721195411688,766,766,0,-1,3,3,7,15,398,219,769
491,0,206,1,971,970,0,20,1,529,528,0.0,0.0007147962830593281,1,761,760,3,-1,4,6,0,237,993,137
492,6,6,431,431,0,24,24,552,552,0,3.4037918240920386e-05,3.4037918240920386e-05,394,394,0,-1,4,4,6,1,606,661,890
493,2,208,360,968,608,11,32,409,626,217,0.0,0.0028932230504782326,1,918,917,3,5,4,6,2,266,560,50
494,0,0,1,1,0,0,0,1,1,0,0.0,0.0,1,1,0,-1,-1,-1,7,0,299,823,774
495,0,0,1,1,0,0,0,1,1,0,0.0,0.0,1,1,0,-1,-1,-1,7,0,335,565,982
496,0,102,1,928,927,0,6,1,365,364,0.0,3.4037918240920386e-05,1,415,414,4,-1,5,5,0,601,887,550
497,66,272,870,980,110,62,62,971,971,0,0.002757071377514551,0.00439089145307873,916,953,37,3,2,2,3,8,620,497,119
498,626,832,996,999,3,192,192,996,996,0,0.012764219340345145,0.012832295176826986,987,987,0,3,2,2,9,92,422,30,408
499,0,102,1,926,925,0,6,1,419,418,0.0,0.0009870996289866913,1,803,802,4,-1,5,3,0,923,917,144
500,13,13,565,565,0,25,25,503,503,0,0.00010211375472276115,0.00010211375472276115,474,474,0,-1,4,4,7,3,324,526,330
501,0,0,1,1,0,0,0,1,1,0,0.0,0.0,1,1,0,-1,-1,-1,11,0,227,914,974
502,0,0,1,1,0,0,0,1,1,0,0.0,0.0,1,1,0,-1,-1,-1,11,0,227,400,641
503,2,208,346,934,588,31,56,374,441,67,0.0,0.000442492937131965,1,668,667,3,5,4,21,1,74,743,467
504,0,206,1,948,947,0,56,1,463,462,0.0,0.0002042275094455223,1,554,553,3,-1,4,19,0,38,990,160
505,0,0,1,1,0,0,0,1,1,0,0.0,0.0,1,1,0,-1,-1,-1,2,0,906,889,684
506,16,222,572,964,392,64,64,744,744,0,0.0007147962830593281,0.0009190237925048504,771,799,28,3,3,3,9,2,422,160,134
507,263,879,962,998,36,178,198,968,979,11,0.004288777698355968,0.009564655025698629,945,977,32,2,2,2,10,30,206,65,50
508,16,16,576,576,0,50,50,646,646,0,6.807583648184077e-05,6.807583648184077e-05,449,449,0,-1,3,3,10,3,243,260,843
509,0,0,1,1,0,0,0,1,1,0,0.0,0.0,1,1,0,-1,-1,-1,23,1,8,685,750
510,8,8,548,548,0,10,10,508,508,0,6.807583648184077e-05,6.807583648184077e-05,459,459,0,-1,4,4,3,3,770,434,819
511,8,8,502,502,0,14,14,450,450,0,0.0002042275094455223,0.0002042275094455223,560,560,0,-1,4,4,5,2,426,523,996
512,0,616,1,994,993,0,42,1,641,640,0.0,0.003267640151128357,1,927,926,2,-1,3,8,0,488,632,48
513,8,8,588,588,0,12,12,623,623,0,0.0005105687736138058,0.0005105687736138058,722,722,0,-1,4,4,2,3,928,121,824
514,32,238,715,960,245,70,70,700,700,0,0.0008169100377820892,0.0018380475850097008,768,878,110,3,3,3,10,6,204,295,183
515,2,104,360,920,560,7,8,377,390,13,0.0,0.00013615167296368154,1,520,519,4,5,5,5,1,565,837,840
516,68,169,875,963,88,40,40,781,781,0,0.001497668402600497,0.001497668402600497,860,860,0,6,3,3,5,17,517,45,692
517,10,10,599,599,0,18,18,664,664,0,0.0007828721195411688,0.0007828721195411688,779,779,0,-1,4,4,3,4,568,336,725
518,3,209,484,986,502,5,10,455,640,185,0.00013615167296368154,0.004152626025392287,541,952,411,3,5,4,3,2,812,576,16
519,3,619,417,998,581,7,72,361,915,554,0.0,0.017087034956942034,1,993,992,2,5,3,6,2,664,694,2
520,0,206,1,973,972,0,20,1,538,537,0.0,0.0017359338302869397,1,874,873,3,-1,4,6,0,594,200,55
521,0,206,1,976,975,0,8,1,483,482,0.0,0.001157289220191293,1,836,835,3,-1,4,2,0,972,978,42
522,0,0,1,1,0,0,0,1,1,0,0.0,0.0,1,1,0,-1,-1,-1,2,1,993,235,916
523,17,633,671,998,327,21,30,735,794,59,0.00017018959120460194,0.006058749446883829,554,963,409,2,3,3,4,4,777,305,70
524,5,5,487,487,0,6,6,440,440,0,6.807583648184077e-05,6.807583648184077e-05,456,456,0,-1,5,5,3,3,485,411,657
525,0,102,1,940,939,0,5,1,409,408,0.0,0.00013615167296368154,1,522,521,4,-1,5,3,0,523,276,121
526,0,0,1,1,0,0,0,1,1,0,0.0,0.0,1,1,0,-1,-1,-1,3,2,634,271,969
527,13,629,616,999,383,11,25,476,743,267,0.0002042275094455223,0.004731270635487933,554,955,401,2,4,3,4,5,550,528,376
528,12,114,480,874,394,72,72,509,509,0,0.0002042275094455223,0.00034037918240920387,569,644,75,4,4,4,20,2,88,524,334
529,22,22,679,679,0,38,38,820,820,0,0.0012253650566731338,0.0012253650566731338,823,823,0,-1,3,3,3,4,778,440,779
530,0,206,1,964,963,0,14,1,404,403,0.0,0.0,1,1,0,3,-1,4,8,0,371,796,506
531,9,9,559,559,0,22,22,605,605,0,0.00017018959120460194,0.00017018959120460194,550,550,0,-1,4,4,5,4,908,339,798
532,12,628,564,996,432,28,38,583,689,106,0.0002382654276864427,0.002314578440382586,600,898,298,2,4,3,6,4,266,346,256
533,0,206,1,959,958,0,38,1,547,546,0.0,0.0007488342013002485,1,761,760,3,-1,4,9,0,217,713,185
534,0,102,1,961,960,0,6,1,474,473,0.0,0.0005786446100956465,1,741,740,4,-1,5,3,0,730,483,412
535,40,40,750,750,0,88,88,845,845,0,0.0004084550188910446,0.0004084550188910446,665,665,0,-1,3,3,8,6,411,490,894
536,0,101,1,929,928,0,3,1,332,331,0.0,0.0,1,1,0,5,-1,6,3,0,710,937,374
537,0,102,1,927,926,0,5,1,392,391,0.0,0.0002042275094455223,1,566,565,4,-1,5,3,0,627,728,422
538,17,633,612,998,386,56,70,670,761,91,0.0002723033459273631,0.006092787365124749,602,965,363,2,3,3,9,4,394,305,12
539,39,245,734,960,226,66,66,643,643,0,0.0005446066918547262,0.0009870996289866913,716,790,74,3,3,3,12,5,184,591,473
540,0,102,1,951,950,0,5,1,374,373,0.0,0.00010211375472276115,1,486,485,4,-1,5,4,0,738,929,566
541,2,208,351,941,590,20,35,351,400,49,3.4037918240920386e-05,0.00010211375472276115,401,475,74,3,5,4,19,2,48,692,369
542,10,112,638,956,318,12,12,661,661,0,0.0005105687736138058,0.0007147962830593281,715,768,53,4,4,4,2,4,940,312,536
543,2,103,390,962,572,3,3,395,395,0,0.0,3.4037918240920386e-05,1,400,399,5,5,5,2,1,981,606,173
544,0,206,1,952,951,0,31,1,471,470,0.0,0.0002723033459273631,1,607,606,3,-1,4,10,0,189,728,253
545,15,221,553,957,404,40,40,539,539,0,0.0002723033459273631,0.00037441710065012424,611,660,49,3,4,4,10,7,109,427,214
546,105,311,920,980,60,30,30,692,692,0,0.001599782157323258,0.002586881786309949,855,907,52,3,4,4,5,34,662,89,663
547,2,2,372,372,0,4,4,406,406,0,6.807583648184077e-05,6.807583648184077e-05,445,445,0,-1,5,5,2,2,970,575,488
548,41,41,786,786,0,64,64,802,802,0,0.0007828721195411688,0.0007828721195411688,773,773,0,-1,3,3,8,6,323,295,928
549,2,104,357,923,566,5,8,357,418,61,0.0,0.00030634126416828345,1,633,632,4,5,5,4,2,753,764,700
550,16,16,614,614,0,18,18,493,493,0,0.0002042275094455223,0.0002042275094455223,582,582,0,-1,4,4,5,5,474,562,793
551,26,26,785,785,0,22,22,843,843,0,0.001055175465468532,0.001055175465468532,825,825,0,-1,3,3,2,4,841,470,324
552,24,24,638,638,0,134,134,848,848,0,0.0006467204465774873,0.0006467204465774873,740,740,0,-1,3,3,14,5,172,589,930
553,16,117,691,952,261,8,8,514,514,0,6.807583648184077e-05,6.807583648184077e-05,447,447,0,8,4,4,2,4,976,164,448
554,0,0,1,1,0,0,0,1,1,0,0.0,0.0,1,1,0,-1,-1,-1,3,3,814,854,735
555,0,0,1,1,0,0,0,1,1,0,0.0,0.0,1,1,0,-1,-1,-1,5,2,561,271,875
556,13,219,558,965,407,21,26,443,487,44,6.807583648184077e-05,0.0006467204465774873,453,742,289,3,4,4,9,5,177,274,221
557,313,313,972,972,0,200,200,957,957,0,0.005377991082065421,0.005377991082065421,955,955,0,-1,3,3,15,45,110,77,928
558,1,1,333,333,0,3,3,333,333,0,0.0,0.0,1,1,0,-1,6,6,3,1,484,763,859
559,6,6,391,391,0,29,29,416,416,0,0.0002382654276864427,0.0002382654276864427,589,589,0,-1,4,4,13,2,41,805,750
560,0,102,1,893,892,0,10,1,365,364,0.0,6.807583648184077e-05,1,451,450,4,-1,5,8,0,186,919,314
561,0,206,1,941,940,0,60,1,525,524,0.0,0.0016678579938050988,1,861,860,3,-1,4,16,0,134,909,171
562,5,5,561,561,0,4,4,510,510,0,6.807583648184077e-05,6.807583648184077e-05,461,461,0,-1,5,5,2,5,962,710,675
563,88,190,949,985,36,12,12,720,720,0,0.003165526396405596,0.003982436434187685,929,946,17,4,4,4,2,38,847,111,289
564,0,0,1,1,0,0,0,1,1,0,0.0,0.0,1,1,0,-1,-1,-1,5,0,677,833,927
565,22,22,727,727,0,14,14,577,577,0,0.000442492937131965,0.000442492937131965,688,688,0,-1,4,4,3,9,712,198,995
566,13,219,535,955,420,60,60,639,639,0,0.0002382654276864427,0.0005105687736138058,601,712,111,3,4,4,10,4,114,339,670
567,0,0,1,1,0,0,0,1,1,0,0.0,0.0,1,1,0,-1,-1,-1,3,0,716,744,929
568,34,136,793,952,159,28,28,769,769,0,0.0005786446100956465,0.0006126825283365669,730,740,10,4,3,3,3,5,829,338,556
569,0,206,1,950,949,0,56,1,510,509,0.0,0.0011232513019503727,1,807,806,3,-1,4,18,2,29,462,68
570,0,102,1,901,900,0,11,1,381,380,0.0,6.807583648184077e-05,1,458,457,4,-1,5,7,0,273,790,248
571,24,230,709,972,263,32,32,636,636,0,0.0002042275094455223,0.0005786446100956465,568,731,163,3,4,4,6,4,465,259,452
572,6,108,421,904,483,16,16,437,437,0,6.807583648184077e-05,0.00013615167296368154,447,516,69,4,4,4,7,1,362,527,625
573,3,3,463,463,0,3,3,389,389,0,0.00013615167296368154,0.00013615167296368154,533,533,0,-1,5,5,2,3,967,196,917
574,14,14,661,661,0,20,20,708,708,0,0.00030634126416828345,0.00030634126416828345,650,650,0,-1,4,4,4,4,827,622,502
575,39,39,790,790,0,34,34,704,704,0,0.000442492937131965,0.000442492937131965,692,692,0,-1,3,3,4,11,500,118,812
576,3,3,403,403,0,12,12,386,386,0,0.00010211375472276115,0.00010211375472276115,474,474,0,-1,5,5,7,3,324,761,961
577,12,1652,529,1000,471,38,80,531,781,250,6.807583648184077e-05,0.01143674052894925,443,983,540,1,4,2,9,3,147,434,206
578,0,206,1,967,966,0,12,1,462,461,0.0,0.0006467204465774873,1,743,742,3,-1,4,4,0,632,860,470
579,0,206,1,940,939,0,38,1,422,421,0.0,0.0002042275094455223,1,555,554,3,-1,4,15,0,77,992,741
580,0,102,1,902,901,0,9,1,371,370,0.0,6.807583648184077e-05,1,455,454,4,-1,5,7,0,342,993,499
581,0,0,1,1,0,0,0,1,1,0,0.0,0.0,1,1,0,-1,-1,-1,10,0,293,932,940
582,6,6,394,394,0,50,50,454,454,0,3.4037918240920386e-05,3.4037918240920386e-05,401,401,0,-1,4,4,19,1,48,416,660
583,0,102,1,902,901,0,10,1,384,383,0.0,0.00013615167296368154,1,513,512,4,-1,5,7,0,722,839,785
584,0,0,1,1,0,0,0,1,1,0,0.0,0.0,1,1,0,-1,-1,-1,6,1,399,539,716
585,84,700,875,996,121,48,68,711,841,130,0.0009870996289866913,0.004935498144933456,807,958,151,2,3,3,7,19,413,184,144
586,44,146,823,947,124,36,36,742,742,0,0.0010892133837094523,0.0010892133837094523,825,825,0,4,3,3,5,10,386,296,485
587,0,616,1,998,997,0,26,1,733,732,0.0,0.0030293747234419145,1,923,922,2,-1,3,4,0,593,983,63
588,8,110,520,918,398,13,13,452,452,0,0.00017018959120460194,0.00017018959120460194,541,541,0,4,4,4,5,3,406,290,225
589,0,0,1,1,0,0,0,1,1,0,0.0,0.0,1,1,0,-1,-1,-1,3,1,852,874,349
590,0,101,1,934,933,0,2,1,332,331,0.0,6.807583648184077e-05,1,450,449,5,-1,6,2,0,904,488,441
591,15,116,658,946,288,20,20,670,670,0,0.0010892133837094523,0.001157289220191293,816,824,8,5,4,4,4,4,553,125,958
592,0,206,1,967,966,0,22,1,530,529,0.0,0.001055175465468532,1,806,805,3,-1,4,7,0,697,981,297
593,2,104,356,916,560,6,9,356,397,41,0.0,0.0002042275094455223,1,568,567,4,5,5,5,1,773,734,240
594,0,206,1,971,970,0,12,1,516,515,0.0,0.0013955546478777359,1,839,838,3,-1,4,4,0,507,918,55
595,10,112,551,924,373,12,12,451,451,0,0.00017018959120460194,0.00017018959120460194,546,546,0,4,4,4,4,4,354,319,361
596,9,110,613,949,336,14,14,631,631,0,0.00017018959120460194,0.00030634126416828345,559,639,80,5,4,4,3,4,916,501,444
597,6,1646,388,1000,612,54,164,506,884,378,0.0002382654276864427,0.016133973246196264,578,993,415,1,4,2,15,1,81,720,23
598,8,110,494,897,403,54,54,669,669,0,3.4037918240920386e-05,0.00034037918240920387,407,644,237,4,4,4,9,2,319,323,247
599,7,213,562,982,420,8,8,538,538,0,0.0002382654276864427,0.0008509479560230097,609,796,187,3,4,4,2,2,951,408,440
600,10,10,548,548,0,30,30,555,555,0,0.00013615167296368154,0.00013615167296368154,510,510,0,-1,4,4,7,3,637,536,819
601,0,102,1,946,945,0,4,1,405,404,0.0,0.00017018959120460194,1,554,553,4,-1,5,2,0,232,866,103
602,5,5,413,413,0,12,12,394,394,0,0.0,0.0,1,1,0,-1,5,5,7,3,472,572,511
603,1,1,333,333,0,5,5,333,333,0,0.0,0.0,1,1,0,-1,7,7,5,1,294,703,798
604,6,6,437,437,0,22,22,496,496,0,0.0,0.0,1,1,0,-1,4,4,7,1,342,659,816
605,128,230,915,961,46,108,108,915,915,0,0.0022465026039007454,0.0022465026039007454,896,896,0,4,3,3,8,27,197,304,870
606,2,103,388,961,573,4,4,439,439,0,6.807583648184077e-05,6.807583648184077e-05,455,455,0,5,5,5,2,1,997,555,719
607,90,706,872,996,124,74,84,810,843,33,0.0013615167296368155,0.004663194799006093,840,949,109,2,3,3,9,15,389,92,692
608,38,38,738,738,0,94,94,797,797,0,0.0005446066918547262,0.0005446066918547262,711,711,0,-1,3,3,12,4,375,202,864
609,2,104,368,935,567,4,6,369,426,57,0.00010211375472276115,0.00013615167296368154,501,530,29,4,5,5,3,1,958,687,168
610,0,101,1,900,899,0,7,1,332,331,0.0,6.807583648184077e-05,1,454,453,5,-1,6,7,0,497,833,484
611,1,1,333,333,0,12,12,333,333,0,0.0,0.0,1,1,0,-1,7,7,12,1,58,765,835
612,10,216,527,959,432,28,36,489,555,66,0.00010211375472276115,0.0007488342013002485,479,762,283,3,4,4,8,4,197,567,405
613,10,112,640,962,322,9,10,554,563,9,0.0,0.0014295925661186562,1,869,868,4,4,4,3,4,850,444,58
614,24,230,702,968,266,28,28,565,565,0,0.00013615167296368154,0.0008509479560230097,528,791,263,3,4,4,6,8,352,286,184
615,12,12,709,709,0,12,12,757,757,0,0.0006807583648184077,0.0006807583648184077,781,781,0,-1,4,4,2,2,873,475,864
616,0,102,1,930,929,0,6,1,382,381,0.0,6.807583648184077e-05,1,464,463,4,-1,5,4,1,573,650,561
617,9,111,627,950,323,8,8,540,540,0,0.0002382654276864427,0.00034037918240920387,603,665,62,4,4,4,2,4,469,278,305
618,0,102,1,897,896,0,9,1,384,383,0.0,6.807583648184077e-05,1,436,435,4,-1,5,5,0,793,801,93
619,0,102,1,958,957,0,4,1,392,391,0.0,0.000442492937131965,1,701,700,4,-1,5,3,0,668,825,500
620,49,151,842,957,115,46,46,804,804,0,0.0008169100377820892,0.0008169100377820892,784,783,-1,4,3,3,6,17,661,327,239
621,0,102,1,916,915,0,4,1,358,357,0.0,0.00017018959120460194,1,543,542,4,-1,5,3,0,687,635,727
622,10,10,645,645,0,8,8,581,581,0,0.00017018959120460194,0.00017018959120460194,550,550,0,-1,4,4,2,3,985,507,917
623,0,101,1,911,910,0,6,1,330,329,0.0,0.0,1,1,0,5,-1,6,6,0,587,728,656
624,13,115,687,958,271,8,8,551,551,0,0.0002382654276864427,0.0007147962830593281,616,769,153,4,4,4,2,6,940,229,440
625,0,206,1,950,949,0,27,1,416,415,0.0,0.0002723033459273631,1,601,600,3,-1,4,13,0,129,668,424
626,6,6,398,398,0,36,36,502,502,0,0.00010211375472276115,0.00010211375472276115,477,477,0,-1,4,4,10,1,206,862,859
627,6,6,452,452,0,14,14,569,569,0,0.00010211375472276115,0.00010211375472276115,481,481,0,-1,4,4,3,1,337,762,962
628,0,102,1,939,938,0,5,1,414,413,0.0,0.00034037918240920387,1,653,652,4,-1,5,3,0,785,877,212
629,10,216,566,970,404,18,22,525,571,46,0.00010211375472276115,0.0020422750944552232,498,885,387,3,4,4,5,6,478,406,153
630,2,2,395,395,0,4,4,470,470,0,3.4037918240920386e-05,3.4037918240920386e-05,414,414,0,-1,5,5,2,1,788,667,852
631,0,206,1,954,953,0,18,1,398,397,0.0,0.00017018959120460194,1,545,544,3,-1,4,10,0,258,986,408
632,82,82,890,890,0,40,40,777,777,0,0.0013615167296368155,0.0013615167296368155,847,847,0,-1,3,3,5,20,688,49,980
633,6,6,398,398,0,18,18,390,390,0,0.0,0.0,1,1,0,-1,4,4,10,1,206,402,992
634,0,206,1,971,970,0,14,1,467,466,0.0,0.0005786446100956465,1,732,731,3,-1,4,5,1,314,852,139
635,0,101,1,944,943,0,3,1,330,329,0.0,3.4037918240920386e-05,1,397,396,5,-1,6,3,1,867,852,654
636,60,60,832,832,0,86,86,897,897,0,0.0019741992579733825,0.0019741992579733825,876,876,0,-1,2,2,7,6,182,494,926
637,0,0,1,1,0,0,0,1,1,0,0.0,0.0,1,1,0,-1,-1,-1,4,0,767,735,916
638,0,0,1,1,0,0,0,1,1,0,0.0,0.0,1,1,0,-1,-1,-1,5,1,392,660,867
639,1,1,333,333,0,2,2,333,333,0,3.4037918240920386e-05,3.4037918240920386e-05,402,402,0,-1,6,6,2,1,807,734,752
640,0,206,1,949,948,0,33,1,431,430,0.0,6.807583648184077e-05,1,440,439,3,-1,4,13,0,41,728,508
641,2,103,362,910,548,6,6,392,392,0,3.4037918240920386e-05,3.4037918240920386e-05,398,398,0,5,5,5,3,2,837,679,364
642,8,110,502,908,406,14,14,450,450,0,0.00010211375472276115,0.00013615167296368154,483,513,30,4,4,4,5,3,426,441,721
643,15,117,663,944,281,14,14,589,589,0,0.0007488342013002485,0.00088498587426393,771,791,20,4,4,4,3,7,863,396,551
644,8,8,647,647,0,4,4,510,510,0,0.0004084550188910446,0.0004084550188910446,697,697,0,-1,5,5,2,7,962,303,956
645,6,212,436,968,532,9,14,442,501,59,0.00013615167296368154,0.000442492937131965,517,689,172,3,4,4,3,1,725,687,363
646,0,0,1,1,0,0,0,1,1,0,0.0,0.0,1,1,0,-1,-1,-1,7,0,398,928,833
647,0,102,1,895,894,0,8,1,355,354,0.0,0.00010211375472276115,1,486,485,4,-1,5,7,0,466,520,383
648,100,100,883,883,0,100,100,923,923,0,0.018040096667687803,0.01834643793185609,990,990,0,4,1,1,8,11,415,162,381
649,217,217,967,967,0,116,116,975,975,0,0.005207801490860819,0.005207801490860819,959,959,0,-1,2,2,7,27,477,25,928
650,0,102,1,978,977,0,3,1,442,441,0.0,0.0011913271384322134,1,849,848,4,-1,5,2,0,775,956,206
651,2,104,363,922,559,9,9,407,407,0,0.0,3.4037918240920386e-05,1,395,394,4,5,5,5,1,644,853,661
652,82,82,851,851,0,104,104,796,796,0,0.0009870996289866913,0.0009870996289866913,805,805,0,-1,3,3,12,15,252,219,702
653,288,288,969,969,0,172,172,938,938,0,0.004595118962524252,0.004595118962524252,946,946,0,-1,3,3,12,38,52,111,866
654,322,522,986,994,8,64,64,942,942,0,0.00527587732734266,0.005684332346233704,960,966,6,3,3,3,4,61,815,14,303
655,0,1640,1,1000,999,0,47,1,697,696,0.0,0.01320671227747711,1,988,987,1,-1,2,8,0,521,960,585
656,0,206,1,968,967,0,16,1,488,487,0.0,0.002212464685659825,1,891,890,3,-1,4,6,0,399,954,304
657,16,16,552,552,0,44,44,535,535,0,0.00017018959120460194,0.00017018959120460194,533,533,0,-1,3,3,11,1,233,870,848
658,1,103,332,954,622,2,4,332,445,113,0.0,0.0002382654276864427,1,613,612,4,6,5,2,2,806,656,165
659,0,0,1,1,0,0,0,1,1,0,0.0,0.0,1,1,0,-1,-1,-1,4,0,304,886,812
660,14,630,472,989,517,69,112,444,576,132,6.807583648184077e-05,0.001055175465468532,436,800,364,2,4,3,23,4,15,581,412
661,8,8,565,565,0,8,8,513,513,0,0.0002382654276864427,0.0002382654276864427,605,605,0,-1,4,4,2,2,874,22,675
662,16,16,566,566,0,52,52,628,628,0,0.0002723033459273631,0.0002723033459273631,615,615,0,-1,3,3,9,2,213,532,803
663,6,108,393,884,491,27,29,393,403,10,0.0,0.00013615167296368154,1,511,510,4,4,4,15,2,107,495,385
664,22,124,658,919,261,28,28,507,507,0,0.0002382654276864427,0.0002723033459273631,595,618,23,4,4,4,8,6,420,368,580
665,63,165,891,972,81,44,44,901,901,0,0.0019741992579733825,0.0020763130126961434,883,886,3,4,3,3,4,14,789,84,222
666,2,104,372,937,565,4,4,406,406,0,3.4037918240920386e-05,6.807583648184077e-05,399,444,45,4,5,5,2,2,970,342,570
667,30,132,687,911,224,82,82,642,642,0,0.00017018959120460194,0.000442492937131965,533,680,147,4,3,3,14,6,332,379,209
668,50,256,814,972,158,74,74,803,803,0,0.0012934408931549745,0.003642057251778481,832,938,106,3,3,3,9,11,190,83,88
669,0,101,1,922,921,0,4,1,332,331,0.0,0.0,1,1,0,5,-1,6,4,0,631,953,311
670,0,616,1,995,994,0,38,1,808,807,0.0,0.006841621566424997,1,975,974,2,-1,3,3,0,704,817,18
671,13,219,588,972,384,14,22,469,563,94,0.0002382654276864427,0.0004084550188910446,595,679,84,3,4,4,5,5,290,310,101
672,0,0,1,1,0,0,0,1,1,0,0.0,0.0,1,1,0,-1,-1,-1,12,0,93,668,715
673,59,265,833,974,141,84,84,806,806,0,0.0008509479560230097,0.001055175465468532,787,812,25,3,3,3,9,10,119,405,107
674,124,226,910,965,55,100,100,897,897,0,0.002280540522141666,0.0023486163586235067,892,896,4,4,3,3,9,12,389,58,755
675,60,266,805,965,160,126,126,841,841,0,0.0010892133837094523,0.00176997174852786,805,866,61,3,3,3,15,7,110,224,269
676,0,0,1,1,0,0,0,1,1,0,0.0,0.0,1,1,0,-1,-1,-1,10,1,241,730,956
677,18,119,663,934,271,20,20,593,593,0,0.0002042275094455223,0.0002723033459273631,569,614,45,5,4,4,4,5,280,182,764
678,18,224,604,958,354,40,56,516,601,85,0.0002382654276864427,0.0006467204465774873,582,747,165,3,4,4,12,5,93,636,439
679,16,16,527,527,0,90,90,678,678,0,0.0004084550188910446,0.0004084550188910446,670,670,0,-1,3,3,14,1,181,404,729
680,0,101,1,974,973,0,2,1,327,326,0.0,6.807583648184077e-05,1,462,461,5,-1,6,2,0,944,664,223
681,38,38,767,767,0,52,52,723,723,0,0.0005446066918547262,0.0005446066918547262,724,724,0,-1,3,3,7,7,273,169,695
682,6,6,414,414,0,18,18,449,449,0,0.00017018959120460194,0.00017018959120460194,536,536,0,-1,4,4,7,1,472,958,906
683,0,0,1,1,0,0,0,1,1,0,0.0,0.0,1,1,0,-1,-1,-1,16,0,50,546,737
684,20,122,708,943,235,16,16,569,569,0,0.0005786446100956465,0.0007147962830593281,739,768,29,4,4,4,4,4,543,40,353
685,0,0,1,1,0,0,0,1,1,0,0.0,0.0,1,1,0,-1,-1,-1,3,0,901,981,937
686,6,212,399,953,554,44,52,504,537,33,0.00010211375472276115,0.0002042275094455223,482,563,81,3,4,4,12,1,116,661,541
687,9,110,580,940,360,20,20,644,644,0,0.0002382654276864427,0.0002723033459273631,606,624,18,5,4,4,4,3,728,458,121
688,0,101,1,947,946,0,3,1,331,330,0.0,0.00010211375472276115,1,491,490,5,-1,6,3,0,798,794,441
689,0,0,1,1,0,0,0,1,1,0,0.0,0.0,1,1,0,-1,-1,-1,3,0,857,564,641
690,0,206,1,943,942,0,60,1,482,481,0.0,0.00037441710065012424,1,642,641,3,-1,4,21,1,2,947,336
691,56,672,824,997,173,58,68,758,827,69,0.0005446066918547262,0.003199564314646516,716,934,218,2,3,3,7,8,171,386,41
692,12,12,594,594,0,16,16,541,541,0,6.807583648184077e-05,6.807583648184077e-05,447,447,0,-1,4,4,4,4,545,259,735
693,0,0,1,1,0,0,0,1,1,0,0.0,0.0,1,1,0,-1,-1,-1,6,0,419,817,472
694,6,212,400,959,559,34,38,532,554,22,0.00017018959120460194,0.00030634126416828345,543,631,88,3,4,4,9,1,178,799,452
695,17,118,649,927,278,22,22,565,565,0,0.0002723033459273631,0.0002723033459273631,614,614,0,5,4,4,5,8,311,302,734
696,71,171,875,966,91,38,38,852,852,0,0.0020082371762143027,0.0020082371762143027,874,874,0,5,3,3,3,14,554,190,373
697,0,101,1,874,873,0,21,1,332,331,0.0,0.0,1,1,0,5,-1,6,21,0,25,423,861
698,41,143,764,924,160,64,64,717,717,0,0.0006126825283365669,0.0006807583648184077,734,743,9,4,3,3,9,9,367,293,196
699,0,0,1,1,0,0,0,1,1,0,0.0,0.0,1,1,0,-1,-1,-1,4,0,553,803,782
700,17,223,744,986,242,32,32,920,920,0,0.000442492937131965,0.0017359338302869397,707,885,178,3,3,3,2,3,913,541,129
701,226,327,952,976,24,234,234,957,957,0,0.0038462847612240037,0.003880322679464924,944,944,0,6,2,2,15,20,37,38,640
702,55,157,868,964,96,12,12,584,584,0,0.0019741992579733825,0.0020422750944552232,884,887,3,4,4,4,2,18,429,171,215
703,20,122,735,956,221,32,32,946,946,0,0.0011232513019503727,0.001497668402600497,836,864,28,4,3,3,2,3,906,268,253
704,8,110,523,926,403,24,24,568,568,0,0.00034037918240920387,0.0005105687736138058,646,712,66,4,4,4,6,4,399,278,274
705,42,143,824,951,127,64,64,921,921,0,0.0017359338302869397,0.0017359338302869397,877,877,0,5,2,2,6,2,661,634,373
706,0,0,1,1,0,0,0,1,1,0,0.0,0.0,1,1,0,-1,-1,-1,7,1,209,705,783
707,0,0,1,1,0,0,0,1,1,0,0.0,0.0,1,1,0,-1,-1,-1,12,0,348,768,897
708,0,206,1,943,942,0,30,1,405,404,0.0,0.0002723033459273631,1,600,599,3,-1,4,15,0,37,608,156
709,5,106,467,938,471,6,6,418,418,0,0.00010211375472276115,0.0002723033459273631,480,614,134,5,5,5,3,3,748,311,409
710,6,107,468,939,471,12,12,612,612,0,0.00030634126416828345,0.00034037918240920387,632,650,18,5,4,4,2,1,849,681,449
711,229,435,963,986,23,138,138,967,967,0,0.005207801490860819,0.0053439531638245,956,957,1,3,2,2,9,27,414,25,659
712,12,113,594,932,338,20,20,632,632,0,0.0002723033459273631,0.000442492937131965,610,692,82,5,4,4,4,4,550,149,383
713,24,24,665,665,0,44,44,603,603,0,0.0002042275094455223,0.0002042275094455223,569,569,0,-1,4,4,8,4,434,167,911
714,4,4,479,479,0,4,4,455,455,0,3.4037918240920386e-05,3.4037918240920386e-05,411,411,0,-1,5,5,2,3,868,508,927
715,0,616,1,993,992,0,36,1,531,530,0.0,0.0015317063208414173,1,852,851,2,-1,3,9,0,263,784,139
716,0,1640,1,1000,999,0,134,1,687,686,0.0,0.005922597773920147,1,954,953,1,-1,2,22,0,55,961,82
717,243,243,977,977,0,54,54,906,906,0,0.00616086320160659,0.00616086320160659,967,967,0,-1,3,3,4,49,690,31,826
718,0,206,1,975,974,0,20,1,601,600,0.0,0.0023486163586235067,1,901,900,3,-1,4,4,0,462,883,39
719,79,79,894,894,0,40,40,863,863,0,0.001599782157323258,0.001599782157323258,860,860,0,-1,3,3,4,17,562,79,953
720,13,219,576,966,390,28,28,534,534,0,0.0005105687736138058,0.0005446066918547262,693,708,15,3,4,4,8,3,371,458,634
721,40,142,769,933,164,61,61,781,781,0,0.0014295925661186562,0.0015657442390823377,847,854,7,4,2,2,8,2,415,325,584
722,0,0,1,1,0,0,0,1,1,0,0.0,0.0,1,1,0,-1,-1,-1,7,0,320,502,950
723,0,101,1,937,936,0,2,1,331,330,0.0,0.0,1,1,0,5,-1,6,2,0,881,894,771
724,40,40,712,712,0,105,105,687,687,0,0.0007488342013002485,0.0007488342013002485,758,758,0,-1,2,2,16,2,42,719,817
725,8,214,596,984,388,13,18,678,823,145,3.4037918240920386e-05,0.0045270431260424114,399,951,552,3,4,4,3,2,915,680,34
726,0,0,1,1,0,0,0,1,1,0,0.0,0.0,1,1,0,-1,-1,-1,9,0,159,877,723
727,0,0,1,1,0,0,0,1,1,0,0.0,0.0,1,1,0,-1,-1,-1,4,0,622,588,624
728,2,2,359,359,0,11,11,388,388,0,6.807583648184077e-05,6.807583648184077e-05,452,452,0,-1,5,5,7,1,299,594,372
729,22,124,668,928,260,26,26,662,662,0,0.0005105687736138058,0.0006126825283365669,706,738,32,4,3,3,4,2,540,363,904
730,18,634,656,997,341,44,54,811,870,59,0.00010211375472276115,0.004050512270669526,491,946,455,2,3,3,4,2,759,363,95
731,0,616,1,990,989,0,70,1,597,596,0.0,0.0015317063208414173,1,856,855,2,-1,3,14,0,21,798,82
732,112,213,928,971,43,64,64,920,920,0,0.003199564314646516,0.003199564314646516,931,931,0,6,2,2,5,15,386,158,663
733,0,102,1,974,973,0,3,1,436,435,0.0,0.00017018959120460194,1,559,558,4,-1,5,2,0,978,774,496
734,5,106,440,921,481,10,10,432,432,0,0.00010211375472276115,0.00010211375472276115,489,489,0,5,5,5,5,3,464,411,837
735,12,114,644,954,310,10,10,532,532,0,0.00013615167296368154,0.00034037918240920387,526,655,129,4,4,4,3,6,854,486,211
736,2,2,368,368,0,3,3,368,368,0,3.4037918240920386e-05,3.4037918240920386e-05,395,395,0,-1,5,5,2,1,979,503,905
737,0,0,1,1,0,0,0,1,1,0,0.0,0.0,1,1,0,-1,-1,-1,5,0,528,890,832
738,74,175,877,954,77,66,66,873,873,0,0.001599782157323258,0.0016338200755641784,861,865,4,5,3,3,6,17,465,60,313
739,2,2,380,380,0,4,4,420,420,0,3.4037918240920386e-05,3.4037918240920386e-05,410,410,0,-1,5,5,2,1,975,666,820
740,1,103,332,945,613,3,5,332,406,74,0.0,0.00034037918240920387,1,657,656,4,6,5,3,2,867,495,475
741,12,218,563,969,406,18,18,566,566,0,0.0002723033459273631,0.00088498587426393,614,797,183,3,4,4,3,5,634,124,195
742,9,9,549,549,0,13,13,462,462,0,0.0002723033459273631,0.0002723033459273631,610,610,0,-1,4,4,5,3,519,536,583
743,22,1662,622,1000,378,68,106,609,794,185,0.0005786446100956465,0.008611593314952858,717,970,253,1,3,2,13,2,160,473,154
744,6,212,382,941,559,42,53,438,485,47,0.00013615167296368154,0.0004084550188910446,507,656,149,3,4,4,17,1,80,618,52
745,33,134,772,937,165,56,56,833,833,0,0.0012934408931549745,0.0013274788113958951,838,844,6,5,3,3,6,8,465,497,885
746,26,128,725,925,200,30,30,690,690,0,0.000442492937131965,0.0007488342013002485,695,769,74,4,3,3,4,4,759,365,275
747,0,0,1,1,0,0,0,1,1,0,0.0,0.0,1,1,0,-1,-1,-1,16,0,132,974,973
748,6,212,406,954,548,26,36,434,508,74,3.4037918240920386e-05,0.00088498587426393,384,778,394,3,4,4,12,1,219,873,62
749,0,0,1,1,0,0,0,1,1,0,0.0,0.0,1,1,0,-1,-1,-1,17,0,6,786,818
750,19,120,613,897,284,46,46,511,511,0,0.00013615167296368154,0.00013615167296368154,518,518,0,5,4,4,13,6,97,229,357
751,1,1,333,333,0,2,2,333,333,0,0.0,0.0,1,1,0,-1,6,6,2,1,896,924,997
752,0,0,1,1,0,0,0,1,1,0,0.0,0.0,1,1,0,-1,-1,-1,5,1,524,650,728
753,307,513,975,989,14,198,198,984,984,0,0.00704584907587052,0.00793083495013445,970,974,4,3,2,2,10,37,298,74,261
754,97,303,860,972,112,120,120,778,778,0,0.0009870996289866913,0.001497668402600497,801,852,51,3,3,3,14,17,198,131,405
755,3,3,448,448,0,5,5,409,409,0,0.0,0.0,1,1,0,-1,5,5,3,5,840,225,200
756,0,102,1,899,898,0,9,1,369,368,0.0,3.4037918240920386e-05,1,404,403,4,-1,5,7,0,265,940,347
757,0,102,1,971,970,0,4,1,466,465,0.0,0.0005446066918547262,1,737,736,4,-1,5,2,1,941,650,329
758,2,2,362,362,0,7,7,372,372,0,0.0,0.0,1,1,0,-1,5,5,5,1,552,853,713
759,5,107,527,968,441,3,3,397,397,0,0.00013615167296368154,0.0005105687736138058,528,726,198,4,5,5,2,3,933,385,52
760,0,206,1,966,965,0,13,1,451,450,0.0,0.001055175465468532,1,815,814,3,-1,4,5,0,457,984,62
761,0,616,1,989,988,0,60,1,543,542,0.0,0.002723033459273631,1,911,910,2,-1,3,15,3,124,478,98
762,6,107,432,919,487,10,10,454,454,0,0.0,3.4037918240920386e-05,1,403,402,5,4,4,3,2,930,325,481
763,16,222,603,966,363,28,28,683,683,0,0.00010211375472276115,0.0005446066918547262,475,716,241,3,3,3,3,1,731,553,338
764,8,8,545,545,0,18,18,653,653,0,0.0004084550188910446,0.0004084550188910446,684,684,0,-1,4,4,3,2,833,634,372
765,0,616,1,992,991,0,50,1,509,508,0.0,0.0007488342013002485,1,753,752,2,-1,3,14,0,268,821,134
766,64,165,892,971,79,48,48,960,960,0,0.008066986623098132,0.008066986623098132,976,976,0,5,2,2,3,8,654,521,661
767,10,216,552,967,415,22,26,576,631,55,0.00013615167296368154,0.00037441710065012424,509,660,151,3,4,4,5,4,667,501,450
768,22,228,676,971,295,32,36,704,734,30,0.0005446066918547262,0.002144388849177984,717,893,176,3,3,3,5,3,667,197,15
769,80,181,859,950,91,72,72,811,811,0,0.0010892133837094523,0.0011232513019503727,814,818,4,5,3,3,7,12,246,163,292
770,0,0,1,1,0,0,0,1,1,0,0.0,0.0,1,1,0,-1,-1,-1,7,0,329,917,569
771,2,2,355,355,0,10,10,388,388,0,3.4037918240920386e-05,3.4037918240920386e-05,398,398,0,-1,5,5,6,1,470,421,942
772,25,25,741,741,0,38,38,774,774,0,0.0005446066918547262,0.0005446066918547262,719,719,0,-1,3,3,6,6,529,381,400
773,0,206,1,956,955,0,31,1,481,480,0.0,0.0006467204465774873,1,740,739,3,-1,4,11,0,379,804,139
774,1,102,333,886,553,7,7,333,333,0,0.0,0.0,1,1,0,5,6,6,7,1,374,621,298
775,60,161,859,957,98,68,68,954,954,0,0.0027911092957554717,0.0027911092957554717,923,923,0,5,2,2,4,5,495,393,364
776,10,216,619,983,364,7,7,529,529,0,3.4037918240920386e-05,0.00037441710065012424,403,671,268,3,4,4,2,5,821,241,308
777,26,26,736,736,0,24,24,652,652,0,0.00034037918240920387,0.00034037918240920387,657,657,0,-1,4,4,4,5,566,182,888
778,83,185,899,966,67,48,48,931,931,0,0.002552843868069029,0.002723033459273631,911,914,3,4,3,3,3,15,672,151,124
779,19,225,639,969,330,22,26,527,579,52,0.00034037918240920387,0.0005105687736138058,639,699,60,3,4,4,5,5,546,510,662
780,108,209,936,972,36,56,56,975,975,0,0.007692569522448007,0.007692569522448007,976,976,0,8,2,2,2,17,931,45,448
781,0,616,1,992,991,0,70,1,741,740,0.0,0.003880322679464924,1,938,937,2,-1,3,9,0,208,737,13
782,12,218,555,966,411,17,22,455,495,40,0.0002042275094455223,0.0005446066918547262,560,716,156,3,4,4,7,4,264,210,145
783,43,145,814,948,134,24,24,650,650,0,0.0006807583648184077,0.0006807583648184077,744,744,0,4,4,4,4,14,815,387,639
784,1,617,333,992,659,11,60,333,605,272,0.0,0.002144388849177984,1,892,891,2,6,3,11,1,150,140,104
785,37,243,773,970,197,46,46,733,733,0,0.0009190237925048504,0.005990673610401988,790,963,173,3,3,3,6,8,419,497,19
786,2,2,366,366,0,4,4,395,395,0,0.0,0.0,1,1,0,-1,5,5,2,3,586,321,813
787,74,176,891,970,79,28,28,847,847,0,0.0016678579938050988,0.0021784267674189047,870,896,26,4,3,3,3,20,710,71,232
788,107,209,921,968,47,82,82,919,919,0,0.0031314884781646754,0.003369753905851118,925,932,7,4,3,3,7,18,439,141,386
789,0,0,1,1,0,0,0,1,1,0,0.0,0.0,1,1,0,-1,-1,-1,4,0,860,488,813
790,0,0,1,1,0,0,0,1,1,0,0.0,0.0,1,1,0,-1,-1,-1,3,0,856,600,462
791,0,206,1,977,976,0,10,1,507,506,0.0,0.0033016780693692774,1,933,932,3,-1,4,3,0,770,811,20
792,1,103,333,938,605,3,6,333,434,101,0.0,0.001055175465468532,1,817,816,4,6,5,3,1,676,671,63
793,0,102,1,898,897,0,15,1,399,398,0.0,0.00030634126416828345,1,626,625,4,-1,5,8,0,499,902,795
794,0,0,1,1,0,0,0,1,1,0,0.0,0.0,1,1,0,-1,-1,-1,6,0,237,866,649
795,0,102,1,927,926,0,6,1,406,405,0.0,0.0004765308553728854,1,705,704,4,-1,5,3,0,680,678,475
796,6,212,462,974,512,11,16,470,568,98,6.807583648184077e-05,0.0002723033459273631,451,632,181,3,4,4,4,2,673,648,482
797,3,105,450,943,493,5,6,403,438,35,0.00010211375472276115,0.00037441710065012424,496,672,176,4,5,5,3,3,708,441,202
798,6,6,425,425,0,22,22,455,455,0,0.0,0.0,1,1,0,-1,4,4,9,3,119,321,913
799,0,0,1,1,0,0,0,1,1,0,0.0,0.0,1,1,0,-1,-1,-1,2,2,970,431,880
800,875,977,998,999,1,206,206,996,996,0,0.019265461724360937,0.019367575479083698,996,996,0,4,2,2,9,127,330,11,689
801,10,216,666,990,324,4,12,439,709,270,0.00010211375472276115,0.004629156880765172,501,958,457,3,5,4,2,8,997,477,18
802,12,218,569,969,400,24,24,628,628,0,0.00030634126416828345,0.0007147962830593281,638,758,120,3,4,4,4,4,572,551,470
803,0,206,1,965,964,0,14,1,463,462,0.0,0.00037441710065012424,1,672,671,3,-1,4,5,0,396,860,727
804,41,41,777,777,0,64,64,772,772,0,0.0006126825283365669,0.0006126825283365669,740,740,0,-1,3,3,8,8,418,257,979
805,0,102,1,946,945,0,3,1,368,367,0.0,0.00013615167296368154,1,529,528,4,-1,5,2,0,988,669,317
806,6,108,435,922,487,18,18,595,595,0,3.4037918240920386e-05,0.0002382654276864427,404,600,196,4,4,4,3,1,892,110,435
807,36,652,688,989,301,108,142,708,817,109,0.00037441710065012424,0.0045270431260424114,637,948,311,2,3,3,16,4,132,86,51
808,0,0,1,1,0,0,0,1,1,0,0.0,0.0,1,1,0,-1,-1,-1,3,0,902,940,673
809,63,165,849,951,102,44,44,808,808,0,0.0008169100377820892,0.0010211375472276116,785,818,33,4,3,3,4,8,500,177,453
810,28,130,716,934,218,46,46,782,782,0,0.0005105687736138058,0.0005446066918547262,706,714,8,4,3,3,5,5,390,688,380
811,22,22,710,710,0,12,12,567,567,0,0.000442492937131965,0.000442492937131965,690,690,0,-1,4,4,2,9,905,198,629
812,16,16,519,519,0,108,108,674,674,0,0.00034037918240920387,0.00034037918240920387,636,636,0,-1,3,3,18,1,111,727,324
813,24,1664,626,1000,374,162,210,809,887,78,0.0007828721195411688,0.008611593314952858,761,972,211,1,3,2,21,3,2,390,142
814,8,1648,478,1000,522,28,136,400,808,408,0.00017018959120460194,0.01497668402600497,529,993,464,1,4,2,15,2,104,547,11
815,6,107,461,935,474,12,12,475,475,0,6.807583648184077e-05,0.00013615167296368154,447,519,72,5,4,4,4,1,617,623,332
816,87,293,835,965,130,230,230,888,888,0,0.001497668402600497,0.0016338200755641784,855,863,8,3,2,2,21,9,3,415,577
817,0,102,1,905,904,0,9,1,389,388,0.0,0.00013615167296368154,1,512,511,4,-1,5,5,0,347,522,115
818,16,16,526,526,0,100,100,708,708,0,0.0002723033459273631,0.0002723033459273631,600,600,0,-1,3,3,13,1,115,282,775
819,77,77,841,841,0,148,148,880,880,0,0.0018040096667687805,0.0018040096667687805,871,871,0,-1,2,2,14,9,47,415,472
820,34,135,794,949,155,34,34,802,802,0,0.0024507301133462676,0.0024507301133462676,896,896,0,6,3,3,4,6,787,73,861
821,37,139,862,976,114,18,18,781,781,0,0.0011232513019503727,0.0014295925661186562,829,858,29,4,4,4,3,15,853,219,432
822,40,246,685,946,261,268,268,903,903,0,0.0009530617107457708,0.0012934408931549745,788,832,44,3,2,2,23,1,4,480,197
823,55,157,817,945,128,50,50,642,642,0,0.0009870996289866913,0.0012934408931549745,799,828,29,4,4,4,9,15,394,219,198
824,24,24,737,737,0,48,48,907,907,0,0.0013274788113958951,0.0013274788113958951,843,843,0,-1,3,3,3,7,651,224,835
825,18,224,599,955,356,98,98,747,747,0,0.00030634126416828345,0.0008169100377820892,619,765,146,3,3,3,13,3,129,541,83
826,4,4,527,527,0,4,4,510,510,0,0.0002382654276864427,0.0002382654276864427,620,620,0,-1,5,5,2,3,962,121,979
827,0,102,1,930,929,0,8,1,457,456,0.0,0.0005786446100956465,1,736,735,4,-1,5,4,0,507,980,293
828,0,206,1,960,959,0,42,1,656,655,0.0,0.0026209197045508697,1,914,913,3,-1,4,7,1,450,529,28
829,0,206,1,950,949,0,52,1,542,541,0.0,0.0013274788113958951,1,832,831,3,-1,4,12,0,87,967,96
830,6,108,399,889,490,35,36,423,428,5,0.00017018959120460194,0.0002723033459273631,534,603,69,4,4,4,16,1,78,537,443
831,1,1,333,333,0,4,4,333,333,0,0.0,0.0,1,1,0,-1,6,6,4,2,700,374,728
832,34,135,775,942,167,50,50,843,843,0,0.0006807583648184077,0.0006807583648184077,757,757,0,5,3,3,5,5,538,338,837
833,26,232,714,973,259,46,46,733,733,0,0.0004084550188910446,0.0006126825283365669,671,728,57,3,3,3,6,4,341,328,619
834,0,206,1,963,962,0,12,1,443,442,0.0,0.00017018959120460194,1,543,542,3,-1,4,4,0,516,673,241
835,36,242,687,952,265,100,108,574,616,42,0.0002042275094455223,0.00030634126416828345,567,620,53,3,3,3,21,5,3,636,223
836,41,41,851,851,0,22,22,824,824,0,0.0011232513019503727,0.0011232513019503727,829,829,0,-1,3,3,2,8,964,187,715
837,0,101,1,908,907,0,8,1,332,331,0.0,0.0,1,1,0,5,-1,6,8,0,323,981,692
838,229,331,961,975,14,166,166,929,929,0,0.003812246842983083,0.003914360597705844,945,947,2,4,2,2,12,24,116,13,523
839,0,102,1,914,913,0,9,1,401,400,0.0,0.0002723033459273631,1,622,621,4,-1,5,5,1,290,962,450
840,2,2,354,354,0,10,10,365,365,0,3.4037918240920386e-05,3.4037918240920386e-05,402,402,0,-1,5,5,8,1,303,781,428
841,2,2,350,350,0,27,27,391,391,0,0.0,0.0,1,1,0,-1,5,5,16,1,72,558,672
842,0,0,1,1,0,0,0,1,1,0,0.0,0.0,1,1,0,-1,-1,-1,10,1,259,705,937
843,24,24,760,760,0,24,24,783,783,0,0.0002382654276864427,0.0002382654276864427,612,612,0,-1,3,3,3,4,863,622,909
844,8,214,589,982,393,8,12,550,690,140,6.807583648184077e-05,0.0005786446100956465,453,731,278,3,4,4,2,3,967,585,545
845,0,0,1,1,0,0,0,1,1,0,0.0,0.0,1,1,0,-1,-1,-1,2,0,469,981,794
846,0,206,1,973,972,0,10,1,442,441,0.0,6.807583648184077e-05,1,445,444,3,-1,4,5,0,580,986,410
847,0,101,1,933,932,0,3,1,327,326,0.0,0.00010211375472276115,1,479,478,5,-1,6,3,0,639,877,392
848,0,0,1,1,0,0,0,1,1,0,0.0,0.0,1,1,0,-1,-1,-1,8,0,260,818,426
849,127,127,908,908,0,110,110,858,858,0,0.0019061234214915416,0.0019061234214915416,879,879,0,-1,3,3,10,15,125,36,433
850,0,206,1,977,976,0,8,1,499,498,0.0,0.0011913271384322134,1,843,842,3,-1,4,2,0,779,950,60
851,48,254,799,971,172,42,42,643,643,0,0.0009870996289866913,0.0011913271384322134,804,825,21,3,4,4,7,14,591,175,371
852,18,634,568,992,424,72,104,542,681,139,0.00034037918240920387,0.0031314884781646754,637,920,283,2,4,3,16,6,42,247,35
853,0,206,1,973,972,0,16,1,553,552,0.0,0.0007488342013002485,1,772,771,3,-1,4,4,0,617,522,83
854,4,105,504,964,460,3,3,395,395,0,3.4037918240920386e-05,0.00010211375472276115,402,494,92,5,5,5,2,3,981,311,298
855,0,102,1,936,935,0,4,1,417,416,0.0,0.0004084550188910446,1,697,696,4,-1,5,2,0,776,701,159
856,111,317,955,991,36,28,28,843,843,0,0.0038462847612240037,0.0048674223084516155,942,951,9,3,3,3,3,36,718,48,207
857,0,206,1,972,971,0,8,1,480,479,0.0,0.0005446066918547262,1,729,728,3,-1,4,2,0,589,963,377
858,34,136,860,980,120,8,8,644,644,0,0.0009530617107457708,0.001055175465468532,807,817,10,4,4,4,2,19,884,59,567
859,0,0,1,1,0,0,0,1,1,0,0.0,0.0,1,1,0,-1,-1,-1,3,0,485,600,834
860,0,206,1,968,967,0,12,1,512,511,0.0,0.00037441710065012424,1,665,664,3,-1,4,4,0,949,974,178
861,6,6,506,506,0,7,7,529,529,0,0.00017018959120460194,0.00017018959120460194,555,555,0,-1,4,4,2,4,821,409,569
862,10,112,525,910,385,26,26,485,485,0,0.0002042275094455223,0.0002042275094455223,549,549,0,4,4,4,9,7,395,451,434
863,0,206,1,956,955,0,38,1,484,483,0.0,0.00034037918240920387,1,638,637,3,-1,4,11,0,188,900,80
864,0,0,1,1,0,0,0,1,1,0,0.0,0.0,1,1,0,-1,-1,-1,3,0,585,731,649
865,26,642,659,993,334,54,76,571,685,114,0.00013615167296368154,0.002110350930937064,519,889,370,2,4,3,11,6,162,486,38
866,0,0,1,1,0,0,0,1,1,0,0.0,0.0,1,1,0,-1,-1,-1,3,3,621,746,874
867,18,18,707,707,0,20,20,659,659,0,0.0002723033459273631,0.0002723033459273631,620,620,0,-1,4,4,4,7,679,237,488
868,62,268,793,960,167,134,134,774,774,0,0.0005786446100956465,0.0007147962830593281,717,752,35,3,2,2,17,4,24,202,317
869,102,102,925,925,0,28,28,772,772,0,0.002110350930937064,0.002110350930937064,887,887,0,-1,3,3,3,17,592,79,806
870,23,124,698,943,245,38,38,840,840,0,0.000442492937131965,0.0004765308553728854,683,698,15,5,3,3,3,5,927,619,601
871,156,362,907,976,69,224,224,895,895,0,0.0019741992579733825,0.002757071377514551,878,917,39,3,3,3,19,19,31,144,296
872,22,124,594,890,296,78,78,605,605,0,0.0002042275094455223,0.0002042275094455223,564,564,0,4,3,3,14,2,133,682,331
873,106,106,921,921,0,54,54,893,893,0,0.002382654276864427,0.002382654276864427,906,906,0,-1,3,3,4,18,512,171,794
874,0,102,1,935,934,0,5,1,399,398,0.0,0.00013615167296368154,1,526,525,4,-1,5,3,0,770,926,418
875,44,44,797,797,0,52,52,790,790,0,0.0005786446100956465,0.0005786446100956465,737,737,0,-1,3,3,6,6,98,275,925
876,66,66,793,793,0,152,152,772,772,0,0.0007488342013002485,0.0007488342013002485,763,763,0,-1,3,3,20,11,88,249,802
877,334,540,983,993,10,104,104,967,967,0,0.00966676878042139,0.009939072126348753,979,981,2,3,2,2,5,49,474,16,266
878,0,0,1,1,0,0,0,1,1,0,0.0,0.0,1,1,0,-1,-1,-1,16,0,78,889,970
879,26,232,735,977,242,20,20,575,575,0,0.0005786446100956465,0.0010892133837094523,736,823,87,3,4,4,4,9,453,245,328
880,18,18,739,739,0,22,22,859,859,0,0.00034037918240920387,0.00034037918240920387,653,653,0,-1,3,3,2,2,792,770,974
881,16,118,618,928,310,22,22,546,546,0,0.0002723033459273631,0.0002723033459273631,626,626,0,4,4,4,5,6,665,613,434
882,3,3,468,468,0,3,3,331,331,0,0.00013615167296368154,0.00013615167296368154,535,535,0,-1,6,6,3,3,668,534,735
883,182,182,972,972,0,22,22,795,795,0,0.006773545729943157,0.006773545729943157,969,969,0,-1,3,3,2,34,747,20,608
884,8,8,499,499,0,26,26,511,511,0,0.00010211375472276115,0.00010211375472276115,475,475,0,-1,4,4,7,3,209,434,400
885,0,0,1,1,0,0,0,1,1,0,0.0,0.0,1,1,0,-1,-1,-1,13,0,41,831,673
886,2,104,382,957,575,4,5,388,419,31,6.807583648184077e-05,0.0006467204465774873,459,756,297,4,5,5,3,1,922,421,130
887,0,0,1,1,0,0,0,1,1,0,0.0,0.0,1,1,0,-1,-1,-1,2,0,959,359,568
888,1,103,333,959,626,2,3,333,392,59,0.0,3.4037918240920386e-05,1,413,412,4,7,5,2,1,666,590,749
889,16,16,542,542,0,35,35,472,472,0,6.807583648184077e-05,6.807583648184077e-05,449,449,0,-1,3,3,12,2,62,662,890
890,13,219,652,979,327,12,12,533,533,0,0.00010211375472276115,0.0002042275094455223,492,574,82,3,4,4,4,5,827,274,302
891,2,2,355,355,0,3,3,355,355,0,6.807583648184077e-05,6.807583648184077e-05,460,460,0,-1,5,5,2,1,769,781,733
892,0,102,1,931,930,0,10,1,442,441,0.0,0.001157289220191293,1,828,827,4,-1,5,5,0,580,498,58
893,32,134,742,932,190,40,40,735,735,0,0.0005446066918547262,0.0006467204465774873,716,738,22,4,3,3,5,5,492,273,576
894,0,0,1,1,0,0,0,1,1,0,0.0,0.0,1,1,0,-1,-1,-1,20,0,70,426,502
895,0,206,1,941,940,0,35,1,423,422,0.0,0.0005105687736138058,1,685,684,3,-1,4,16,0,134,674,294
896,0,616,1,990,989,0,72,1,631,630,0.0,0.0026209197045508697,1,913,912,2,-1,3,13,0,160,898,133
897,17,223,641,968,327,28,32,666,703,37,0.0004765308553728854,0.0011232513019503727,695,824,129,3,3,3,5,4,667,305,268
898,50,151,867,965,98,18,18,665,665,0,0.0010892133837094523,0.0010892133837094523,828,828,0,7,4,4,3,15,732,92,671
899,2,104,367,935,568,5,6,392,416,24,0.0,0.0005786446100956465,1,719,718,4,5,5,3,1,912,639,293
900,6,6,433,433,0,18,18,515,515,0,0.0002042275094455223,0.0002042275094455223,567,567,0,-1,4,4,5,3,290,260,813
901,2,208,366,972,606,5,10,393,473,80,0.0,0.0002042275094455223,1,566,565,3,5,4,3,3,855,460,379
902,0,206,1,976,975,0,18,1,657,656,0.0,0.001497668402600497,1,864,863,3,-1,4,3,2,756,684,53
903,80,182,859,951,92,74,74,797,797,0,0.001599782157323258,0.0016678579938050988,855,861,6,4,3,3,9,17,395,45,208
904,0,206,1,947,946,0,24,1,416,415,0.0,0.0002723033459273631,1,611,610,3,-1,4,11,1,76,583,741
905,0,102,1,928,927,0,6,1,377,376,0.0,0.00013615167296368154,1,517,516,4,-1,5,4,0,635,816,408
906,38,244,736,964,228,52,52,621,621,0,0.0004084550188910446,0.0009190237925048504,672,781,109,3,4,4,10,11,258,316,295
907,32,238,749,968,219,56,56,799,799,0,0.0007828721195411688,0.0009870996289866913,774,810,36,3,3,3,6,6,281,376,191
908,20,226,635,961,326,28,32,595,644,49,0.0002042275094455223,0.000442492937131965,553,684,131,3,3,3,5,3,496,347,364
909,0,0,1,1,0,0,0,1,1,0,0.0,0.0,1,1,0,-1,-1,-1,2,0,643,801,906
910,40,142,750,924,174,66,66,678,678,0,0.00088498587426393,0.0011232513019503727,784,819,35,4,3,3,10,8,99,345,447
911,38,140,803,948,145,28,28,741,741,0,0.0010892133837094523,0.0012594029749140542,821,834,13,4,3,3,3,4,836,407,494
912,6,212,380,942,562,68,81,485,525,40,6.807583648184077e-05,0.0005446066918547262,446,714,268,3,4,4,21,1,3,452,160
913,4,105,527,971,444,4,4,510,510,0,0.00013615167296368154,0.0005446066918547262,535,743,208,5,5,5,2,2,962,682,507
914,489,695,988,992,4,164,164,961,961,0,0.00891793457912114,0.009360427516253106,975,976,1,3,2,2,10,59,189,5,589
915,16,118,625,935,310,24,24,650,650,0,0.0002723033459273631,0.0002723033459273631,611,612,1,4,4,4,4,5,652,252,579
916,0,102,1,936,935,0,3,1,368,367,0.0,0.0004084550188910446,1,680,679,4,-1,5,2,0,849,673,90
917,30,236,710,965,255,34,42,560,623,63,0.00030634126416828345,0.0020082371762143027,635,886,251,3,4,4,7,10,331,262,133
918,2,2,361,361,0,6,6,375,375,0,0.0,0.0,1,1,0,-1,5,5,4,3,500,578,802
919,16,118,622,924,302,28,28,767,767,0,0.0004084550188910446,0.0005105687736138058,684,726,42,4,3,3,3,2,471,670,353
920,0,0,1,1,0,0,0,1,1,0,0.0,0.0,1,1,0,-1,-1,-1,3,0,927,804,356
921,6,107,427,907,480,12,12,436,436,0,0.0,0.0,1,1,0,6,4,4,4,1,385,592,469
922,28,28,775,775,0,24,24,759,759,0,0.000442492937131965,0.000442492937131965,702,702,0,-1,3,3,3,8,588,477,709
923,0,206,1,972,971,0,10,1,462,461,0.0,0.0005105687736138058,1,723,722,3,-1,4,3,0,746,940,293
924,0,0,1,1,0,0,0,1,1,0,0.0,0.0,1,1,0,-1,-1,-1,3,0,918,750,726
925,0,101,1,931,930,0,5,1,331,330,0.0,6.807583648184077e-05,1,443,442,5,-1,6,5,0,695,511,648
926,19,19,655,655,0,40,40,723,723,0,0.00030634126416828345,0.00030634126416828345,613,613,0,-1,3,3,5,4,390,278,820
927,12,114,493,887,394,34,34,444,444,0,6.807583648184077e-05,0.0002382654276864427,443,570,127,4,4,4,14,3,108,829,931
928,0,0,1,1,0,0,0,1,1,0,0.0,0.0,1,1,0,-1,-1,-1,3,0,877,772,902
929,79,181,840,937,97,116,116,775,775,0,0.0009530617107457708,0.0010211375472276116,795,802,7,4,3,3,15,12,95,159,598
930,10,112,579,932,353,12,13,470,483,13,0.00013615167296368154,0.0002382654276864427,526,609,83,4,4,4,5,3,744,353,474
931,683,889,995,998,3,128,128,960,960,0,0.014500153170632085,0.014534191088873005,987,987,0,3,3,3,8,118,301,37,363
932,66,272,794,956,162,120,124,719,738,19,0.0005786446100956465,0.0010211375472276116,706,796,90,3,3,3,17,7,103,115,267
933,83,83,891,891,0,34,34,750,750,0,0.002280540522141666,0.002280540522141666,901,901,0,-1,3,3,4,19,444,91,478
934,132,132,932,932,0,86,86,914,914,0,0.0040845501889104465,0.0040845501889104465,945,945,0,-1,3,3,6,29,356,142,428
935,50,50,792,792,0,116,116,884,884,0,0.0015317063208414173,0.0015317063208414173,852,852,0,-1,3,3,11,5,155,393,934
936,0,0,1,1,0,0,0,1,1,0,0.0,0.0,1,1,0,-1,-1,-1,8,0,131,858,571
937,0,101,1,933,932,0,2,1,332,331,0.0,0.00013615167296368154,1,507,506,5,-1,6,2,0,739,729,724
938,19,19,678,678,0,16,16,527,527,0,0.0004084550188910446,0.0004084550188910446,683,683,0,-1,4,4,4,7,280,396,752
939,62,268,824,970,146,108,108,900,900,0,0.0018040096667687805,0.0022465026039007454,877,901,24,3,2,2,9,7,136,150,240
940,7,213,501,967,466,26,26,580,580,0,0.0,0.002382654276864427,1,902,901,3,4,4,5,3,390,300,28
941,0,0,1,1,0,0,0,1,1,0,0.0,0.0,1,1,0,-1,-1,-1,5,0,406,843,927
942,0,102,1,954,953,0,4,1,381,380,0.0,0.00017018959120460194,1,549,548,4,-1,5,3,0,875,999,230
943,9,111,643,965,322,8,8,592,592,0,0.00037441710065012424,0.000442492937131965,681,703,22,4,4,4,2,4,997,450,553
944,12,218,617,978,361,14,14,578,578,0,0.0002382654276864427,0.002314578440382586,585,896,311,3,4,4,3,4,288,551,135
945,0,0,1,1,0,0,0,1,1,0,0.0,0.0,1,1,0,-1,-1,-1,4,0,480,919,436
946,38,140,784,936,152,42,42,689,689,0,0.0004084550188910446,0.0006467204465774873,668,741,73,4,4,4,7,11,336,52,474
947,0,616,1,1000,999,0,18,1,814,813,0.0,0.005207801490860819,1,958,957,2,-1,3,2,1,928,513,69
948,17,119,681,944,263,18,18,633,633,0,0.00017018959120460194,0.0002382654276864427,545,591,46,4,4,4,3,5,801,636,110
949,9,110,511,900,389,34,34,508,508,0,0.00010211375472276115,0.00013615167296368154,483,514,31,5,4,4,9,5,147,710,761
950,0,102,1,930,929,0,8,1,443,442,0.0,6.807583648184077e-05,1,454,453,4,-1,5,4,0,607,668,280
951,0,206,1,958,957,0,23,1,418,417,0.0,0.0006467204465774873,1,741,740,3,-1,4,11,0,176,205,399
952,18,18,694,694,0,18,18,649,649,0,0.0005786446100956465,0.0005786446100956465,730,730,0,-1,4,4,3,6,903,289,994
953,30,236,755,975,220,34,34,646,646,0,0.0005446066918547262,0.0006467204465774873,725,749,24,3,4,4,7,9,697,414,576
954,0,206,1,957,956,0,23,1,427,426,0.0,0.0002042275094455223,1,565,564,3,-1,4,11,0,248,784,432
955,54,156,849,958,109,40,40,812,812,0,0.00176997174852786,0.002110350930937064,882,896,14,4,3,3,5,13,908,261,159
956,81,81,921,921,0,12,12,694,694,0,0.002212464685659825,0.002212464685659825,910,910,0,-1,4,4,2,27,947,69,821
957,202,408,953,982,29,162,162,969,969,0,0.004561081044283332,0.004969536063174376,951,958,7,3,2,2,9,17,287,81,187
958,0,0,1,1,0,0,0,1,1,0,0.0,0.0,1,1,0,-1,-1,-1,4,0,354,818,937
959,0,206,1,944,943,0,38,1,447,446,0.0,0.0002723033459273631,1,598,597,3,-1,4,13,0,115,946,551
960,6,6,505,505,0,18,18,696,696,0,0.00017018959120460194,0.00017018959120460194,563,563,0,-1,4,4,3,1,718,553,864
961,21,227,689,975,286,44,44,805,805,0,0.0007147962830593281,0.0013615167296368155,768,844,76,3,3,3,4,5,445,412,195
962,38,244,793,978,185,36,40,735,769,34,0.0007147962830593281,0.0016338200755641784,766,866,100,3,3,3,5,8,363,386,64
963,70,70,810,810,0,220,220,907,907,0,0.00088498587426393,0.00088498587426393,775,775,0,-1,2,2,19,7,148,253,922
964,0,102,1,940,939,0,4,1,419,418,0.0,0.0007147962830593281,1,769,768,4,-1,5,2,0,757,778,399
965,0,0,1,1,0,0,0,1,1,0,0.0,0.0,1,1,0,-1,-1,-1,4,0,573,489,483
966,6,212,489,979,490,10,10,530,530,0,0.0,0.0006807583648184077,1,770,769,3,4,4,3,1,797,506,172
967,6,212,415,968,553,20,24,471,510,39,0.00017018959120460194,0.0008509479560230097,530,782,252,3,4,4,6,1,514,756,99
968,29,235,739,973,234,30,30,704,704,0,0.00030634126416828345,0.0006467204465774873,626,744,118,3,3,3,4,8,711,286,150
969,30,131,827,971,144,26,26,852,852,0,0.00037441710065012424,0.0004084550188910446,677,690,13,7,3,3,4,5,860,165,603
970,2,2,381,381,0,8,8,503,503,0,0.00010211375472276115,0.00010211375472276115,494,494,0,-1,5,5,4,1,860,322,514
971,43,249,771,966,195,48,56,627,671,44,0.0004084550188910446,0.0018720855032506212,670,874,204,3,3,3,9,10,306,366,42
972,0,0,1,1,0,0,0,1,1,0,0.0,0.0,1,1,0,-1,-1,-1,17,0,24,929,996
973,0,0,1,1,0,0,0,1,1,0,0.0,0.0,1,1,0,-1,-1,-1,5,0,724,917,330
974,134,134,909,909,0,110,110,869,869,0,0.0020082371762143027,0.0020082371762143027,877,877,0,-1,3,3,10,27,298,304,730
975,117,323,920,981,61,74,74,934,934,0,0.0053439531638245,0.00616086320160659,958,965,7,3,2,2,5,15,537,36,45
976,54,54,818,818,0,62,62,779,779,0,0.0007488342013002485,0.0007488342013002485,755,755,0,-1,3,3,7,13,340,217,901
977,8,109,566,947,381,12,12,604,604,0,0.0002042275094455223,0.0002042275094455223,582,582,0,6,4,4,2,4,761,278,460
978,6,108,496,947,451,8,8,520,520,0,0.0002042275094455223,0.00037441710065012424,588,675,87,4,4,4,2,3,947,260,86
979,25,127,740,946,206,20,20,587,587,0,0.0002723033459273631,0.00037441710065012424,606,659,53,4,4,4,4,7,424,389,586
980,22,22,646,646,0,52,52,623,623,0,0.00010211375472276115,0.00010211375472276115,475,475,0,-1,3,3,9,3,287,300,940
981,206,822,950,996,46,136,136,900,900,0,0.0022465026039007454,0.006262976956329351,892,968,76,2,3,3,11,34,167,89,51
982,0,616,1,995,994,0,23,1,564,563,0.0,0.0013955546478777359,1,842,841,2,-1,3,5,0,506,804,616
983,2,2,360,360,0,7,7,375,375,0,0.00010211375472276115,0.00010211375472276115,489,489,0,-1,5,5,5,1,766,899,542
984,2,2,364,364,0,3,3,365,365,0,3.4037918240920386e-05,3.4037918240920386e-05,401,401,0,-1,5,5,2,1,750,781,650
985,43,249,782,971,189,54,54,724,724,0,0.00030634126416828345,0.0018040096667687805,636,868,232,3,3,3,8,13,468,256,15
986,62,62,782,782,0,156,156,752,752,0,0.0009530617107457708,0.0009530617107457708,786,786,0,-1,3,3,20,9,61,414,538
987,6,6,398,398,0,23,23,408,408,0,0.0,0.0,1,1,0,-1,4,4,12,1,375,618,900
988,99,715,857,994,137,120,134,830,862,32,0.0013615167296368155,0.0026209197045508697,829,915,86,2,3,3,13,16,120,113,378
989,0,206,1,943,942,0,60,1,482,481,0.0,0.0005105687736138058,1,694,693,3,-1,4,21,0,2,665,306
990,11,217,587,970,383,18,18,647,647,0,0.00030634126416828345,0.004050512270669526,625,942,317,3,4,4,3,4,839,557,21
991,7,623,544,999,455,6,34,466,917,451,0.0002382654276864427,0.012730181422104225,606,986,380,2,5,3,3,4,899,504,23
992,0,101,1,943,942,0,2,1,331,330,0.0,0.00010211375472276115,1,480,479,5,-1,6,2,0,942,868,419
993,45,661,839,998,159,16,30,598,761,163,0.00034037918240920387,0.0061949011198475104,657,967,310,2,4,3,4,12,610,159,24
994,0,616,1,990,989,0,78,1,715,714,0.0,0.004595118962524252,1,954,953,2,-1,3,11,0,307,939,21
995,0,206,1,972,971,0,20,1,624,623,0.0,0.0011232513019503727,1,837,836,3,-1,4,4,2,706,775,281
996,24,230,730,975,245,36,36,755,755,0,0.000442492937131965,0.0008169100377820892,697,782,85,3,3,3,5,7,517,253,589
997,48,48,747,747,0,76,76,593,593,0,0.00034037918240920387,0.00034037918240920387,636,636,0,-1,3,3,15,10,49,262,804
998,81,183,883,966,83,38,38,845,845,0,0.0013615167296368155,0.0014295925661186562,847,851,4,4,3,3,3,17,989,269,762
999,0,206,1,975,974,0,8,1,481,480,0.0,0.0007488342013002485,1,766,765,3,-1,4,2,1,954,949,264
