,FreeNet_pre_score,FreeNet_post_score,FreeNet_pre_rank,FreeNet_post_rank,FreeNet_delta_ranks,Reversed_pre_score,Reversed_post_score,Reversed_pre_rank,Reversed_post_rank,Reversed_delta_ranks,Random_pre_score,Random_post_score,Random_pre_rank,Random_post_rank,Random_delta_ranks,dist_victim_relayer,dist_victim_vilain_pre,dist_victim_vilain_post,out_deg_victim,in_deg_villain,victim,villain,relayer
0,0,0,1,1,0,0,0,1,1,0,0.0,0.0,1,1,0,-1,-1,-1,9,0,191,860,943
1,0,206,1,968,967,0,17,1,512,511,0.0,0.0011913271384322134,1,832,831,3,-1,4,5,0,502,812,42
2,1,1,333,333,0,6,6,333,333,0,0.0,0.0,1,1,0,-1,7,7,6,1,441,765,821
3,2,208,366,974,608,5,10,398,514,116,6.807583648184077e-05,0.0020422750944552232,449,887,438,3,5,4,3,1,882,503,35
4,18,120,626,914,288,46,46,676,676,0,0.00034037918240920387,0.00034037918240920387,657,657,0,4,3,3,6,3,378,197,964
5,0,206,1,963,962,0,20,1,523,522,0.0,0.0007147962830593281,1,751,750,3,-1,4,4,0,410,975,294
6,30,30,640,640,0,95,95,568,568,0,0.0004084550188910446,0.0004084550188910446,667,667,0,-1,3,3,21,5,1,124,979
7,2,2,358,358,0,5,5,358,358,0,0.00013615167296368154,0.00013615167296368154,514,514,0,-1,5,5,4,2,516,615,982
8,0,101,1,885,884,0,10,1,331,330,0.0,0.0,1,1,0,6,-1,7,10,1,82,852,896
9,1,103,333,916,583,4,7,333,396,63,0.0,6.807583648184077e-05,1,459,458,4,6,5,4,2,512,344,727
10,5,106,541,969,428,4,4,470,470,0,0.0005105687736138058,0.0005105687736138058,735,735,0,5,5,5,2,4,866,450,544
11,0,0,1,1,0,0,0,1,1,0,0.0,0.0,1,1,0,-1,-1,-1,3,0,726,915,685
12,540,540,1000,1000,0,32,32,943,943,0,0.02117158514585248,0.02117158514585248,996,996,0,-1,3,3,2,157,742,2,775
13,1,207,333,956,623,7,34,333,569,236,0.0,0.001497668402600497,1,847,846,3,6,4,7,1,321,469,151
14,50,151,863,965,102,22,22,792,792,0,0.00176997174852786,0.00176997174852786,887,887,0,7,3,3,2,12,894,100,469
15,16,117,606,918,312,38,38,806,806,0,0.0002723033459273631,0.0002723033459273631,614,614,0,5,3,3,3,1,634,655,337
16,0,206,1,960,959,0,20,1,488,487,0.0,0.0015657442390823377,1,849,848,3,-1,4,6,0,393,574,104
17,0,0,1,1,0,0,0,1,1,0,0.0,0.0,1,1,0,-1,-1,-1,5,2,457,684,766
18,30,131,692,908,216,70,70,655,655,0,0.0002382654276864427,0.0002382654276864427,585,585,0,5,3,3,11,4,188,380,503
19,38,654,694,988,294,106,144,707,819,112,0.000442492937131965,0.008645631233193778,670,971,301,2,3,3,16,5,50,688,1
20,18,18,604,604,0,86,86,754,754,0,6.807583648184077e-05,6.807583648184077e-05,443,443,0,-1,3,3,12,3,93,263,546
21,0,0,1,1,0,0,0,1,1,0,0.0,0.0,1,1,0,-1,-1,-1,8,0,508,768,483
22,24,24,718,718,0,34,34,755,755,0,0.00037441710065012424,0.00037441710065012424,668,668,0,-1,3,3,4,3,709,280,633
23,20,20,597,597,0,54,54,516,516,0,0.0004765308553728854,0.0004765308553728854,690,690,0,-1,4,4,15,5,45,562,868
24,93,93,914,914,0,50,50,890,890,0,0.0027911092957554717,0.0027911092957554717,912,912,0,-1,3,3,5,21,557,123,922
25,14,116,605,927,322,14,14,532,532,0,0.0002042275094455223,0.0004084550188910446,584,693,109,4,4,4,3,3,737,677,115
26,7,213,535,975,440,14,14,579,579,0,0.00017018959120460194,0.00034037918240920387,553,663,110,3,4,4,3,2,826,101,168
27,53,259,890,991,101,12,12,716,716,0,0.001599782157323258,0.002552843868069029,870,910,40,3,4,4,2,17,985,180,189
28,0,206,1,968,967,0,12,1,483,482,0.0,0.00088498587426393,1,790,789,3,-1,4,4,0,655,942,219
29,0,102,1,886,885,0,9,1,354,353,0.0,3.4037918240920386e-05,1,404,403,4,-1,5,8,1,358,660,592
30,40,246,839,986,147,28,28,833,833,0,0.0011913271384322134,0.001497668402600497,829,863,34,3,3,3,3,11,600,83,683
31,14,116,611,928,317,26,26,603,603,0,0.00034037918240920387,0.00034037918240920387,668,668,0,4,4,4,5,4,616,637,623
32,53,53,818,818,0,68,68,774,774,0,0.001055175465468532,0.001055175465468532,798,798,0,-1,3,3,8,8,350,161,955
33,44,146,781,931,150,44,44,646,646,0,0.000442492937131965,0.0007488342013002485,668,772,104,4,3,3,7,7,209,422,697
34,62,62,817,817,0,76,76,715,715,0,0.0006467204465774873,0.0006467204465774873,737,737,0,-1,3,3,10,9,105,245,894
35,0,0,1,1,0,0,0,1,1,0,0.0,0.0,1,1,0,-1,-1,-1,5,0,695,858,820
36,0,206,1,946,945,0,23,1,400,399,0.0,0.00017018959120460194,1,542,541,3,-1,4,12,0,175,907,468
37,12,218,459,947,488,79,110,466,570,104,0.0,0.00034037918240920387,1,638,637,3,4,4,25,3,17,598,221
38,126,227,946,976,30,98,98,994,994,0,0.006297014874570271,0.006297014874570271,965,965,0,5,2,2,4,12,824,104,560
39,10,112,619,954,335,10,10,532,532,0,0.00030634126416828345,0.0005105687736138058,639,716,77,4,4,4,3,3,854,411,700
40,7,213,499,961,462,22,26,485,522,37,3.4037918240920386e-05,0.00017018959120460194,396,538,142,3,4,4,7,2,340,566,452
41,1,1,332,332,0,2,2,332,332,0,3.4037918240920386e-05,3.4037918240920386e-05,412,412,0,-1,6,6,2,2,897,842,740
42,6,212,413,964,551,16,22,420,463,43,0.00010211375472276115,0.0010892133837094523,482,812,330,3,4,4,7,1,193,537,109
43,55,157,876,971,95,12,12,645,645,0,0.0012594029749140542,0.00176997174852786,846,889,43,4,4,4,2,15,999,53,461
44,6,6,402,402,0,27,27,452,452,0,0.0,0.0,1,1,0,-1,4,4,10,1,105,878,953
45,8,109,518,922,404,18,18,595,595,0,0.00017018959120460194,0.00017018959120460194,554,554,0,6,4,4,3,2,892,770,603
46,0,0,1,1,0,0,0,1,1,0,0.0,0.0,1,1,0,-1,-1,-1,3,0,902,934,564
47,78,284,911,984,73,32,32,923,923,0,0.0018040096667687805,0.002382654276864427,890,913,23,3,3,3,2,19,779,144,589
48,18,224,576,950,374,78,78,567,567,0,0.0002723033459273631,0.0005446066918547262,607,707,100,3,4,4,17,4,24,637,435
49,6,108,388,879,491,35,35,417,417,0,6.807583648184077e-05,0.00010211375472276115,447,477,30,4,4,4,17,2,210,654,476
50,3,209,459,982,523,3,12,388,684,296,3.4037918240920386e-05,0.0028591851322373124,402,926,524,3,5,4,2,5,792,464,74
51,131,232,921,965,44,62,62,760,760,0,0.0017018959120460194,0.0017018959120460194,858,858,0,5,3,3,7,23,366,106,421
52,0,102,1,936,935,0,4,1,396,395,0.0,0.00013615167296368154,1,512,511,4,-1,5,2,0,849,908,391
53,6,107,480,940,460,14,14,601,601,0,0.00017018959120460194,0.00017018959120460194,544,544,0,5,4,4,3,2,683,223,225
54,19,121,732,956,224,8,8,534,534,0,0.0005786446100956465,0.0007828721195411688,745,791,46,4,4,4,2,5,684,591,199
55,27,27,781,781,0,20,20,642,642,0,0.00088498587426393,0.00088498587426393,791,791,0,-1,4,4,4,8,607,284,644
56,29,29,823,823,0,14,14,736,736,0,0.0010892133837094523,0.0010892133837094523,822,822,0,-1,4,4,3,15,918,138,699
57,0,0,1,1,0,0,0,1,1,0,0.0,0.0,1,1,0,-1,-1,-1,2,0,653,887,852
58,0,206,1,971,970,0,10,1,486,485,0.0,0.0016338200755641784,1,860,859,3,-1,4,3,0,620,696,44
59,9,215,597,979,382,16,16,607,607,0,3.4037918240920386e-05,0.0013274788113958951,410,843,433,3,4,4,4,3,480,248,61
60,36,36,752,752,0,62,62,701,701,0,0.00030634126416828345,0.00030634126416828345,621,621,0,-1,3,3,10,5,243,182,831
61,8,8,620,620,0,4,4,453,453,0,0.00017018959120460194,0.00017018959120460194,565,565,0,-1,5,5,2,6,847,229,725
62,0,101,1,915,914,0,4,1,332,331,0.0,6.807583648184077e-05,1,444,443,5,-1,6,4,3,444,478,585
63,2,103,353,880,527,24,24,396,396,0,0.00010211375472276115,0.00010211375472276115,467,467,0,5,5,5,14,1,130,931,509
64,0,0,1,1,0,0,0,1,1,0,0.0,0.0,1,1,0,-1,-1,-1,4,0,648,731,638
65,36,138,848,969,121,22,22,847,847,0,0.0012253650566731338,0.0016678579938050988,843,877,34,4,3,3,2,9,830,242,240
66,2,2,373,373,0,6,6,424,424,0,0.0,0.0,1,1,0,-1,5,5,3,1,745,555,980
67,6,6,498,498,0,12,12,609,609,0,0.00037441710065012424,0.00037441710065012424,670,670,0,-1,4,4,2,1,976,404,990
68,41,247,771,970,199,76,76,821,821,0,0.0005446066918547262,0.0009870996289866913,710,800,90,3,3,3,9,6,395,295,275
69,0,0,1,1,0,0,0,1,1,0,0.0,0.0,1,1,0,-1,-1,-1,11,0,139,888,742
70,4,4,406,406,0,12,12,384,384,0,0.00013615167296368154,0.00013615167296368154,500,500,0,-1,5,5,8,5,521,464,985
71,6,6,431,431,0,16,16,457,457,0,3.4037918240920386e-05,3.4037918240920386e-05,404,404,0,-1,4,4,6,1,587,837,641
72,16,16,571,571,0,38,38,544,544,0,6.807583648184077e-05,6.807583648184077e-05,454,454,0,-1,4,4,9,4,245,380,945
73,38,38,794,794,0,40,40,754,754,0,0.00088498587426393,0.00088498587426393,796,796,0,-1,3,3,5,9,773,415,707
74,14,116,628,945,317,20,20,663,663,0,0.00013615167296368154,0.0002042275094455223,521,574,53,4,4,4,4,3,610,280,609
75,49,151,829,956,127,44,44,838,838,0,0.0006467204465774873,0.0007147962830593281,757,768,11,4,3,3,4,8,453,187,504
76,2,104,349,873,524,20,25,349,369,20,0.0,0.0,1,1,0,4,5,5,19,1,46,437,290
77,3,104,478,971,493,3,3,402,402,0,0.0,3.4037918240920386e-05,1,404,403,5,5,5,2,3,898,631,509
78,118,219,940,976,36,48,48,946,946,0,0.0042547397801150485,0.0042547397801150485,948,948,0,5,3,3,3,29,337,142,274
79,0,0,1,1,0,0,0,1,1,0,0.0,0.0,1,1,0,-1,-1,-1,12,0,239,669,915
80,2,208,354,965,611,11,16,373,432,59,6.807583648184077e-05,0.0002042275094455223,446,564,118,3,5,4,8,1,270,687,652
81,0,102,1,887,886,0,24,1,383,382,0.0,0.0002042275094455223,1,561,560,4,-1,5,16,0,60,728,362
82,0,0,1,1,0,0,0,1,1,0,0.0,0.0,1,1,0,-1,-1,-1,8,0,454,367,664
83,2,2,365,365,0,4,4,393,393,0,0.00013615167296368154,0.00013615167296368154,518,518,0,-1,5,5,2,1,763,238,898
84,8,109,531,933,402,8,8,460,460,0,3.4037918240920386e-05,3.4037918240920386e-05,406,406,0,5,4,4,2,3,846,441,593
85,0,102,1,909,908,0,7,1,360,359,0.0,0.0,1,1,0,4,-1,5,6,0,455,514,878
86,0,102,1,914,913,0,7,1,362,361,0.0,0.00010211375472276115,1,483,482,4,-1,5,6,3,764,854,188
87,135,341,925,978,53,132,132,963,963,0,0.0037441710065012424,0.006297014874570271,937,964,27,3,2,2,8,15,142,206,27
88,2,2,347,347,0,26,26,397,397,0,0.0,0.0,1,1,0,-1,5,5,14,1,198,618,752
89,12,12,469,469,0,86,86,528,528,0,0.0002723033459273631,0.0002723033459273631,610,610,0,-1,4,4,21,4,54,239,966
90,6,107,484,938,454,14,14,589,589,0,3.4037918240920386e-05,0.00017018959120460194,411,545,134,5,4,4,3,1,433,152,724
91,60,162,813,933,120,72,72,693,693,0,0.0012934408931549745,0.0013615167296368155,821,831,10,4,3,3,11,10,163,413,549
92,7,109,535,944,409,6,6,418,418,0,0.0002382654276864427,0.0005105687736138058,616,723,107,4,5,5,3,6,699,459,46
93,1,1,332,332,0,3,3,332,332,0,0.0,0.0,1,1,0,-1,6,6,3,1,554,543,752
94,34,34,831,831,0,12,12,645,645,0,0.0010211375472276116,0.0010211375472276116,811,811,0,-1,4,4,2,14,999,243,701
95,0,206,1,971,970,0,15,1,451,450,0.0,0.0005105687736138058,1,706,705,3,-1,4,6,0,515,950,795
96,18,224,696,980,284,12,12,583,583,0,0.0005446066918547262,0.0009190237925048504,727,804,77,3,4,4,2,5,689,221,143
97,9,9,590,590,0,8,8,490,490,0,0.0002382654276864427,0.0002382654276864427,598,598,0,-1,4,4,2,5,689,710,588
98,400,400,989,989,0,48,48,904,904,0,0.009496579189216788,0.009496579189216788,981,981,0,-1,3,3,3,78,490,9,887
99,0,0,1,1,0,0,0,1,1,0,0.0,0.0,1,1,0,-1,-1,-1,8,0,308,884,962
100,50,152,808,942,134,42,42,629,629,0,0.00088498587426393,0.0011232513019503727,787,827,40,4,4,4,7,12,678,99,479
101,389,595,985,995,10,104,104,975,975,0,0.00966676878042139,0.009836958371625992,979,979,0,3,2,2,5,62,571,70,541
102,6,108,433,910,477,14,14,453,453,0,0.00010211375472276115,0.00034037918240920387,483,633,150,4,4,4,5,1,377,552,584
103,167,269,958,976,18,80,80,954,954,0,0.004152626025392287,0.004186663943633207,946,946,0,4,2,2,6,34,764,89,655
104,2,104,355,897,542,16,17,409,417,8,0.0,0.00010211375472276115,1,480,479,4,5,5,9,1,168,607,666
105,0,206,1,980,979,0,10,1,536,535,0.0,0.0018720855032506212,1,885,884,3,-1,4,3,0,798,963,112
106,0,206,1,963,962,0,16,1,428,427,0.0,0.00017018959120460194,1,538,537,3,-1,4,8,0,454,918,93
107,0,0,1,1,0,0,0,1,1,0,0.0,0.0,1,1,0,-1,-1,-1,17,0,210,522,813
108,10,216,518,958,440,38,46,531,601,70,0.00037441710065012424,0.002382654276864427,660,904,244,3,4,4,9,3,147,704,13
109,8,214,466,951,485,30,42,413,464,51,0.0,0.00030634126416828345,1,605,604,3,4,4,14,2,268,430,422
110,12,218,533,965,432,25,46,464,631,167,3.4037918240920386e-05,0.0053439531638245,406,960,554,3,4,4,9,2,395,547,24
111,15,15,638,638,0,14,14,512,512,0,0.0002042275094455223,0.0002042275094455223,573,573,0,-1,4,4,5,6,727,229,548
112,0,0,1,1,0,0,0,1,1,0,0.0,0.0,1,1,0,-1,-1,-1,3,0,627,678,867
113,0,102,1,912,911,0,6,1,359,358,0.0,0.00010211375472276115,1,473,472,4,-1,5,5,0,284,672,862
114,19,225,604,953,349,80,84,582,595,13,0.0002382654276864427,0.0005105687736138058,586,701,115,3,3,3,17,4,112,278,233
115,0,0,1,1,0,0,0,1,1,0,0.0,0.0,1,1,0,-1,-1,-1,4,0,652,800,942
116,30,132,674,906,232,80,80,631,631,0,0.0002723033459273631,0.0002723033459273631,606,606,0,4,3,3,13,9,165,341,578
117,2,2,368,368,0,5,5,393,393,0,6.807583648184077e-05,6.807583648184077e-05,463,463,0,-1,5,5,3,1,825,421,954
118,30,132,747,936,189,46,46,747,747,0,0.00037441710065012424,0.000442492937131965,662,691,29,4,3,3,6,4,587,259,317
119,76,282,853,976,123,88,88,862,862,0,0.0012594029749140542,0.0015317063208414173,832,855,23,3,3,3,8,13,420,255,256
120,16,222,581,968,387,24,32,493,557,64,0.0002382654276864427,0.000442492937131965,586,682,96,3,3,3,8,3,146,755,465
121,0,1640,1,1000,999,0,52,1,943,942,0.0,0.03979032642363593,1,997,996,1,-1,2,3,1,892,705,11
122,588,1188,994,1000,6,160,160,986,986,0,0.0141938119064638,0.018822968787228972,989,992,3,2,2,2,7,85,366,0,32
123,0,0,1,1,0,0,0,1,1,0,0.0,0.0,1,1,0,-1,-1,-1,2,0,769,897,815
124,0,206,1,985,984,0,9,1,572,571,0.0,0.002586881786309949,1,916,915,3,-1,4,3,0,668,330,72
125,0,206,1,978,977,0,14,1,593,592,0.0,0.0024507301133462676,1,911,910,3,-1,4,3,0,590,914,57
126,0,206,1,929,928,0,45,1,399,398,0.0,0.00010211375472276115,1,466,465,3,-1,4,24,0,28,702,785
127,2,104,389,968,579,3,4,397,522,125,0.0002042275094455223,0.0005786446100956465,591,742,151,4,5,5,2,2,933,357,294
128,16,16,769,769,0,8,8,644,644,0,0.0005446066918547262,0.0005446066918547262,740,740,0,-1,4,4,2,4,884,470,685
129,106,106,925,925,0,54,54,917,917,0,0.0020763130126961434,0.0020763130126961434,884,884,0,-1,3,3,4,17,659,96,515
130,6,108,490,947,457,6,6,453,453,0,3.4037918240920386e-05,0.0002723033459273631,407,626,219,4,5,5,3,4,871,156,519
131,30,30,776,776,0,36,36,755,755,0,0.0007828721195411688,0.0007828721195411688,776,776,0,-1,3,3,5,4,517,246,990
132,57,263,790,966,176,108,112,726,736,10,0.0010892133837094523,0.0020422750944552232,813,887,74,3,3,3,15,10,0,366,243
133,6,6,438,438,0,16,16,547,547,0,0.00017018959120460194,0.00017018959120460194,545,545,0,-1,4,4,4,1,783,110,938
134,18,224,631,965,334,28,32,540,576,36,0.0002382654276864427,0.0004765308553728854,600,698,98,3,4,4,8,8,541,521,182
135,10,112,618,952,334,8,8,520,520,0,0.0002382654276864427,0.0008509479560230097,612,793,181,4,4,4,2,4,817,645,294
136,0,0,1,1,0,0,0,1,1,0,0.0,0.0,1,1,0,-1,-1,-1,10,0,75,977,832
137,4,4,436,436,0,7,7,421,421,0,0.0,0.0,1,1,0,-1,5,5,4,3,610,598,815
138,0,0,1,1,0,0,0,1,1,0,0.0,0.0,1,1,0,-1,-1,-1,6,0,393,923,898
139,0,616,1,993,992,0,72,1,612,611,0.0,0.0013615167296368155,1,832,831,2,-1,3,15,0,138,867,226
140,0,101,1,890,889,0,7,1,331,330,0.0,0.0,1,1,0,5,-1,6,7,0,372,822,603
141,145,247,957,979,22,72,72,987,987,0,0.008441403723748256,0.008713707069675619,976,980,4,4,2,2,3,26,583,127,299
142,22,22,650,650,0,32,32,561,561,0,0.0005786446100956465,0.0005786446100956465,711,711,0,-1,3,3,7,2,182,523,789
143,144,744,909,994,85,190,190,903,903,0,0.0013615167296368155,0.0026209197045508697,827,910,83,2,2,2,16,12,145,179,54
144,0,206,1,958,957,0,40,1,596,595,0.0,0.0016338200755641784,1,863,862,3,-1,4,8,0,350,600,43
145,8,110,538,931,393,12,12,490,490,0,0.0002723033459273631,0.00037441710065012424,614,665,51,4,4,4,4,2,787,697,275
146,2,208,352,961,609,12,19,375,435,60,6.807583648184077e-05,0.0002382654276864427,443,587,144,3,5,4,8,1,201,543,280
147,31,133,753,940,187,32,32,657,657,0,0.0005105687736138058,0.0005446066918547262,714,724,10,4,4,4,6,11,237,162,885
148,0,616,1,998,997,0,32,1,738,737,0.0,0.0021784267674189047,1,892,891,2,-1,3,5,0,570,674,55
149,12,628,497,995,498,28,68,433,632,199,6.807583648184077e-05,0.00176997174852786,442,873,431,2,4,3,11,5,227,401,38
150,8,214,498,963,465,20,24,413,441,28,0.0,0.0008169100377820892,1,779,778,3,4,4,10,2,211,430,376
151,111,317,918,979,61,74,74,948,948,0,0.0026549576227917903,0.0030634126416828346,911,922,11,3,2,2,5,15,667,153,470
152,16,222,494,944,450,79,79,525,525,0,0.00010211375472276115,0.00013615167296368154,483,515,32,3,3,3,19,3,31,309,596
153,30,236,763,974,211,20,20,596,596,0,0.0005446066918547262,0.0014295925661186562,738,842,104,3,4,4,4,7,740,218,62
154,54,260,788,967,179,172,172,950,950,0,0.001497668402600497,0.0016338200755641784,836,850,14,3,2,2,12,5,183,412,424
155,75,176,904,972,68,28,28,806,806,0,0.0026549576227917903,0.0026549576227917903,915,915,0,6,3,3,3,18,814,141,181
156,0,102,1,931,930,0,4,1,392,391,0.0,0.00030634126416828345,1,643,642,4,-1,5,2,0,763,548,490
157,47,149,824,949,125,32,32,653,653,0,0.0007828721195411688,0.0008169100377820892,778,785,7,4,4,4,6,11,522,97,704
158,0,0,1,1,0,0,0,1,1,0,0.0,0.0,1,1,0,-1,-1,-1,4,0,304,900,909
159,0,0,1,1,0,0,0,1,1,0,0.0,0.0,1,1,0,-1,-1,-1,16,0,117,985,635
160,14,630,568,994,426,26,40,492,611,119,0.0002723033459273631,0.0012934408931549745,615,833,218,2,4,3,9,3,168,385,618
161,14,14,536,536,0,46,46,522,522,0,0.0002723033459273631,0.0002723033459273631,608,608,0,-1,4,4,13,6,185,447,901
162,12,628,694,1000,306,12,22,718,900,182,0.0007828721195411688,0.006297014874570271,792,972,180,2,4,3,2,4,810,40,134
163,6,6,423,423,0,24,24,530,530,0,0.00010211375472276115,0.00010211375472276115,477,477,0,-1,4,4,6,1,369,666,678
164,0,0,1,1,0,0,0,1,1,0,0.0,0.0,1,1,0,-1,-1,-1,3,0,814,811,783
165,18,119,641,929,288,25,25,578,578,0,0.0004084550188910446,0.000442492937131965,669,680,11,5,3,3,6,3,441,585,534
166,66,682,867,997,130,34,34,750,750,0,0.0011913271384322134,0.0026549576227917903,832,910,78,2,3,3,4,12,815,163,202
167,0,102,1,914,913,0,7,1,396,395,0.0,0.00017018959120460194,1,552,551,4,-1,5,4,0,512,786,451
168,0,101,1,926,925,0,4,1,331,330,0.0,3.4037918240920386e-05,1,394,393,5,-1,6,4,0,660,812,807
169,56,262,753,952,199,130,130,647,647,0,0.0005446066918547262,0.0005786446100956465,714,721,7,3,3,3,23,9,4,198,593
170,0,616,1,992,991,0,55,1,481,480,0.0,0.0010892133837094523,1,811,810,2,-1,3,17,0,103,849,389
171,8,8,544,544,0,16,16,538,538,0,0.00013615167296368154,0.00013615167296368154,512,512,0,-1,4,4,4,2,578,363,808
172,0,0,1,1,0,0,0,1,1,0,0.0,0.0,1,1,0,-1,-1,-1,13,1,90,948,950
173,0,206,1,960,959,0,14,1,447,446,0.0,0.0006126825283365669,1,735,734,3,-1,4,5,2,793,633,209
174,100,100,883,883,0,100,100,888,888,0,0.038394771775758195,0.038394771775758195,1000,1000,0,-1,1,1,9,98,422,23,844
175,30,236,785,977,192,28,28,800,800,0,0.0008169100377820892,0.0017018959120460194,780,872,92,3,3,3,3,5,912,338,120
176,206,308,972,984,12,62,62,964,964,0,0.012594029749140543,0.012594029749140543,989,989,0,4,2,2,3,44,672,27,238
177,30,236,780,978,198,28,28,743,743,0,0.00034037918240920387,0.0016338200755641784,656,869,213,3,3,3,3,4,484,259,95
178,0,0,1,1,0,0,0,1,1,0,0.0,0.0,1,1,0,-1,-1,-1,9,0,262,946,760
179,1,102,333,904,571,5,5,333,333,0,0.0,3.4037918240920386e-05,1,406,405,6,8,7,5,1,474,857,615
180,13,115,630,939,309,12,12,567,567,0,0.0004084550188910446,0.0007828721195411688,691,781,90,4,4,4,2,4,828,339,29
181,599,599,998,998,0,56,56,972,972,0,0.018857006705469893,0.018857006705469893,995,995,0,-1,2,2,2,127,586,11,917
182,28,130,737,930,193,40,40,649,649,0,0.00034037918240920387,0.00034037918240920387,651,651,0,4,4,4,8,13,318,256,285
183,0,102,1,944,943,0,4,1,400,399,0.0,0.00030634126416828345,1,638,637,4,-1,5,2,0,992,728,422
184,20,121,810,972,162,22,22,915,915,0,0.0010892133837094523,0.0010892133837094523,827,827,0,5,3,3,2,3,782,173,373
185,6,6,399,399,0,26,26,449,449,0,0.0,0.0,1,1,0,-1,4,4,9,2,100,662,817
186,0,102,1,924,923,0,6,1,383,382,0.0,0.00030634126416828345,1,641,640,4,-1,5,4,0,543,820,368
187,0,206,1,958,957,0,40,1,588,587,0.0,0.003437829742332959,1,932,931,3,-1,4,8,0,358,930,48
188,14,220,556,965,409,38,38,606,606,0,0.0002042275094455223,0.0007488342013002485,570,758,188,3,4,4,7,5,193,688,216
189,8,110,498,906,408,16,16,440,440,0,6.807583648184077e-05,0.00013615167296368154,438,500,62,4,4,4,6,2,514,680,829
190,2,208,368,976,608,5,12,369,516,147,0.0,0.0030293747234419145,1,919,918,3,5,4,4,2,794,615,126
191,6,108,398,889,491,44,44,480,480,0,0.00013615167296368154,0.00013615167296368154,512,512,0,4,4,4,14,2,144,714,337
192,9,9,522,522,0,40,40,540,540,0,0.00037441710065012424,0.00037441710065012424,659,659,0,-1,4,4,10,5,211,722,838
193,100,306,863,972,109,120,120,801,801,0,0.0013274788113958951,0.001497668402600497,838,852,14,3,3,3,14,15,130,92,504
194,14,14,597,597,0,22,22,552,552,0,0.0002042275094455223,0.0002042275094455223,575,575,0,-1,4,4,5,3,677,385,254
195,35,137,793,950,157,30,30,710,710,0,0.0005786446100956465,0.0006126825283365669,729,743,14,4,4,4,5,8,795,204,532
196,9,111,607,953,346,8,8,539,539,0,0.00013615167296368154,0.0010892133837094523,524,832,308,4,4,4,2,5,760,570,60
197,14,630,617,997,380,18,36,545,768,223,0.00017018959120460194,0.003199564314646516,550,924,374,2,4,3,5,4,765,625,58
198,34,34,780,780,0,34,34,738,738,0,0.0004084550188910446,0.0004084550188910446,681,681,0,-1,3,3,4,4,532,259,520
199,0,102,1,944,943,0,3,1,371,370,0.0,0.00010211375472276115,1,495,494,4,-1,5,2,0,548,798,260
200,99,200,875,950,75,94,94,834,834,0,0.002212464685659825,0.002212464685659825,894,894,0,8,3,3,9,18,123,63,448
201,2,208,366,973,607,6,18,367,538,171,0.0,0.0017018959120460194,1,872,871,3,5,4,5,2,848,721,55
202,0,102,1,885,884,0,11,1,360,359,0.0,0.00010211375472276115,1,472,471,4,-1,5,9,0,414,729,279
203,205,411,955,984,29,114,114,900,900,0,0.0030974505599237552,0.004322815616596889,922,945,23,3,3,3,9,31,274,35,180
204,12,12,576,576,0,22,22,574,574,0,0.0005446066918547262,0.0005446066918547262,717,717,0,-1,4,4,5,2,524,475,955
205,48,48,831,831,0,24,24,708,708,0,0.0010211375472276116,0.0010211375472276116,816,816,0,-1,3,3,3,10,471,272,982
206,15,117,684,952,268,18,18,695,695,0,0.0006807583648184077,0.001055175465468532,766,825,59,4,4,4,3,4,862,267,145
207,0,206,1,974,973,0,14,1,565,564,0.0,0.0026889955410327104,1,924,923,3,-1,4,3,0,901,587,98
208,0,102,1,959,958,0,5,1,438,437,0.0,0.0009190237925048504,1,802,801,4,-1,5,3,0,852,934,158
209,8,624,502,995,493,17,62,426,775,349,0.0,0.006909697402906838,1,971,970,2,4,3,7,3,417,598,6
210,18,18,709,709,0,20,20,805,805,0,0.00037441710065012424,0.00037441710065012424,665,665,0,-1,3,3,3,3,902,263,608
211,25,25,704,704,0,50,50,797,797,0,0.0010211375472276116,0.0010211375472276116,809,809,0,-1,3,3,5,4,390,207,701
212,0,206,1,943,942,0,52,1,506,505,0.0,0.0012594029749140542,1,826,825,3,-1,4,16,0,72,782,59
213,10,111,612,954,342,12,12,530,530,0,0.0002723033459273631,0.00030634126416828345,611,634,23,5,4,4,4,4,738,315,384
214,31,31,749,749,0,36,36,664,664,0,0.0006126825283365669,0.0006126825283365669,739,739,0,-1,4,4,6,10,275,195,752
215,54,54,857,857,0,34,34,790,790,0,0.0013615167296368155,0.0013615167296368155,842,842,0,-1,3,3,4,13,611,183,604
216,7,7,550,550,0,14,14,578,578,0,0.00030634126416828345,0.00030634126416828345,626,626,0,-1,4,4,3,2,288,101,815
217,6,622,388,991,603,38,80,423,566,143,0.0,0.0012253650566731338,1,832,831,2,4,3,17,2,39,885,352
218,0,0,1,1,0,0,0,1,1,0,0.0,0.0,1,1,0,-1,-1,-1,2,0,752,938,883
219,25,641,739,999,260,26,40,745,871,126,0.000442492937131965,0.006535280302256714,692,966,274,2,3,3,4,5,550,350,580
220,2,2,360,360,0,9,9,369,369,0,6.807583648184077e-05,6.807583648184077e-05,448,448,0,-1,5,5,7,3,400,755,798
221,0,102,1,930,929,0,8,1,426,425,0.0,3.4037918240920386e-05,1,404,403,4,-1,5,4,2,945,431,711
222,0,102,1,928,927,0,5,1,389,388,0.0,0.0005786446100956465,1,737,736,4,-1,5,3,0,861,918,204
223,0,206,1,957,956,0,16,1,425,424,0.0,0.0004765308553728854,1,701,700,3,-1,4,7,0,637,569,266
224,0,102,1,869,868,0,25,1,357,356,0.0,3.4037918240920386e-05,1,399,398,4,-1,5,21,1,54,947,441
225,0,102,1,876,875,0,20,1,372,371,0.0,0.0002723033459273631,1,596,595,4,-1,5,13,0,115,844,370
226,0,0,1,1,0,0,0,1,1,0,0.0,0.0,1,1,0,-1,-1,-1,5,0,719,980,644
227,2,2,361,361,0,4,4,363,363,0,6.807583648184077e-05,6.807583648184077e-05,464,464,0,-1,5,5,3,1,780,781,979
228,16,117,475,880,405,136,136,572,572,0,0.0002382654276864427,0.0002382654276864427,581,581,0,5,3,3,35,2,20,652,540
229,13,13,606,606,0,14,14,548,548,0,0.00034037918240920387,0.00034037918240920387,653,653,0,-1,4,4,3,3,743,536,996
230,32,648,678,990,312,108,118,741,771,30,0.0009190237925048504,0.0017018959120460194,786,865,79,2,3,3,15,2,81,475,327
231,19,121,773,969,196,8,8,583,583,0,0.0004084550188910446,0.0011913271384322134,705,843,138,4,4,4,2,6,751,275,71
232,5,106,536,965,429,4,4,452,452,0,0.0002042275094455223,0.0002042275094455223,580,580,0,5,5,5,2,4,810,208,788
233,66,272,783,957,174,168,168,727,727,0,0.0011913271384322134,0.0012253650566731338,819,821,2,3,2,2,23,6,8,516,260
234,0,101,1,961,960,0,2,1,331,330,0.0,3.4037918240920386e-05,1,401,400,5,-1,6,2,0,981,963,580
235,0,101,1,929,928,0,4,1,332,331,0.0,0.0,1,1,0,5,-1,6,4,0,891,880,761
236,0,616,1,998,997,0,28,1,767,766,0.0,0.006739507811702236,1,974,973,2,-1,3,3,0,651,915,30
237,16,118,666,944,278,8,8,478,478,0,0.0005446066918547262,0.0009190237925048504,727,807,80,4,4,4,2,4,931,246,121
238,0,102,1,916,915,0,5,1,382,381,0.0,0.00010211375472276115,1,488,487,4,-1,5,3,0,687,803,230
239,0,206,1,944,943,0,49,1,466,465,0.0,0.00034037918240920387,1,639,638,3,-1,4,17,0,10,520,189
240,2,2,358,358,0,8,8,378,378,0,3.4037918240920386e-05,3.4037918240920386e-05,396,396,0,-1,5,5,5,1,426,878,757
241,12,218,589,973,384,16,16,539,539,0,6.807583648184077e-05,0.00010211375472276115,441,485,44,3,4,4,4,2,513,468,493
242,32,134,694,912,218,112,112,828,828,0,0.0008509479560230097,0.0009870996289866913,779,795,16,4,3,3,12,4,212,143,318
243,2,208,361,966,605,6,14,362,465,103,6.807583648184077e-05,0.0007828721195411688,449,773,324,3,5,4,5,2,311,331,377
244,28,129,679,907,228,86,86,755,755,0,0.00034037918240920387,0.00034037918240920387,632,632,0,5,3,3,12,6,194,199,597
245,41,247,740,962,222,110,110,771,771,0,0.0007147962830593281,0.0011232513019503727,741,810,69,3,3,3,14,5,130,216,505
246,221,323,976,985,9,62,62,965,965,0,0.012185574730249497,0.012389802239695021,989,989,0,4,2,2,3,54,627,28,591
247,0,0,1,1,0,0,0,1,1,0,0.0,0.0,1,1,0,-1,-1,-1,12,0,239,228,908
248,61,61,835,835,0,68,68,819,819,0,0.0011232513019503727,0.0011232513019503727,819,819,0,-1,3,3,7,12,324,67,715
249,16,118,487,882,395,146,146,655,655,0,0.00017018959120460194,0.0002382654276864427,528,583,55,4,3,3,25,1,17,904,761
250,195,195,968,968,0,70,70,925,925,0,0.004356853534837809,0.004356853534837809,951,951,0,-1,3,3,5,36,662,48,892
251,9,111,577,937,360,12,12,492,492,0,0.00010211375472276115,0.0002042275094455223,483,582,99,4,4,4,5,3,695,485,797
252,4,210,440,973,533,5,13,383,554,171,6.807583648184077e-05,0.000442492937131965,462,697,235,3,5,4,3,5,833,401,338
253,12,628,480,989,509,57,132,469,707,238,0.00017018959120460194,0.004220701861874128,537,941,404,2,4,3,19,2,83,383,56
254,8,110,514,914,400,26,26,522,522,0,0.0002382654276864427,0.00030634126416828345,592,627,35,4,4,4,7,2,364,383,353
255,172,172,955,955,0,64,64,938,938,0,0.002586881786309949,0.002586881786309949,918,918,0,-1,3,3,4,33,504,15,938
256,143,349,941,981,40,56,56,803,803,0,0.002995336805200994,0.003880322679464924,922,946,24,3,3,3,6,28,345,41,83
257,0,616,1,997,996,0,28,1,687,686,0.0,0.001940161339732462,1,882,881,2,-1,3,5,0,519,866,153
258,603,603,998,998,0,104,104,993,993,0,0.019095272133156337,0.019095272133156337,994,994,0,-1,2,2,5,118,656,37,916
259,2,104,353,877,524,25,26,388,389,1,6.807583648184077e-05,0.0002042275094455223,435,558,123,4,5,5,15,1,49,853,680
260,5,106,499,952,453,6,6,439,439,0,0.00010211375472276115,0.00010211375472276115,492,492,0,7,5,5,3,3,798,369,703
261,1,207,332,982,650,2,8,332,547,215,0.0,0.0002723033459273631,1,627,626,3,6,4,2,3,792,748,282
262,0,0,1,1,0,0,0,1,1,0,0.0,0.0,1,1,0,-1,-1,-1,3,0,892,907,917
263,6,212,488,978,490,12,12,616,616,0,0.00037441710065012424,0.0007828721195411688,666,780,114,3,4,4,2,1,937,480,80
264,0,206,1,965,964,0,26,1,515,514,0.0,0.0013274788113958951,1,835,834,3,-1,4,7,0,398,723,117
265,10,216,506,958,452,70,70,615,615,0,0.00010211375472276115,0.0002042275094455223,475,559,84,3,4,4,15,4,110,617,840
266,1,1,333,333,0,4,4,333,333,0,0.0,0.0,1,1,0,-1,6,6,4,2,532,344,498
267,0,0,1,1,0,0,0,1,1,0,0.0,0.0,1,1,0,-1,-1,-1,2,0,967,205,664
268,69,69,905,905,0,32,32,956,956,0,0.004629156880765172,0.004629156880765172,958,958,0,-1,3,3,2,12,684,104,814
269,38,38,764,764,0,60,60,742,742,0,0.0006467204465774873,0.0006467204465774873,732,732,0,-1,3,3,9,7,339,169,856
270,20,121,675,933,258,30,30,708,708,0,0.0002382654276864427,0.0002382654276864427,595,595,0,5,3,3,4,4,453,501,337
271,0,206,1,977,976,0,10,1,492,491,0.0,0.0010892133837094523,1,820,819,3,-1,4,3,0,844,978,129
272,2,2,346,346,0,13,13,346,346,0,0.0,0.0,1,1,0,-1,5,5,12,1,183,140,205
273,0,0,1,1,0,0,0,1,1,0,0.0,0.0,1,1,0,-1,-1,-1,6,0,295,996,796
274,46,252,807,969,162,66,66,864,864,0,0.0016338200755641784,0.0018380475850097008,856,868,12,3,2,2,6,2,393,453,173
275,2,104,365,922,557,5,8,365,406,41,0.0,0.0002382654276864427,1,592,591,4,5,5,4,3,304,708,167
276,2,2,355,355,0,9,9,382,382,0,3.4037918240920386e-05,3.4037918240920386e-05,395,395,0,-1,5,5,6,1,255,530,728
277,0,102,1,891,890,0,10,1,351,350,0.0,0.00017018959120460194,1,544,543,4,-1,5,9,0,126,768,662
278,1,617,333,993,660,10,46,333,562,229,0.0,0.0016338200755641784,1,865,864,2,7,3,10,3,135,626,129
279,1,207,333,958,625,9,22,333,464,131,0.0,0.0006807583648184077,1,751,750,3,6,4,9,2,168,331,440
280,8,110,498,906,408,24,24,511,511,0,0.0002042275094455223,0.0004084550188910446,556,667,111,4,4,4,6,2,514,408,287
281,0,0,1,1,0,0,0,1,1,0,0.0,0.0,1,1,0,-1,-1,-1,3,0,707,673,774
282,1,102,333,913,580,6,6,333,333,0,0.0,6.807583648184077e-05,1,457,456,5,7,6,6,2,405,663,592
283,0,102,1,921,920,0,7,1,397,396,0.0,0.0005105687736138058,1,714,713,4,-1,5,4,0,753,959,295
284,16,222,565,958,393,74,74,725,725,0,0.0002382654276864427,0.0005786446100956465,590,721,131,3,3,3,9,1,351,667,198
285,0,102,1,891,890,0,11,1,361,360,0.0,0.0,1,1,0,4,-1,5,9,0,306,565,853
286,0,0,1,1,0,0,0,1,1,0,0.0,0.0,1,1,0,-1,-1,-1,3,0,640,905,875
287,0,0,1,1,0,0,0,1,1,0,0.0,0.0,1,1,0,-1,-1,-1,4,0,567,906,757
288,16,222,540,957,417,105,106,710,712,2,0.00017018959120460194,0.0011232513019503727,531,809,278,3,3,3,18,1,29,681,148
289,0,206,1,961,960,0,23,1,484,483,0.0,0.00030634126416828345,1,635,634,3,-1,4,8,0,468,356,288
290,169,169,933,933,0,162,162,945,945,0,0.0033016780693692774,0.0033016780693692774,930,930,0,-1,3,3,12,19,184,135,984
291,9,9,600,600,0,8,8,511,511,0,0.00010211375472276115,0.00010211375472276115,497,497,0,-1,4,4,2,3,838,347,941
292,6,622,414,994,580,17,31,445,567,122,0.00010211375472276115,0.0009870996289866913,474,796,322,2,4,3,7,2,324,597,508
293,0,0,1,1,0,0,0,1,1,0,0.0,0.0,1,1,0,-1,-1,-1,6,1,473,554,868
294,17,223,700,976,276,8,12,489,585,96,0.0002042275094455223,0.0015317063208414173,579,867,288,3,4,4,2,5,596,310,54
295,70,172,872,962,90,34,34,738,738,0,0.00088498587426393,0.0009870996289866913,798,813,15,4,3,3,4,18,304,148,385
296,0,102,1,934,933,0,5,1,368,367,0.0,0.00010211375472276115,1,485,484,4,-1,5,4,0,728,922,476
297,0,102,1,933,932,0,6,1,423,422,0.0,0.00034037918240920387,1,647,646,4,-1,5,3,0,615,900,616
298,0,0,1,1,0,0,0,1,1,0,0.0,0.0,1,1,0,-1,-1,-1,3,0,628,629,808
299,0,616,1,997,996,0,24,1,697,696,0.0,0.003914360597705844,1,945,944,2,-1,3,3,0,778,400,243
300,4,4,433,433,0,9,9,387,387,0,0.0,0.0,1,1,0,-1,5,5,6,2,399,298,796
301,1,207,333,978,645,2,8,333,513,180,0.0,0.0008509479560230097,1,787,786,3,9,4,2,1,924,647,207
302,1,207,333,948,615,12,51,333,556,223,0.0,0.0015657442390823377,1,846,845,3,6,4,12,3,183,181,98
303,0,206,1,970,969,0,16,1,518,517,0.0,0.0007828721195411688,1,778,777,3,-1,4,4,0,304,201,99
304,137,137,948,948,0,44,44,838,838,0,0.0034718676605738795,0.0034718676605738795,936,936,0,-1,3,3,4,31,453,102,800
305,10,10,608,608,0,10,10,513,513,0,0.00010211375472276115,0.00010211375472276115,502,502,0,-1,4,4,3,4,845,625,980
306,0,616,1,995,994,0,28,1,596,595,0.0,0.0013274788113958951,1,837,836,2,-1,3,6,0,606,372,507
307,82,184,894,969,75,48,48,918,918,0,0.0016678579938050988,0.001940161339732462,873,886,13,4,3,3,3,18,746,64,286
308,0,0,1,1,0,0,0,1,1,0,0.0,0.0,1,1,0,-1,-1,-1,5,0,616,773,705
309,34,136,706,908,202,62,62,652,652,0,0.0002723033459273631,0.00037441710065012424,603,646,43,4,3,3,10,9,205,341,378
310,146,146,915,915,0,132,132,860,860,0,0.0018720855032506212,0.0018720855032506212,872,872,0,-1,3,3,12,23,52,117,760
311,17,119,698,954,256,12,12,645,645,0,0.000442492937131965,0.0009530617107457708,688,804,116,4,4,4,2,7,999,303,471
312,0,101,1,912,911,0,2,1,331,330,0.0,6.807583648184077e-05,1,444,443,5,-1,6,2,0,905,922,799
313,2,208,372,973,601,10,14,443,504,61,0.0,0.0005105687736138058,1,700,699,3,5,4,5,1,580,840,482
314,4,4,430,430,0,7,7,398,398,0,6.807583648184077e-05,6.807583648184077e-05,447,447,0,-1,5,5,4,2,545,430,529
315,2,208,369,972,603,4,18,370,630,260,0.0,0.003948398515946765,1,943,942,3,5,4,3,2,923,679,31
316,0,0,1,1,0,0,0,1,1,0,0.0,0.0,1,1,0,-1,-1,-1,22,0,55,892,976
317,38,38,686,686,0,146,146,746,746,0,0.00037441710065012424,0.00037441710065012424,644,644,0,-1,3,3,19,3,89,173,674
318,0,206,1,947,946,0,24,1,388,387,0.0,0.00017018959120460194,1,546,545,3,-1,4,15,0,95,457,840
319,16,222,648,973,325,16,20,559,611,52,0.00017018959120460194,0.007352190340038803,549,974,425,3,4,4,4,6,611,368,0
320,0,0,1,1,0,0,0,1,1,0,0.0,0.0,1,1,0,-1,-1,-1,11,0,167,936,538
321,106,207,879,947,68,202,202,949,949,0,0.0032336022328874367,0.0032336022328874367,936,936,0,6,2,2,13,12,165,104,181
322,123,123,934,934,0,64,64,928,928,0,0.002927260968719153,0.002927260968719153,926,926,0,-1,3,3,4,20,762,95,963
323,102,102,886,886,0,154,154,951,951,0,0.002723033459273631,0.002723033459273631,916,916,0,-1,2,2,10,12,82,100,669
324,12,218,499,951,452,47,60,460,512,52,6.807583648184077e-05,0.0004084550188910446,447,670,223,3,4,4,17,3,112,585,535
325,10,10,603,603,0,10,10,535,535,0,0.00034037918240920387,0.00034037918240920387,655,655,0,-1,4,4,3,6,856,406,997
326,30,236,776,973,197,28,28,776,776,0,0.000442492937131965,0.0030293747234419145,691,919,228,3,3,3,3,6,935,381,51
327,100,100,868,868,0,100,100,702,702,0,0.012525953912658701,0.014261887742945642,984,992,8,2,1,1,15,21,95,157,166
328,44,250,725,958,233,100,108,684,728,44,0.0002042275094455223,0.0015657442390823377,558,854,296,3,3,3,16,4,72,259,45
329,0,0,1,1,0,0,0,1,1,0,0.0,0.0,1,1,0,-1,-1,-1,2,0,799,564,614
330,20,226,697,979,282,18,18,635,635,0,0.00034037918240920387,0.0012594029749140542,652,848,196,3,4,4,3,7,627,389,96
331,1,207,332,975,643,3,18,332,650,318,3.4037918240920386e-05,0.0026889955410327104,405,916,511,3,6,4,3,1,699,736,142
332,6,212,483,977,494,10,18,517,678,161,6.807583648184077e-05,0.002757071377514551,452,914,462,3,4,4,3,1,716,659,76
333,57,57,831,831,0,56,56,835,835,0,0.0010892133837094523,0.0010892133837094523,816,816,0,-1,3,3,6,13,606,255,903
334,0,206,1,977,976,0,14,1,565,564,0.0,0.0005786446100956465,1,736,735,3,-1,4,3,0,958,868,242
335,118,118,946,946,0,62,62,978,978,0,0.004969536063174376,0.004969536063174376,954,954,0,-1,2,2,3,19,670,144,784
336,0,206,1,976,975,0,10,1,508,507,0.0,0.0005446066918547262,1,723,722,3,-1,4,3,0,835,367,340
337,1,103,332,922,590,5,8,332,401,69,0.0,0.00013615167296368154,1,527,526,4,6,5,5,1,456,671,110
338,0,102,1,930,929,0,5,1,383,382,0.0,0.00030634126416828345,1,630,629,4,-1,5,3,0,842,751,217
339,0,0,1,1,0,0,0,1,1,0,0.0,0.0,1,1,0,-1,-1,-1,4,0,235,200,644
340,0,206,1,952,951,0,40,1,539,538,0.0,0.001055175465468532,1,807,806,3,-1,4,10,0,259,822,89
341,0,0,1,1,0,0,0,1,1,0,0.0,0.0,1,1,0,-1,-1,-1,7,0,658,937,863
342,0,0,1,1,0,0,0,1,1,0,0.0,0.0,1,1,0,-1,-1,-1,5,0,538,674,511
343,47,149,829,955,126,46,46,831,831,0,0.0016678579938050988,0.0020082371762143027,865,881,16,4,3,3,6,13,486,255,194
344,0,0,1,1,0,0,0,1,1,0,0.0,0.0,1,1,0,-1,-1,-1,21,0,13,423,796
345,0,101,1,933,932,0,3,1,331,330,0.0,0.0,1,1,0,6,-1,7,3,0,716,455,763
346,54,156,802,935,133,100,100,821,821,0,0.0007488342013002485,0.0007488342013002485,761,761,0,4,3,3,10,4,99,267,756
347,32,238,740,970,230,40,40,725,725,0,0.0007828721195411688,0.002314578440382586,769,896,127,3,3,3,5,6,793,471,151
348,366,366,975,975,0,284,284,980,980,0,0.006569318220497634,0.006569318220497634,960,960,0,-1,2,2,16,50,78,33,356
349,94,196,884,954,70,72,72,815,815,0,0.0011913271384322134,0.0012253650566731338,828,830,2,4,3,3,7,18,118,54,526
350,1,207,333,963,630,5,13,333,452,119,0.0,6.807583648184077e-05,1,465,464,3,8,4,5,1,531,647,667
351,0,0,1,1,0,0,0,1,1,0,0.0,0.0,1,1,0,-1,-1,-1,5,1,552,747,984
352,0,206,1,962,961,0,22,1,497,496,0.0,0.0005105687736138058,1,707,706,3,-1,4,7,0,505,921,207
353,54,670,742,991,249,168,226,738,850,112,0.0005446066918547262,0.00704584907587052,701,964,263,2,2,2,22,4,18,557,6
354,0,206,1,976,975,0,12,1,647,646,0.0,0.0005786446100956465,1,741,740,3,-1,4,2,0,910,993,211
355,2,208,353,948,595,15,35,354,447,93,0.0,0.000442492937131965,1,683,682,3,5,4,14,1,130,893,827
356,6,212,416,954,538,31,46,474,572,98,0.00034037918240920387,0.0007488342013002485,653,760,107,3,4,4,11,2,174,805,482
357,31,31,766,766,0,30,30,692,692,0,0.0007828721195411688,0.0007828721195411688,771,771,0,-1,4,4,5,8,565,284,702
358,7,108,562,956,394,12,12,658,658,0,0.0002723033459273631,0.00030634126416828345,630,650,20,5,4,4,2,3,686,354,623
359,1,103,332,926,594,2,3,332,366,34,0.0,6.807583648184077e-05,1,447,446,4,7,5,2,1,932,469,534
360,24,126,675,915,240,52,52,677,677,0,0.0005105687736138058,0.0005786446100956465,686,708,22,4,3,3,9,3,166,507,215
361,0,206,1,976,975,0,10,1,493,492,0.0,0.00030634126416828345,1,629,628,3,-1,4,4,0,553,276,465
362,0,0,1,1,0,0,0,1,1,0,0.0,0.0,1,1,0,-1,-1,-1,2,0,865,993,446
363,20,20,647,647,0,36,36,592,592,0,6.807583648184077e-05,6.807583648184077e-05,444,444,0,-1,4,4,8,8,454,477,936
364,0,0,1,1,0,0,0,1,1,0,0.0,0.0,1,1,0,-1,-1,-1,2,0,715,600,349
365,0,0,1,1,0,0,0,1,1,0,0.0,0.0,1,1,0,-1,-1,-1,5,0,546,426,932
366,6,108,456,931,475,11,11,465,465,0,6.807583648184077e-05,0.00034037918240920387,448,648,200,4,4,4,4,1,635,322,810
367,68,274,884,982,98,40,40,798,798,0,0.0012594029749140542,0.0019061234214915416,843,883,40,3,3,3,5,15,435,53,467
368,0,101,1,901,900,0,7,1,332,331,0.0,3.4037918240920386e-05,1,402,401,6,-1,7,7,0,170,819,708
369,36,242,723,951,228,154,154,875,875,0,0.0008509479560230097,0.0010892133837094523,773,814,41,3,3,3,14,6,332,471,229
370,0,102,1,927,926,0,7,1,420,419,0.0,0.00017018959120460194,1,544,543,4,-1,5,4,0,824,695,323
371,0,206,1,964,963,0,20,1,490,489,0.0,0.0012253650566731338,1,825,824,3,-1,4,6,0,549,744,297
372,0,616,1,990,989,0,80,1,668,667,0.0,0.003778208924742163,1,938,937,2,-1,3,13,0,185,970,50
373,40,656,687,990,303,210,220,854,869,15,0.0009870996289866913,0.0015657442390823377,799,851,52,2,3,3,20,6,5,490,103
374,0,0,1,1,0,0,0,1,1,0,0.0,0.0,1,1,0,-1,-1,-1,18,0,86,930,911
375,55,157,793,921,128,128,128,799,799,0,0.0006467204465774873,0.0007147962830593281,730,746,16,4,3,3,16,8,78,257,392
376,6,107,377,865,488,73,73,486,486,0,0.00010211375472276115,0.00010211375472276115,479,479,0,5,4,4,23,2,57,719,676
377,42,248,767,964,197,84,84,737,737,0,0.0004765308553728854,0.0015317063208414173,696,857,161,3,3,3,12,8,93,386,144
378,100,100,847,847,0,100,100,665,665,0,0.010109261717553355,0.010109261717553355,976,976,0,-1,1,1,16,3,132,580,991
379,13,13,547,547,0,56,56,619,619,0,0.00010211375472276115,0.00010211375472276115,486,486,0,-1,4,4,10,5,152,710,867
380,34,34,803,803,0,30,30,759,759,0,0.0007147962830593281,0.0007147962830593281,774,774,0,-1,3,3,4,8,682,186,929
381,0,102,1,946,945,0,3,1,368,367,0.0,0.00013615167296368154,1,529,528,4,-1,5,2,0,988,912,378
382,6,108,475,940,465,16,16,581,581,0,0.0002723033459273631,0.000442492937131965,627,696,69,4,4,4,4,2,811,652,464
383,0,102,1,882,881,0,14,1,354,353,0.0,6.807583648184077e-05,1,444,443,4,-1,5,12,0,194,905,648
384,0,101,1,915,914,0,4,1,329,328,0.0,3.4037918240920386e-05,1,398,397,5,-1,6,4,0,949,665,607
385,6,622,396,991,595,36,50,543,640,97,6.807583648184077e-05,0.0015317063208414173,436,865,429,2,4,3,8,1,483,666,335
386,23,23,756,756,0,18,18,794,794,0,0.00037441710065012424,0.00037441710065012424,670,670,0,-1,3,3,2,6,976,447,583
387,19,120,757,966,209,18,18,843,843,0,0.000442492937131965,0.000442492937131965,709,709,0,6,3,3,2,4,995,617,679
388,0,206,1,952,951,0,42,1,558,557,0.0,0.002212464685659825,1,898,897,3,-1,4,9,0,269,638,102
389,128,128,944,944,0,44,44,854,854,0,0.002382654276864427,0.002382654276864427,904,904,0,-1,3,3,4,28,384,98,502
390,2,2,358,358,0,4,4,360,360,0,3.4037918240920386e-05,3.4037918240920386e-05,393,393,0,-1,5,5,3,1,726,763,712
391,0,206,1,964,963,0,16,1,477,476,0.0,0.0012934408931549745,1,834,833,3,-1,4,6,0,606,930,87
392,0,206,1,946,945,0,42,1,497,496,0.0,0.001599782157323258,1,857,856,3,-1,4,11,0,162,699,171
393,2,2,357,357,0,13,13,357,357,0,6.807583648184077e-05,6.807583648184077e-05,442,442,0,-1,5,5,12,2,222,692,941
394,16,222,624,971,347,30,30,737,737,0,0.0004765308553728854,0.0020422750944552232,704,884,180,3,3,3,4,1,539,666,71
395,0,102,1,898,897,0,18,1,399,398,0.0,0.0002042275094455223,1,571,570,4,-1,5,10,0,293,871,191
396,0,616,1,997,996,0,24,1,599,598,0.0,0.001599782157323258,1,861,860,2,-1,3,5,0,616,881,212
397,19,121,722,948,226,18,18,671,671,0,0.0004084550188910446,0.0006126825283365669,681,741,60,4,4,4,3,6,590,381,840
398,32,134,826,961,135,12,12,715,715,0,0.0011913271384322134,0.0012934408931549745,839,846,7,4,4,4,2,14,684,190,549
399,17,119,693,947,254,44,44,894,894,0,0.0004084550188910446,0.0010211375472276116,674,807,133,4,3,3,4,2,553,101,186
400,0,0,1,1,0,0,0,1,1,0,0.0,0.0,1,1,0,-1,-1,-1,6,0,514,983,838
401,60,161,811,933,122,126,126,893,893,0,0.0018380475850097008,0.0018380475850097008,870,870,0,5,2,2,11,5,139,403,402
402,0,102,1,921,920,0,5,1,360,359,0.0,3.4037918240920386e-05,1,398,397,4,-1,5,4,0,885,538,810
403,120,326,900,976,76,130,130,903,903,0,0.0024507301133462676,0.0030974505599237552,898,924,26,3,2,2,11,18,215,148,289
404,40,246,711,961,250,96,96,638,638,0,0.000442492937131965,0.0009530617107457708,685,787,102,3,3,3,17,5,73,418,194
405,2,103,349,879,530,17,17,355,355,0,0.0,0.0,1,1,0,6,5,5,15,1,45,861,621
406,0,0,1,1,0,0,0,1,1,0,0.0,0.0,1,1,0,-1,-1,-1,3,0,867,898,940
407,46,662,770,993,223,70,90,699,779,80,0.000442492937131965,0.0031314884781646754,683,928,245,2,3,3,10,6,128,658,47
408,0,206,1,962,961,0,30,1,633,632,0.0,0.0034037918240920387,1,930,929,3,-1,4,5,1,426,235,31
409,29,235,696,960,264,68,72,656,677,21,0.000442492937131965,0.0011232513019503727,679,812,133,3,3,3,11,5,150,510,308
410,6,107,482,948,466,4,4,406,406,0,0.0002723033459273631,0.0002723033459273631,626,626,0,5,5,5,2,6,232,406,449
411,42,144,832,962,130,44,44,899,899,0,0.0016338200755641784,0.0017018959120460194,861,865,4,4,3,3,4,6,491,397,711
412,0,0,1,1,0,0,0,1,1,0,0.0,0.0,1,1,0,-1,-1,-1,4,0,794,978,565
413,2,2,360,360,0,4,4,361,361,0,0.0,0.0,1,1,0,-1,5,5,3,3,819,578,957
414,18,18,575,575,0,51,51,503,503,0,0.0002382654276864427,0.0002382654276864427,591,591,0,-1,4,4,14,4,85,319,979
415,28,234,782,980,198,32,32,907,907,0,0.0008509479560230097,0.0010211375472276116,791,818,27,3,3,3,2,5,926,221,556
416,0,102,1,914,913,0,6,1,402,401,0.0,0.0002042275094455223,1,567,566,4,-1,5,3,0,743,902,417
417,14,14,586,586,0,27,27,532,532,0,0.00017018959120460194,0.00017018959120460194,544,544,0,-1,4,4,8,3,323,677,961
418,78,179,923,977,54,28,28,858,858,0,0.0019061234214915416,0.0019061234214915416,887,887,0,5,3,3,3,20,911,109,687
419,0,206,1,937,936,0,64,1,456,455,0.0,0.0006467204465774873,1,714,713,3,-1,4,21,1,54,235,130
420,66,168,910,974,64,52,52,983,983,0,0.007658531604207087,0.007692569522448007,973,973,0,4,2,2,3,12,850,100,410
421,10,112,556,928,372,8,8,439,439,0,6.807583648184077e-05,0.0006807583648184077,438,756,318,4,4,4,2,3,893,596,264
422,6,108,396,900,504,56,56,602,602,0,0.0002042275094455223,0.0004765308553728854,564,694,130,4,4,4,12,3,93,260,722
423,0,102,1,958,957,0,3,1,381,380,0.0,0.000442492937131965,1,698,697,4,-1,5,2,0,878,729,113
424,12,12,542,542,0,42,42,591,591,0,0.0002723033459273631,0.0002723033459273631,610,610,0,-1,4,4,9,3,319,795,867
425,104,310,864,966,102,292,292,932,932,0,0.0020082371762143027,0.0028932230504782326,872,909,37,3,2,2,23,9,43,277,190
426,110,110,881,881,0,116,116,856,856,0,0.0020082371762143027,0.0020082371762143027,872,872,0,-1,3,3,11,17,307,269,950
427,18,18,615,615,0,30,30,519,519,0,0.00010211375472276115,0.00010211375472276115,482,482,0,-1,4,4,7,4,193,443,907
428,0,0,1,1,0,0,0,1,1,0,0.0,0.0,1,1,0,-1,-1,-1,4,0,513,984,811
429,32,32,707,707,0,52,52,592,592,0,0.00013615167296368154,0.00013615167296368154,514,514,0,-1,4,4,10,9,189,191,996
430,19,225,671,973,302,30,30,684,684,0,0.00034037918240920387,0.0011913271384322134,639,829,190,3,4,4,5,5,487,591,155
431,4,4,555,555,0,4,4,545,545,0,0.00010211375472276115,0.00010211375472276115,506,506,0,-1,5,5,2,3,775,704,684
432,23,229,622,954,332,46,50,469,484,15,0.00010211375472276115,0.0005105687736138058,483,688,205,3,3,3,16,5,50,274,296
433,23,23,688,688,0,40,40,704,704,0,0.0005105687736138058,0.0005105687736138058,719,719,0,-1,3,3,5,5,818,619,903
434,0,206,1,976,975,0,11,1,490,489,0.0,0.0007488342013002485,1,773,772,3,-1,4,4,0,679,801,658
435,2,103,411,976,565,3,3,433,433,0,0.0,0.0,1,1,0,6,5,5,2,1,973,540,748
436,18,18,623,623,0,50,50,682,682,0,0.0005446066918547262,0.0005446066918547262,716,716,0,-1,3,3,8,3,415,525,850
437,16,222,542,956,414,58,58,625,625,0,0.00013615167296368154,0.0002723033459273631,509,603,94,3,3,3,10,3,153,285,334
438,0,0,1,1,0,0,0,1,1,0,0.0,0.0,1,1,0,-1,-1,-1,25,0,17,872,533
439,17,17,664,664,0,16,16,598,598,0,0.0002723033459273631,0.0002723033459273631,623,623,0,-1,4,4,4,6,610,368,730
440,0,102,1,909,908,0,8,1,362,361,0.0,3.4037918240920386e-05,1,393,392,4,-1,5,6,0,369,672,347
441,6,6,464,464,0,18,18,653,653,0,0.00017018959120460194,0.00017018959120460194,562,562,0,-1,4,4,3,1,833,609,778
442,0,102,1,901,900,0,10,1,391,390,0.0,0.0002382654276864427,1,593,592,4,-1,5,6,0,536,587,245
443,1,102,332,920,588,4,4,332,332,0,0.0,0.0,1,1,0,6,6,6,4,3,758,460,656
444,9,9,595,595,0,8,8,479,479,0,6.807583648184077e-05,6.807583648184077e-05,455,455,0,-1,4,4,2,3,653,347,963
445,3,105,448,933,485,4,4,371,371,0,3.4037918240920386e-05,6.807583648184077e-05,405,461,56,4,5,5,3,2,729,547,694
446,16,222,573,961,388,52,52,724,724,0,0.0004765308553728854,0.0018380475850097008,683,879,196,3,3,3,7,1,209,759,89
447,121,121,907,907,0,108,108,915,915,0,0.003437829742332959,0.003437829742332959,935,935,0,-1,2,2,9,11,414,166,822
448,0,102,1,898,897,0,15,1,412,411,0.0,0.0004765308553728854,1,702,701,4,-1,5,8,0,418,966,250
449,28,644,648,992,344,84,118,592,724,132,0.00017018959120460194,0.0029612988869600733,537,917,380,2,3,3,16,4,42,567,74
450,100,100,876,876,0,100,100,885,885,0,0.018482589604819768,0.01865277919602437,992,993,1,3,1,1,9,5,208,355,541
451,8,624,484,993,509,29,78,455,722,267,0.00010211375472276115,0.005922597773920147,473,965,492,2,4,3,11,3,230,761,18
452,33,135,841,972,131,14,14,669,669,0,0.00088498587426393,0.0009530617107457708,803,813,10,4,4,4,3,15,883,138,586
453,2,208,362,967,605,10,14,424,488,64,6.807583648184077e-05,0.0006126825283365669,457,739,282,3,5,4,5,1,552,659,295
454,0,206,1,957,956,0,18,1,401,400,0.0,3.4037918240920386e-05,1,397,396,3,-1,4,9,0,263,976,718
455,13,13,529,529,0,24,24,426,426,0,0.0,0.0,1,1,0,-1,4,4,10,5,135,274,839
456,96,198,929,973,44,34,34,900,900,0,0.0025188059498281084,0.0026549576227917903,912,914,2,4,3,3,3,27,770,61,262
457,94,196,905,968,63,56,56,891,891,0,0.0021784267674189047,0.002280540522141666,896,899,3,4,3,3,5,23,662,122,547
458,17,17,641,641,0,28,28,595,595,0,0.00030634126416828345,0.00030634126416828345,623,623,0,-1,4,4,6,6,575,467,939
459,60,266,849,977,128,40,40,783,783,0,0.0012253650566731338,0.0014295925661186562,835,849,14,3,3,3,5,12,478,99,134
460,8,214,582,979,397,7,12,534,670,136,6.807583648184077e-05,0.005888559855679227,460,967,507,3,4,4,2,3,998,411,70
461,6,107,440,924,484,24,24,637,637,0,0.0002042275094455223,0.0002042275094455223,577,577,0,6,4,4,4,1,460,474,640
462,81,183,857,946,89,100,100,874,874,0,0.0012934408931549745,0.0013274788113958951,827,827,0,4,3,3,10,15,437,137,357
463,0,102,1,922,921,0,7,1,381,380,0.0,0.0002042275094455223,1,561,560,4,-1,5,5,0,291,890,634
464,0,206,1,971,970,0,12,1,446,445,0.0,0.00037441710065012424,1,649,648,3,-1,4,4,0,822,971,266
465,60,266,814,963,149,80,80,742,742,0,0.00088498587426393,0.001599782157323258,783,858,75,3,3,3,10,9,206,293,630
466,0,0,1,1,0,0,0,1,1,0,0.0,0.0,1,1,0,-1,-1,-1,2,1,283,949,806
467,28,644,685,992,307,42,86,565,794,229,0.0002382654276864427,0.007692569522448007,579,971,392,2,3,3,10,5,355,314,24
468,792,792,998,998,0,206,206,995,995,0,0.017869907076483203,0.017869907076483203,992,992,0,-1,2,2,9,127,278,11,826
469,16,632,530,992,462,59,86,511,607,96,6.807583648184077e-05,0.0015657442390823377,447,850,403,2,3,3,17,1,112,531,155
470,94,94,867,867,0,90,90,758,758,0,0.0017359338302869397,0.0017359338302869397,872,872,0,-1,3,3,10,13,285,42,806
471,0,0,1,1,0,0,0,1,1,0,0.0,0.0,1,1,0,-1,-1,-1,2,0,653,844,372
472,22,638,749,999,250,8,18,500,784,284,0.000442492937131965,0.003778208924742163,706,942,236,2,4,3,2,10,983,262,281
473,0,101,1,904,903,0,6,1,330,329,0.0,0.0,1,1,0,7,-1,8,6,0,498,511,582
474,24,230,680,967,287,40,48,669,711,42,0.0005446066918547262,0.0024507301133462676,713,902,189,3,3,3,7,4,364,637,13
475,66,272,891,985,94,18,18,731,731,0,0.0022465026039007454,0.0030974505599237552,907,931,24,3,4,4,3,22,683,128,272
476,22,123,686,928,242,36,36,705,705,0,0.0004084550188910446,0.0005446066918547262,675,714,39,5,3,3,5,4,438,149,22
477,19,120,648,909,261,36,36,686,686,0,0.00034037918240920387,0.00037441710065012424,646,661,15,5,3,3,5,4,793,287,935
478,0,0,1,1,0,0,0,1,1,0,0.0,0.0,1,1,0,-1,-1,-1,5,0,695,922,984
479,12,113,620,942,322,8,8,478,478,0,0.0006126825283365669,0.0006126825283365669,740,740,0,5,4,4,2,2,931,473,331
480,42,658,756,994,238,84,84,721,721,0,0.00037441710065012424,0.0031314884781646754,661,924,263,2,3,3,12,6,96,199,98
481,0,102,1,930,929,0,4,1,366,365,0.0,0.00017018959120460194,1,552,551,4,-1,5,3,0,712,699,452
482,214,830,966,999,33,110,110,965,965,0,0.0051397256543789785,0.01317267435923619,957,989,32,2,2,2,6,32,369,26,0
483,768,974,996,1000,4,222,222,969,969,0,0.012219612648490419,0.013649205214609075,983,988,5,3,2,2,13,96,90,1,60
484,36,36,747,747,0,102,102,846,846,0,0.0007828721195411688,0.0007828721195411688,767,767,0,-1,3,3,11,9,176,145,874
485,0,616,1,988,987,0,158,1,587,586,0.0,0.001055175465468532,1,806,805,2,-1,3,33,0,9,707,60
486,0,102,1,883,882,0,15,1,349,348,0.0,0.00010211375472276115,1,477,476,4,-1,5,14,0,172,778,476
487,44,44,834,834,0,30,30,745,745,0,0.00088498587426393,0.00088498587426393,791,791,0,-1,4,4,5,13,695,120,854
488,28,130,701,922,221,42,42,630,630,0,0.00017018959120460194,0.0002382654276864427,543,589,46,4,3,3,8,5,380,688,196
489,54,260,834,974,140,46,46,792,792,0,0.0005786446100956465,0.0017359338302869397,726,871,145,3,3,3,6,14,582,387,79
490,17,17,693,693,0,28,28,805,805,0,0.0010211375472276116,0.0010211375472276116,819,819,0,-1,3,3,3,3,564,559,757
491,0,206,1,956,955,0,20,1,446,445,0.0,0.0005105687736138058,1,697,696,3,-1,4,8,0,236,919,150
492,2,103,367,928,561,4,4,368,368,0,3.4037918240920386e-05,0.00010211375472276115,406,490,84,5,5,5,3,1,627,543,531
493,316,522,984,995,11,88,88,980,980,0,0.009224275843289425,0.009394465434494027,980,981,1,3,2,2,4,49,784,16,541
494,23,23,757,757,0,14,14,598,598,0,0.000442492937131965,0.000442492937131965,706,706,0,-1,4,4,3,8,530,386,818
495,0,102,1,947,946,0,4,1,416,415,0.0,0.0012594029749140542,1,851,850,4,-1,5,2,0,999,773,94
496,0,101,1,888,887,0,11,1,332,331,0.0,6.807583648184077e-05,1,437,436,5,-1,6,11,0,333,698,771
497,44,44,826,826,0,40,40,822,822,0,0.0009870996289866913,0.0009870996289866913,820,820,0,-1,3,3,4,4,542,167,731
498,0,206,1,950,949,0,38,1,472,471,0.0,0.0008169100377820892,1,763,762,3,-1,4,13,2,129,684,327
499,0,206,1,964,963,0,12,1,448,447,0.0,0.000442492937131965,1,675,674,3,-1,4,4,0,391,372,246
500,42,42,744,744,0,75,75,657,657,0,0.0009870996289866913,0.0009870996289866913,801,801,0,-1,2,2,13,2,185,599,897
501,26,232,741,973,232,34,38,667,731,64,0.0005105687736138058,0.0010211375472276116,710,819,109,3,3,3,6,6,253,424,124
502,189,290,965,980,15,74,74,957,957,0,0.004901460226692535,0.004901460226692535,958,958,0,5,2,2,5,37,765,74,342
503,1,1,331,331,0,3,3,331,331,0,0.0,0.0,1,1,0,-1,6,6,3,2,915,331,877
504,19,121,706,948,242,18,18,658,658,0,0.0002042275094455223,0.00034037918240920387,583,663,80,4,4,4,3,7,588,115,666
505,17,119,661,935,274,18,18,589,589,0,0.0005786446100956465,0.0009870996289866913,738,812,74,4,4,4,3,7,819,170,376
506,0,101,1,969,968,0,2,1,330,329,0.0,6.807583648184077e-05,1,456,455,5,-1,6,2,0,782,866,385
507,7,213,513,970,457,8,14,449,540,91,0.0,0.0002042275094455223,1,571,570,3,4,4,3,5,703,225,199
508,156,362,939,978,39,118,118,927,927,0,0.0019741992579733825,0.0026549576227917903,887,913,26,3,2,2,9,20,147,109,99
509,0,102,1,951,950,0,3,1,382,381,0.0,0.0002042275094455223,1,593,592,4,-1,5,2,0,897,906,691
510,182,284,965,980,15,48,48,900,900,0,0.004731270635487933,0.00527587732734266,950,958,8,4,3,3,3,27,737,25,440
511,0,206,1,988,987,0,8,1,588,587,0.0,0.002144388849177984,1,907,906,3,-1,4,2,0,481,488,105
512,0,0,1,1,0,0,0,1,1,0,0.0,0.0,1,1,0,-1,-1,-1,36,0,16,773,854
513,14,220,673,980,307,14,14,630,630,0,0.00037441710065012424,0.00176997174852786,677,880,203,3,4,4,3,7,642,134,174
514,174,174,970,970,0,32,32,916,916,0,0.005241839409101739,0.005241839409101739,957,957,0,-1,3,3,2,36,849,48,445
515,0,0,1,1,0,0,0,1,1,0,0.0,0.0,1,1,0,-1,-1,-1,6,1,470,814,359
516,0,102,1,891,890,0,14,1,398,397,0.0,0.0004084550188910446,1,666,665,4,-1,5,7,0,296,979,198
517,136,136,959,959,0,32,32,907,907,0,0.004322815616596889,0.004322815616596889,950,950,0,-1,3,3,2,29,907,17,920
518,0,0,1,1,0,0,0,1,1,0,0.0,0.0,1,1,0,-1,-1,-1,4,0,652,883,713
519,0,102,1,949,948,0,4,1,428,427,0.0,0.0013615167296368155,1,858,857,4,-1,5,2,0,895,942,91
520,24,24,745,745,0,27,27,718,718,0,0.00030634126416828345,0.00030634126416828345,631,631,0,-1,3,3,5,4,685,202,859
521,1,1,332,332,0,3,3,332,332,0,0.0,0.0,1,1,0,-1,7,7,3,1,600,972,949
522,40,142,828,960,132,40,43,961,961,0,0.010960209673576363,0.011198475101262807,986,986,0,4,2,2,3,1,674,742,441
523,6,107,402,893,491,68,68,633,633,0,0.00030634126416828345,0.00030634126416828345,637,637,0,7,4,4,12,2,222,493,582
524,22,228,650,965,315,68,68,771,771,0,0.00088498587426393,0.001055175465468532,785,811,26,3,3,3,8,2,428,475,408
525,0,0,1,1,0,0,0,1,1,0,0.0,0.0,1,1,0,-1,-1,-1,8,0,201,908,600
526,0,101,1,894,893,0,7,1,331,330,0.0,0.0,1,1,0,7,-1,8,7,0,678,881,663
527,27,129,759,946,187,26,26,747,747,0,0.0005446066918547262,0.0006126825283365669,716,735,19,4,3,3,4,7,787,303,452
528,29,131,709,924,215,38,38,552,552,0,0.0004765308553728854,0.0006126825283365669,699,736,37,4,4,4,9,7,422,176,653
529,2,104,367,929,562,8,8,436,436,0,0.00013615167296368154,0.0002382654276864427,528,604,76,4,5,5,4,1,706,797,476
530,0,0,1,1,0,0,0,1,1,0,0.0,0.0,1,1,0,-1,-1,-1,7,0,450,836,635
531,0,102,1,920,919,0,4,1,382,381,0.0,0.0004084550188910446,1,674,673,4,-1,5,2,0,909,901,154
532,36,242,769,972,203,26,26,623,623,0,0.0005446066918547262,0.0009190237925048504,710,794,84,3,4,4,5,13,457,217,417
533,10,10,600,600,0,6,6,418,418,0,0.0002042275094455223,0.0002042275094455223,582,582,0,-1,5,5,3,7,699,188,502
534,44,146,806,944,138,30,30,656,656,0,0.0007488342013002485,0.0009190237925048504,782,806,24,4,4,4,5,12,382,159,259
535,0,0,1,1,0,0,0,1,1,0,0.0,0.0,1,1,0,-1,-1,-1,15,2,138,271,533
536,9,9,542,542,0,26,26,606,606,0,0.00010211375472276115,0.00010211375472276115,497,497,0,-1,4,4,5,5,677,395,951
537,0,0,1,1,0,0,0,1,1,0,0.0,0.0,1,1,0,-1,-1,-1,14,0,198,970,888
538,22,22,618,618,0,92,92,670,670,0,0.00013615167296368154,0.00013615167296368154,499,499,0,-1,3,3,14,3,154,505,758
539,2,104,357,907,550,12,13,395,407,12,0.0,0.00010211375472276115,1,483,482,4,5,5,7,2,505,597,231
540,6,6,389,389,0,26,26,416,416,0,0.0,0.0,1,1,0,-1,4,4,12,1,62,687,828
541,14,220,544,953,409,48,48,636,636,0,0.0002723033459273631,0.000442492937131965,613,686,73,3,4,4,8,4,483,501,637
542,47,148,849,963,114,32,32,883,883,0,0.0009190237925048504,0.0009190237925048504,806,806,0,6,3,3,2,11,828,52,140
543,0,0,1,1,0,0,0,1,1,0,0.0,0.0,1,1,0,-1,-1,-1,6,0,630,643,483
544,0,101,1,942,941,0,2,1,330,329,0.0,0.0,1,1,0,6,-1,7,2,0,983,744,402
545,0,1640,1,1000,999,0,54,1,642,641,0.0,0.010211375472276116,1,979,978,1,-1,2,9,0,140,981,274
546,3,3,459,459,0,4,4,419,419,0,0.00010211375472276115,0.00010211375472276115,492,492,0,-1,5,5,2,3,897,631,228
547,1258,1359,999,999,0,528,528,1000,1000,0,0.017427414139351238,0.017495489975833077,994,994,0,5,2,2,21,127,12,11,703
548,9,9,562,562,0,20,20,615,615,0,0.00017018959120460194,0.00017018959120460194,555,555,0,-1,4,4,4,5,593,722,960
549,0,0,1,1,0,0,0,1,1,0,0.0,0.0,1,1,0,-1,-1,-1,9,0,269,330,730
550,0,102,1,956,955,0,5,1,419,418,0.0,0.000442492937131965,1,682,681,4,-1,5,3,0,922,845,658
551,7,109,479,888,409,20,20,401,401,0,0.0,0.0,1,1,0,4,4,4,10,3,272,563,506
552,6,6,430,430,0,14,14,439,439,0,0.00010211375472276115,0.00010211375472276115,493,493,0,-1,4,4,6,1,402,555,956
553,48,254,817,973,156,34,34,712,712,0,0.0010211375472276116,0.001055175465468532,809,812,3,3,3,3,4,9,509,242,222
554,0,0,1,1,0,0,0,1,1,0,0.0,0.0,1,1,0,-1,-1,-1,7,0,170,702,959
555,0,206,1,960,959,0,17,1,435,434,0.0,0.0006467204465774873,1,736,735,3,-1,4,7,0,340,356,535
556,6,212,398,953,555,26,30,456,475,19,0.0002042275094455223,0.0009530617107457708,569,798,229,3,4,4,9,1,159,862,387
557,19,120,805,975,170,8,8,657,657,0,0.0004765308553728854,0.0005786446100956465,726,760,34,5,4,4,2,11,813,52,121
558,91,297,911,982,71,22,22,757,757,0,0.002280540522141666,0.003914360597705844,904,943,39,3,3,3,2,22,763,203,13
559,8,109,533,924,391,11,11,462,462,0,0.00013615167296368154,0.00013615167296368154,519,519,0,5,4,4,4,5,784,231,896
560,0,206,1,966,965,0,15,1,434,433,0.0,0.00030634126416828345,1,629,628,3,-1,4,6,0,470,833,52
561,26,26,731,731,0,32,32,718,718,0,0.00030634126416828345,0.00030634126416828345,625,625,0,-1,3,3,5,4,407,164,905
562,6,212,394,949,555,48,48,542,542,0,3.4037918240920386e-05,0.000442492937131965,404,688,284,3,4,4,12,1,183,958,312
563,40,40,750,750,0,60,60,692,692,0,0.0006467204465774873,0.0006467204465774873,731,731,0,-1,3,3,9,9,178,240,513
564,34,136,752,932,180,30,30,622,622,0,0.00034037918240920387,0.0004084550188910446,656,686,30,4,4,4,5,10,818,262,208
565,156,772,945,999,54,100,100,955,955,0,0.0040845501889104465,0.006297014874570271,947,967,20,2,2,2,6,23,489,122,261
566,7,108,593,967,374,18,18,781,781,0,0.0002382654276864427,0.00030634126416828345,619,661,42,5,4,4,3,2,853,323,718
567,0,101,1,880,879,0,10,1,332,331,0.0,0.0,1,1,0,6,-1,7,10,0,125,698,181
568,33,134,718,914,196,54,54,611,611,0,0.00037441710065012424,0.00037441710065012424,658,658,0,5,3,3,10,9,99,191,580
569,10,10,556,556,0,10,10,454,454,0,0.00013615167296368154,0.00013615167296368154,508,508,0,-1,4,4,3,4,930,332,632
570,38,140,774,936,162,56,56,808,808,0,0.0009190237925048504,0.0010211375472276116,785,805,20,4,3,3,6,6,441,658,247
571,66,66,857,857,0,50,50,814,814,0,0.001497668402600497,0.001497668402600497,848,848,0,-1,3,3,5,14,531,190,806
572,12,218,535,960,425,30,30,520,520,0,0.0002042275094455223,0.0006467204465774873,574,747,173,3,4,4,7,2,372,549,407
573,0,0,1,1,0,0,0,1,1,0,0.0,0.0,1,1,0,-1,-1,-1,5,0,294,821,502
574,0,0,1,1,0,0,0,1,1,0,0.0,0.0,1,1,0,-1,-1,-1,8,0,225,356,962
575,0,0,1,1,0,0,0,1,1,0,0.0,0.0,1,1,0,-1,-1,-1,8,0,646,826,635
576,0,0,1,1,0,0,0,1,1,0,0.0,0.0,1,1,0,-1,-1,-1,2,0,666,836,845
577,10,111,541,922,381,14,14,470,470,0,6.807583648184077e-05,0.00010211375472276115,454,491,37,5,4,4,5,3,773,704,552
578,26,128,791,961,170,22,22,818,818,0,0.0007828721195411688,0.001055175465468532,778,816,38,4,3,3,2,4,919,207,450
579,6,212,433,967,534,14,23,442,547,105,3.4037918240920386e-05,0.0008509479560230097,397,784,387,3,4,4,6,1,295,807,120
580,12,113,537,922,385,30,30,549,549,0,6.807583648184077e-05,6.807583648184077e-05,454,454,0,5,4,4,8,3,468,196,344
581,0,616,1,991,990,0,80,1,591,590,0.0,0.00176997174852786,1,877,876,2,-1,3,15,1,51,650,471
582,0,0,1,1,0,0,0,1,1,0,0.0,0.0,1,1,0,-1,-1,-1,2,0,799,928,849
583,83,289,870,978,108,46,46,729,729,0,0.0018380475850097008,0.0023486163586235067,866,900,34,3,3,3,6,18,393,63,125
584,6,212,390,950,560,78,82,572,589,17,0.00030634126416828345,0.0004084550188910446,627,668,41,3,4,4,17,2,73,670,282
585,6,212,411,957,546,27,48,483,618,135,6.807583648184077e-05,0.003948398515946765,449,936,487,3,4,4,10,2,243,648,21
586,10,112,671,971,300,12,12,731,731,0,0.0007147962830593281,0.0009190237925048504,771,805,34,4,4,4,2,3,959,616,80
587,0,0,1,1,0,0,0,1,1,0,0.0,0.0,1,1,0,-1,-1,-1,3,0,844,911,966
588,84,84,922,922,0,22,22,824,824,0,0.0023486163586235067,0.0023486163586235067,908,908,0,-1,3,3,2,20,910,94,502
589,0,102,1,928,927,0,3,1,370,369,0.0,0.00017018959120460194,1,555,554,4,-1,5,2,0,752,629,617
590,12,12,605,605,0,17,17,532,532,0,6.807583648184077e-05,6.807583648184077e-05,452,452,0,-1,4,4,5,3,647,290,991
591,0,101,1,896,895,0,8,1,332,331,0.0,0.0,1,1,0,5,-1,6,8,0,595,864,460
592,0,0,1,1,0,0,0,1,1,0,0.0,0.0,1,1,0,-1,-1,-1,5,0,467,446,909
593,3,3,407,407,0,4,4,360,360,0,0.0,0.0,1,1,0,-1,5,5,3,5,731,605,604
594,58,160,867,960,93,52,52,960,960,0,0.003812246842983083,0.003880322679464924,932,933,1,4,2,2,3,4,935,220,369
595,56,56,731,731,0,236,236,740,740,0,0.0002723033459273631,0.0002723033459273631,597,597,0,-1,3,3,35,8,20,417,783
596,0,0,1,1,0,0,0,1,1,0,0.0,0.0,1,1,0,-1,-1,-1,6,0,526,686,968
597,0,102,1,929,928,0,6,1,421,420,0.0,0.0014295925661186562,1,861,860,4,-1,5,3,0,729,875,151
598,14,220,509,956,447,66,66,531,531,0,0.00017018959120460194,0.0002042275094455223,536,562,26,3,4,4,17,3,73,378,452
599,68,68,865,865,0,56,56,961,961,0,0.003437829742332959,0.003437829742332959,934,934,0,-1,2,2,2,5,769,338,864
600,14,115,619,936,317,16,16,550,550,0,0.0002042275094455223,0.0002382654276864427,570,595,25,5,4,4,4,3,891,385,781
601,1,1,333,333,0,6,6,333,333,0,0.0,0.0,1,1,0,-1,8,8,6,1,560,857,235
602,758,964,993,995,2,416,416,993,993,0,0.010687906327649,0.010721944245889922,982,982,0,3,2,2,20,78,5,9,370
603,77,77,848,848,0,112,112,853,853,0,0.00088498587426393,0.00088498587426393,787,787,0,-1,3,3,11,7,230,176,980
604,76,76,855,855,0,96,96,916,916,0,0.00176997174852786,0.00176997174852786,868,868,0,-1,2,2,7,9,591,415,641
605,6,6,374,374,0,32,32,371,371,0,0.0,0.0,1,1,0,-1,4,4,23,3,30,676,912
606,101,101,936,936,0,22,22,893,893,0,0.0029612988869600733,0.0029612988869600733,928,928,0,-1,3,3,2,27,283,61,884
607,0,206,1,951,950,0,26,1,455,454,0.0,0.00030634126416828345,1,631,630,3,-1,4,9,3,159,753,505
608,41,247,850,984,134,22,22,838,838,0,0.002314578440382586,0.002586881786309949,910,916,6,3,3,3,2,13,702,255,432
609,6,108,480,943,463,12,12,521,521,0,3.4037918240920386e-05,0.00017018959120460194,407,544,137,4,4,4,4,2,553,532,266
610,8,8,503,503,0,13,13,424,424,0,0.00017018959120460194,0.00017018959120460194,539,539,0,-1,4,4,5,3,818,646,520
611,72,173,896,972,76,52,52,970,970,0,0.005956635692161067,0.005956635692161067,965,965,0,7,2,2,3,9,814,242,857
612,22,22,786,786,0,8,8,571,571,0,0.00017018959120460194,0.00017018959120460194,549,549,0,-1,4,4,2,8,995,286,780
613,6,212,459,971,512,12,18,470,550,80,0.0,0.000442492937131965,1,693,692,3,4,4,5,1,843,506,221
614,65,271,803,965,162,196,196,823,823,0,0.001157289220191293,0.0012253650566731338,827,833,6,3,2,2,21,9,12,293,840
615,1,207,332,979,647,2,7,332,505,173,0.0,0.0005446066918547262,1,721,720,3,6,4,2,1,960,671,771
616,16,117,661,938,277,34,34,794,794,0,0.00034037918240920387,0.00037441710065012424,650,669,19,5,3,3,4,1,635,394,503
617,2,104,361,927,566,6,6,398,398,0,0.0,0.00017018959120460194,1,551,550,4,5,5,3,2,834,719,770
618,0,616,1,990,989,0,110,1,763,762,0.0,0.0038462847612240037,1,939,938,2,-1,3,14,2,21,709,77
619,19,120,626,912,286,42,42,634,634,0,0.000442492937131965,0.000442492937131965,668,668,0,5,4,4,7,5,209,591,298
620,0,0,1,1,0,0,0,1,1,0,0.0,0.0,1,1,0,-1,-1,-1,8,0,244,970,999
621,6,622,419,992,573,14,33,401,564,163,0.0,0.0006467204465774873,1,734,733,2,4,3,8,1,380,736,168
622,36,242,838,981,143,34,34,929,929,0,0.0010211375472276116,0.002212464685659825,817,901,84,3,3,3,3,8,840,417,43
623,8,624,508,996,488,30,48,547,713,166,6.807583648184077e-05,0.004765308553728854,440,957,517,2,4,3,7,3,398,434,32
624,0,0,1,1,0,0,0,1,1,0,0.0,0.0,1,1,0,-1,-1,-1,3,0,712,868,787
625,0,206,1,943,942,0,31,1,396,395,0.0,0.00010211375472276115,1,481,480,3,-1,4,16,0,42,388,468
626,0,0,1,1,0,0,0,1,1,0,0.0,0.0,1,1,0,-1,-1,-1,4,0,344,936,457
627,2,104,370,944,574,4,4,401,401,0,3.4037918240920386e-05,0.000442492937131965,400,693,293,4,5,5,2,1,992,481,375
628,52,258,831,976,145,40,40,785,785,0,0.0020763130126961434,0.0026209197045508697,889,910,21,3,3,3,5,11,502,193,403
629,87,188,952,986,34,22,22,893,893,0,0.003642057251778481,0.003710133088260322,945,948,3,5,3,3,2,31,788,35,442
630,8,624,505,996,491,36,68,554,744,190,0.00013615167296368154,0.00707988699411144,519,974,455,2,4,3,8,4,225,270,6
631,0,0,1,1,0,0,0,1,1,0,0.0,0.0,1,1,0,-1,-1,-1,15,0,104,723,472
632,18,120,666,924,258,40,40,649,649,0,0.00030634126416828345,0.000442492937131965,643,689,46,4,4,4,8,5,318,688,550
633,34,34,780,780,0,44,44,835,835,0,0.0008169100377820892,0.0008169100377820892,791,791,0,-1,3,3,4,4,444,470,488
634,0,0,1,1,0,0,0,1,1,0,0.0,0.0,1,1,0,-1,-1,-1,8,0,646,926,513
635,2,103,387,960,573,4,4,453,453,0,0.0,3.4037918240920386e-05,1,407,406,5,5,5,2,1,847,606,492
636,0,206,1,956,955,0,32,1,526,525,0.0,0.0012594029749140542,1,826,825,3,-1,4,8,0,428,975,255
637,0,206,1,948,947,0,31,1,412,411,0.0,0.0005105687736138058,1,707,706,3,-1,4,15,0,68,865,284
638,0,101,1,872,871,0,17,1,331,330,0.0,0.0,1,1,0,5,-1,6,17,0,23,956,656
639,14,220,656,979,323,8,8,503,503,0,0.00030634126416828345,0.0006126825283365669,637,740,103,3,4,4,2,6,747,229,619
640,467,467,990,990,0,132,132,966,966,0,0.010075223799312433,0.010075223799312433,981,981,0,-1,2,2,8,75,199,24,926
641,0,0,1,1,0,0,0,1,1,0,0.0,0.0,1,1,0,-1,-1,-1,9,0,316,986,742
642,0,0,1,1,0,0,0,1,1,0,0.0,0.0,1,1,0,-1,-1,-1,2,1,914,472,906
643,12,114,483,886,403,76,76,562,562,0,0.00017018959120460194,0.0002042275094455223,530,555,25,4,4,4,18,2,86,425,441
644,105,311,947,989,42,32,32,922,922,0,0.003199564314646516,0.00442492937131965,933,950,17,3,3,3,2,33,469,15,125
645,17,119,644,930,286,23,24,629,631,2,0.0002723033459273631,0.0005446066918547262,615,714,99,4,3,3,5,3,284,631,805
646,2,104,365,934,569,8,8,479,479,0,0.0002042275094455223,0.0002382654276864427,576,606,30,4,5,5,4,2,827,648,654
647,11,11,546,546,0,27,27,497,497,0,0.0002723033459273631,0.0002723033459273631,619,619,0,-1,4,4,8,4,420,315,542
648,70,171,951,989,38,22,22,946,946,0,0.00442492937131965,0.00442492937131965,956,956,0,7,3,3,2,32,956,26,640
649,96,198,929,976,47,22,22,837,837,0,0.0022465026039007454,0.0023486163586235067,903,908,5,4,3,3,2,27,906,61,474
650,0,102,1,905,904,0,11,1,386,385,0.0,0.00037441710065012424,1,674,673,4,-1,5,7,0,510,833,376
651,0,102,1,926,925,0,9,1,402,401,0.0,0.000442492937131965,1,695,694,4,-1,5,6,1,486,874,414
652,6,107,518,954,436,8,8,544,544,0,3.4037918240920386e-05,3.4037918240920386e-05,400,400,0,5,4,4,2,2,781,325,924
653,266,266,976,976,0,96,96,992,992,0,0.009564655025698629,0.009564655025698629,982,982,0,-1,2,2,3,50,490,33,672
654,0,616,1,997,996,0,30,1,746,745,0.0,0.008305252050784574,1,976,975,2,-1,3,4,0,520,836,33
655,32,238,643,945,302,140,144,673,683,10,0.0005105687736138058,0.0016338200755641784,699,861,162,3,3,3,23,2,4,473,78
656,1,207,333,971,638,5,22,333,592,259,0.0,0.0016338200755641784,1,863,862,3,6,4,5,1,601,671,91
657,14,220,761,994,233,4,8,498,656,158,0.0004084550188910446,0.002382654276864427,700,906,206,3,5,4,2,9,813,211,141
658,2,208,367,972,605,8,20,418,587,169,3.4037918240920386e-05,0.0027911092957554717,401,920,519,3,5,4,4,2,397,419,34
659,6,6,386,386,0,38,38,423,423,0,0.0,0.0,1,1,0,-1,4,4,18,1,111,743,912
660,22,124,647,921,274,62,62,798,798,0,0.0008509479560230097,0.0010211375472276116,778,807,29,4,3,3,7,3,170,610,240
661,87,87,927,927,0,22,22,843,843,0,0.0033016780693692774,0.0033016780693692774,934,934,0,-1,3,3,2,26,942,127,975
662,0,101,1,930,929,0,4,1,330,329,0.0,0.0,1,1,0,7,-1,8,4,1,573,660,703
663,61,267,888,986,98,12,12,645,645,0,0.0013615167296368155,0.007794683277170768,863,977,114,3,4,4,2,20,999,109,1
664,0,102,1,911,910,0,6,1,361,360,0.0,3.4037918240920386e-05,1,403,402,4,-1,5,5,0,667,927,694
665,14,220,630,974,344,26,26,644,644,0,0.0004084550188910446,0.0007828721195411688,682,771,89,3,4,4,5,3,848,616,169
666,136,136,911,911,0,128,128,883,883,0,0.002382654276864427,0.002382654276864427,900,900,0,-1,2,2,12,13,183,42,668
667,4,106,456,946,490,4,4,400,400,0,0.00017018959120460194,0.0002723033459273631,546,628,82,4,5,5,2,2,761,499,468
668,8,8,516,516,0,13,13,438,438,0,0.00013615167296368154,0.00013615167296368154,520,520,0,-1,4,4,6,3,267,411,999
669,8,8,541,541,0,15,15,563,563,0,0.00017018959120460194,0.00017018959120460194,550,550,0,-1,4,4,5,3,727,196,991
670,0,0,1,1,0,0,0,1,1,0,0.0,0.0,1,1,0,-1,-1,-1,4,0,759,669,673
671,0,616,1,991,990,0,34,1,476,475,0.0,0.0007147962830593281,1,749,748,2,-1,3,12,0,292,987,395
672,0,101,1,931,930,0,3,1,332,331,0.0,0.0004084550188910446,1,685,684,5,-1,6,3,0,579,776,198
673,6,108,428,911,483,26,26,533,533,0,3.4037918240920386e-05,0.0002042275094455223,411,570,159,4,4,4,7,1,497,718,435
674,16,116,672,939,267,18,18,664,664,0,0.0007488342013002485,0.0007147962830593281,766,758,-8,4,4,4,3,4,712,470,305
675,1,1,333,333,0,11,11,333,333,0,0.0,0.0,1,1,0,-1,6,6,11,2,234,344,800
676,99,99,902,902,0,50,50,830,830,0,0.002314578440382586,0.002314578440382586,894,894,0,-1,3,3,5,21,604,157,864
677,1,617,333,993,660,7,54,333,761,428,0.0,0.0033357159876101976,1,935,934,2,6,3,7,2,346,739,41
678,0,101,1,920,919,0,3,1,332,331,0.0,3.4037918240920386e-05,1,400,399,5,-1,6,3,1,585,742,464
679,0,101,1,910,909,0,5,1,332,331,0.0,0.0,1,1,0,5,-1,6,5,0,406,808,734
680,0,102,1,979,978,0,3,1,457,456,0.0,0.00034037918240920387,1,672,671,4,-1,5,2,0,952,731,258
681,14,220,625,976,351,16,20,529,586,57,6.807583648184077e-05,0.0002723033459273631,439,625,186,3,4,4,4,3,495,307,408
682,28,234,662,959,297,54,62,574,606,32,0.00030634126416828345,0.0005105687736138058,623,703,80,3,3,3,12,6,292,247,453
683,2,2,348,348,0,16,16,355,355,0,0.0,0.0,1,1,0,-1,5,5,14,2,122,331,388
684,0,102,1,954,953,0,6,1,477,476,0.0,0.0017359338302869397,1,882,881,4,-1,5,3,3,875,854,13
685,6,107,551,965,414,12,12,718,718,0,0.0002723033459273631,0.0002723033459273631,624,624,0,6,4,4,2,1,810,168,563
686,0,206,1,970,969,0,21,1,567,566,0.0,0.0013274788113958951,1,839,838,3,-1,4,5,0,644,793,203
687,62,268,861,979,118,50,50,842,842,0,0.0009870996289866913,0.0010892133837094523,820,829,9,3,3,3,5,9,314,130,458
688,4,105,398,897,499,8,8,387,387,0,0.00013615167296368154,0.00013615167296368154,517,517,0,5,5,5,4,3,503,646,708
689,49,49,900,900,0,22,22,888,888,0,0.0026549576227917903,0.0026549576227917903,927,927,0,-1,3,3,2,20,481,87,919
690,102,308,940,988,48,28,28,814,814,0,0.002723033459273631,0.003880322679464924,918,944,26,3,3,3,3,28,699,44,71
691,2,103,353,908,555,7,7,371,371,0,6.807583648184077e-05,0.00017018959120460194,457,556,99,5,5,5,5,3,438,708,384
692,413,619,980,990,10,360,360,989,989,0,0.006399128629293032,0.006603356138738555,961,961,0,3,2,2,19,31,48,76,253
693,16,222,586,967,381,26,30,518,552,34,0.00010211375472276115,0.00034037918240920387,474,646,172,3,3,3,7,1,324,265,417
694,0,102,1,930,929,0,5,1,371,370,0.0,0.0,1,1,0,4,-1,5,4,0,607,845,563
695,6,622,400,992,592,29,51,427,545,118,0.0,0.0008169100377820892,1,776,775,2,4,3,13,1,97,807,375
696,6,212,390,952,562,25,31,411,440,29,0.0,0.0004765308553728854,1,692,691,3,4,4,12,1,87,606,386
697,82,288,837,964,127,236,236,938,938,0,0.003199564314646516,0.0035059055788147996,928,936,8,3,2,2,17,6,24,73,165
698,16,118,609,919,310,52,52,733,733,0,0.00088498587426393,0.0009530617107457708,783,795,12,4,3,3,7,1,658,612,395
699,2,104,361,917,556,6,7,376,389,13,3.4037918240920386e-05,0.00013615167296368154,391,519,128,4,5,5,4,1,235,931,487
700,0,206,1,929,928,0,51,1,412,411,0.0,0.0002382654276864427,1,579,578,3,-1,4,24,0,28,932,454
701,2,2,349,349,0,12,12,372,372,0,3.4037918240920386e-05,3.4037918240920386e-05,402,402,0,-1,5,5,9,3,177,466,554
702,51,152,911,977,66,22,22,916,916,0,0.0030974505599237552,0.0030974505599237552,939,939,0,5,3,3,2,15,987,36,595
703,36,36,765,765,0,78,78,880,880,0,0.0010211375472276116,0.0010211375472276116,798,798,0,-1,3,3,7,6,359,289,620
704,0,101,1,956,955,0,2,1,330,329,0.0,0.0,1,1,0,5,-1,6,2,0,996,915,576
705,2,2,371,371,0,4,4,397,397,0,6.807583648184077e-05,6.807583648184077e-05,453,453,0,-1,5,5,2,1,886,552,546
706,4,106,393,890,497,20,22,389,401,12,0.00013615167296368154,0.00034037918240920387,508,637,129,4,5,5,11,5,150,401,454
707,1,1,333,333,0,3,3,333,333,0,0.0,0.0,1,1,0,-1,9,9,3,1,613,647,992
708,1,1,333,333,0,9,9,333,333,0,0.0,0.0,1,1,0,-1,6,6,9,1,327,671,611
709,0,0,1,1,0,0,0,1,1,0,0.0,0.0,1,1,0,-1,-1,-1,9,0,166,533,951
710,42,144,838,956,118,48,48,942,942,0,0.002110350930937064,0.002212464685659825,896,902,6,4,2,2,3,3,712,505,536
711,6,1646,375,1000,625,55,94,427,538,111,6.807583648184077e-05,0.005003573981415297,428,950,522,1,4,2,22,1,33,334,557
712,126,227,905,955,50,106,106,804,804,0,0.0020763130126961434,0.0020763130126961434,892,892,0,5,3,3,11,23,66,122,893
713,12,12,565,565,0,34,34,607,607,0,0.0002382654276864427,0.0002382654276864427,595,595,0,-1,4,4,7,4,335,149,855
714,146,146,932,932,0,158,158,973,973,0,0.0033357159876101976,0.0033357159876101976,931,931,0,-1,2,2,9,17,180,81,928
715,0,616,1,993,992,0,30,1,495,494,0.0,0.0007488342013002485,1,770,769,2,-1,3,9,0,263,872,622
716,167,167,925,925,0,214,214,942,942,0,0.0032336022328874367,0.0032336022328874367,923,923,0,-1,2,2,16,18,78,82,946
717,6,108,441,910,469,14,15,440,453,13,0.0,0.0,1,1,0,4,4,4,7,2,722,495,360
718,16,118,606,918,312,25,26,525,525,0,0.0009190237925048504,0.0009190237925048504,791,791,0,4,3,3,8,1,449,736,566
719,106,106,893,893,0,56,56,759,759,0,0.0016338200755641784,0.0016338200755641784,861,861,0,-1,3,3,6,14,378,146,971
720,4,4,418,418,0,8,8,375,375,0,0.0,0.0,1,1,0,-1,5,5,6,2,455,547,574
721,10,112,700,973,273,4,4,467,467,0,0.0005446066918547262,0.0007488342013002485,737,787,50,4,5,5,2,6,941,194,453
722,24,24,715,715,0,16,16,492,492,0,0.0004765308553728854,0.0004765308553728854,707,707,0,-1,4,4,4,8,445,386,436
723,6,212,395,951,556,28,56,414,537,123,0.0,0.0006126825283365669,1,732,731,3,4,4,14,2,47,518,355
724,2,104,357,917,560,9,9,395,395,0,0.0,3.4037918240920386e-05,1,395,394,4,5,5,5,1,247,853,463
725,18,119,718,954,236,12,12,609,609,0,0.0008169100377820892,0.0008509479560230097,794,801,7,5,4,4,2,7,976,224,320
726,44,250,748,958,210,84,84,631,631,0,0.0005786446100956465,0.0008509479560230097,709,777,68,3,3,3,14,6,127,258,343
727,0,0,1,1,0,0,0,1,1,0,0.0,0.0,1,1,0,-1,-1,-1,9,0,274,976,588
728,2,2,355,355,0,17,17,410,410,0,0.00010211375472276115,0.00010211375472276115,482,482,0,-1,5,5,9,2,180,313,713
729,22,228,627,955,328,72,72,710,710,0,0.0005105687736138058,0.0007147962830593281,707,754,47,3,3,3,10,3,206,795,29
730,2,2,371,371,0,5,5,391,391,0,6.807583648184077e-05,6.807583648184077e-05,454,454,0,-1,5,5,3,1,831,601,712
731,66,168,873,967,94,24,24,681,681,0,0.001599782157323258,0.001940161339732462,861,874,13,4,4,4,4,19,617,144,490
732,14,116,593,924,331,22,22,564,564,0,0.00013615167296368154,0.00037441710065012424,501,646,145,4,4,4,5,4,457,230,450
733,0,206,1,975,974,0,14,1,529,528,0.0,0.001157289220191293,1,824,823,3,-1,4,5,0,695,985,281
734,10,216,553,970,417,11,11,450,450,0,6.807583648184077e-05,0.0002723033459273631,443,618,175,3,4,4,4,4,949,443,223
735,15,15,714,714,0,14,14,672,672,0,0.00037441710065012424,0.00037441710065012424,661,661,0,-1,4,4,3,7,786,115,989
736,0,0,1,1,0,0,0,1,1,0,0.0,0.0,1,1,0,-1,-1,-1,9,0,381,426,533
737,0,102,1,898,897,0,11,1,375,374,0.0,0.00030634126416828345,1,610,609,4,-1,5,7,0,450,881,301
738,0,101,1,878,877,0,13,1,332,331,0.0,0.0,1,1,0,5,-1,6,13,0,129,802,374
739,1,103,331,968,637,2,4,331,469,138,0.0,0.0008169100377820892,1,799,798,4,8,5,2,3,866,626,261
740,1,1,333,333,0,5,5,333,333,0,3.4037918240920386e-05,3.4037918240920386e-05,395,395,0,-1,6,6,5,1,663,621,723
741,6,108,395,885,490,22,25,398,415,17,0.0,6.807583648184077e-05,1,441,440,4,4,4,12,3,184,755,551
742,56,672,829,997,168,60,70,841,891,50,0.0011913271384322134,0.011232513019503728,830,985,155,2,3,3,5,11,408,83,23
743,6,212,388,946,558,29,39,408,465,57,3.4037918240920386e-05,0.000442492937131965,395,678,283,3,4,4,14,1,108,807,381
744,0,0,1,1,0,0,0,1,1,0,0.0,0.0,1,1,0,-1,-1,-1,17,0,71,978,987
745,5,5,552,552,0,4,4,452,452,0,0.0004765308553728854,0.0004765308553728854,711,711,0,-1,5,5,2,3,782,236,533
746,172,172,934,934,0,256,256,969,969,0,0.0022465026039007454,0.0022465026039007454,888,888,0,-1,2,2,18,12,29,163,831
747,49,49,876,876,0,12,12,683,683,0,0.001497668402600497,0.001497668402600497,860,860,0,-1,4,4,2,18,965,54,953
748,115,217,895,955,60,100,100,832,832,0,0.0016338200755641784,0.0018040096667687805,867,881,14,4,3,3,10,15,205,53,229
749,1,617,332,995,663,9,64,332,704,372,0.0,0.004561081044283332,1,955,954,2,6,3,9,1,803,469,20
750,0,206,1,958,957,0,26,1,505,504,0.0,0.0007828721195411688,1,770,769,3,-1,4,8,0,365,823,186
751,0,206,1,969,968,0,22,1,567,566,0.0,0.0009530617107457708,1,810,809,3,-1,4,5,0,363,729,53
752,6,622,386,991,605,62,80,482,534,52,3.4037918240920386e-05,0.0006467204465774873,394,721,327,2,4,3,19,1,46,799,124
753,6,6,462,462,0,10,10,475,475,0,0.0,0.0,1,1,0,-1,4,4,4,1,507,506,981
754,0,101,1,950,949,0,2,1,330,329,0.0,0.0,1,1,0,5,-1,6,2,0,821,571,842
755,18,120,665,929,264,30,30,682,682,0,0.0007828721195411688,0.0009190237925048504,779,798,19,4,4,4,5,4,502,326,795
756,0,0,1,1,0,0,0,1,1,0,0.0,0.0,1,1,0,-1,-1,-1,4,0,762,897,839
757,6,6,424,424,0,21,21,482,482,0,0.0002382654276864427,0.0002382654276864427,584,584,0,-1,4,4,7,2,196,805,433
758,0,102,1,944,943,0,4,1,435,434,0.0,0.0002042275094455223,1,572,571,4,-1,5,2,0,929,716,619
759,51,257,818,973,155,72,72,829,829,0,0.001599782157323258,0.0020763130126961434,862,890,28,3,2,2,7,8,343,417,318
760,40,246,697,947,250,134,142,688,705,17,0.0004084550188910446,0.0006126825283365669,655,705,50,3,3,3,22,4,55,86,182
761,0,0,1,1,0,0,0,1,1,0,0.0,0.0,1,1,0,-1,-1,-1,7,0,246,936,372
762,178,280,972,984,12,72,72,984,984,0,0.007556417849484326,0.00793083495013445,973,975,2,4,2,2,3,31,530,126,204
763,1,1,332,332,0,2,2,332,332,0,0.0,0.0,1,1,0,-1,7,7,2,2,983,344,568
764,2,2,360,360,0,6,6,382,382,0,3.4037918240920386e-05,3.4037918240920386e-05,401,401,0,-1,5,5,4,2,969,679,712
765,0,0,1,1,0,0,0,1,1,0,0.0,0.0,1,1,0,-1,-1,-1,25,0,17,927,754
766,112,318,906,978,72,98,98,898,898,0,0.0026549576227917903,0.003710133088260322,910,942,32,3,3,3,8,18,380,55,63
767,0,0,1,1,0,0,0,1,1,0,0.0,0.0,1,1,0,-1,-1,-1,2,0,940,847,725
768,0,616,1,989,988,0,73,1,457,456,0.0,0.0008509479560230097,1,765,764,2,-1,3,23,0,15,865,389
769,0,101,1,959,958,0,3,1,330,329,0.0,0.0,1,1,0,5,-1,6,3,0,915,776,710
770,446,548,981,985,4,320,320,993,993,0,0.006943735321147759,0.007113924912352361,965,965,0,4,2,2,14,45,332,77,156
771,6,107,396,892,496,18,18,410,410,0,6.807583648184077e-05,6.807583648184077e-05,436,436,0,6,4,4,8,1,483,592,739
772,601,1217,993,1000,7,136,136,979,979,0,0.012083460975526737,0.01415977398822288,986,987,1,2,2,2,7,85,340,0,87
773,0,102,1,877,876,0,25,1,378,377,0.0,3.4037918240920386e-05,1,391,390,4,-1,5,16,0,195,358,191
774,54,260,848,978,130,44,44,877,877,0,0.0011913271384322134,0.003642057251778481,828,935,107,3,3,3,4,11,458,118,17
775,2,104,366,931,565,6,6,367,367,0,3.4037918240920386e-05,0.0004084550188910446,402,663,261,4,5,5,5,1,727,639,275
776,4,106,456,938,482,4,4,395,395,0,3.4037918240920386e-05,0.00010211375472276115,401,487,86,4,5,5,2,2,598,430,797
777,18,18,621,621,0,36,36,566,566,0,0.0002382654276864427,0.0002382654276864427,595,595,0,-1,4,4,8,4,420,202,821
778,170,170,932,932,0,148,148,951,951,0,0.0028932230504782326,0.0028932230504782326,922,922,0,-1,2,2,9,17,159,81,910
779,0,0,1,1,0,0,0,1,1,0,0.0,0.0,1,1,0,-1,-1,-1,9,0,319,986,898
780,2,2,369,369,0,4,4,372,372,0,0.0,0.0,1,1,0,-1,5,5,3,2,899,842,814
781,129,129,948,948,0,70,70,957,957,0,0.007794683277170768,0.007794683277170768,971,971,0,-1,2,2,5,21,695,157,784
782,6,622,512,1000,488,8,22,549,863,314,6.807583648184077e-05,0.00527587732734266,447,963,516,2,4,3,2,1,878,618,190
783,233,334,965,978,13,126,126,961,961,0,0.005718370264474625,0.005718370264474625,965,965,0,5,2,2,7,48,246,56,593
784,22,123,760,954,194,12,12,603,603,0,0.0005105687736138058,0.0005105687736138058,709,709,0,5,4,4,2,6,992,494,321
785,0,206,1,972,971,0,16,1,510,509,0.0,0.002144388849177984,1,891,890,3,-1,4,6,0,486,716,75
786,0,206,1,960,959,0,24,1,478,477,0.0,0.0009530617107457708,1,801,800,3,-1,4,8,0,223,898,53
787,2,2,362,362,0,6,6,393,393,0,0.0,0.0,1,1,0,-1,5,5,3,1,613,743,974
788,0,206,1,939,938,0,53,1,440,439,0.0,0.0002723033459273631,1,598,597,3,-1,4,19,0,11,933,525
789,0,0,1,1,0,0,0,1,1,0,0.0,0.0,1,1,0,-1,-1,-1,2,0,776,858,565
790,5,5,524,524,0,6,6,480,480,0,0.00013615167296368154,0.00013615167296368154,526,526,0,-1,5,5,3,3,853,385,780
791,42,144,731,910,179,194,194,910,910,0,0.0012253650566731338,0.0013274788113958951,825,831,6,4,2,2,15,4,40,440,164
792,0,616,1,995,994,0,60,1,759,758,0.0,0.003880322679464924,1,942,941,2,-1,3,8,0,282,991,142
793,0,206,1,958,957,0,19,1,416,415,0.0,0.0002042275094455223,1,563,562,3,-1,4,9,0,389,758,508
794,8,214,521,969,448,15,16,495,495,0,0.00013615167296368154,0.0005105687736138058,525,705,180,3,4,4,4,2,572,602,256
795,0,102,1,908,907,0,8,1,372,371,0.0,0.00013615167296368154,1,518,517,4,-1,5,6,0,489,996,586
796,0,0,1,1,0,0,0,1,1,0,0.0,0.0,1,1,0,-1,-1,-1,9,0,217,588,947
797,6,622,456,997,541,26,40,643,791,148,0.0004765308553728854,0.003812246842983083,698,933,235,2,4,3,5,1,720,439,42
798,100,100,910,910,0,70,70,909,909,0,0.0023486163586235067,0.0023486163586235067,899,899,0,-1,3,3,5,17,616,45,808
799,0,616,1,998,997,0,32,1,737,736,0.0,0.0035739814152966403,1,936,935,2,-1,3,5,0,517,608,128
800,355,355,980,980,0,266,266,969,969,0,0.005173763572619898,0.005173763572619898,956,956,0,-1,2,2,17,45,23,77,660
801,22,124,747,956,209,20,20,788,788,0,0.0005786446100956465,0.0007488342013002485,743,774,31,4,3,3,3,6,871,258,262
802,2,103,363,920,557,8,8,390,390,0,0.0,3.4037918240920386e-05,1,395,394,5,5,5,5,1,644,734,290
803,2,2,365,365,0,6,6,391,391,0,0.0,0.0,1,1,0,-1,5,5,4,2,603,320,980
804,0,0,1,1,0,0,0,1,1,0,0.0,0.0,1,1,0,-1,-1,-1,4,0,566,735,887
805,0,206,1,969,968,0,14,1,470,469,0.0,0.0006807583648184077,1,756,755,3,-1,4,5,0,363,574,281
806,0,102,1,897,896,0,10,1,366,365,0.0,0.00017018959120460194,1,549,548,4,-1,5,8,0,449,906,378
807,6,6,464,464,0,8,8,475,475,0,0.0,0.0,1,1,0,-1,4,4,3,1,831,879,962
808,115,216,896,951,55,146,146,919,919,0,0.0022465026039007454,0.0022465026039007454,897,897,0,5,2,2,12,15,143,206,896
809,98,200,911,969,58,48,48,924,924,0,0.0020082371762143027,0.0020763130126961434,889,893,4,4,3,3,3,17,780,96,688
810,2,104,365,920,555,7,8,389,413,24,3.4037918240920386e-05,0.000442492937131965,399,682,283,4,5,5,4,3,758,748,475
811,0,206,1,978,977,0,8,1,505,504,0.0,0.0012934408931549745,1,844,843,3,-1,4,2,0,937,455,190
812,0,0,1,1,0,0,0,1,1,0,0.0,0.0,1,1,0,-1,-1,-1,5,0,456,916,643
813,0,101,1,861,860,0,23,1,331,330,0.0,0.0,1,1,0,5,-1,6,23,0,57,498,601
814,0,102,1,931,930,0,3,1,365,364,0.0,0.00010211375472276115,1,483,482,4,-1,5,2,0,763,517,756
815,11,11,554,554,0,20,20,497,497,0,0.00017018959120460194,0.00017018959120460194,523,523,0,-1,4,4,6,7,556,427,604
816,22,638,661,994,333,36,64,575,756,181,0.0002723033459273631,0.004493005207801491,617,952,335,2,4,3,8,6,383,683,142
817,23,23,677,677,0,48,48,708,708,0,0.0004084550188910446,0.0004084550188910446,668,668,0,-1,3,3,7,3,346,280,983
818,76,76,904,904,0,28,28,836,836,0,0.0026549576227917903,0.0026549576227917903,917,917,0,-1,3,3,3,20,785,87,942
819,0,102,1,979,978,0,3,1,457,456,0.0,0.0005446066918547262,1,745,744,4,-1,5,2,0,952,950,473
820,6,6,421,421,0,8,8,403,403,0,0.0,0.0,1,1,0,-1,5,5,4,3,614,526,969
821,0,0,1,1,0,0,0,1,1,0,0.0,0.0,1,1,0,-1,-1,-1,2,0,898,912,864
822,0,206,1,964,963,0,19,1,438,437,0.0,0.0002723033459273631,1,609,608,3,-1,4,8,1,297,742,294
823,0,0,1,1,0,0,0,1,1,0,0.0,0.0,1,1,0,-1,-1,-1,10,0,256,457,977
824,140,242,928,968,40,122,122,937,937,0,0.0024166921951053475,0.0024507301133462676,908,910,2,4,2,2,8,18,244,54,251
825,9,215,595,979,384,8,12,509,637,128,0.00013615167296368154,0.008237176214302734,526,978,452,3,4,4,2,3,232,534,11
826,6,6,398,398,0,30,30,411,411,0,0.0,0.0,1,1,0,-1,4,4,14,2,144,885,938
827,0,0,1,1,0,0,0,1,1,0,0.0,0.0,1,1,0,-1,-1,-1,5,0,546,991,456
828,18,120,668,934,266,23,26,565,614,49,0.00013615167296368154,0.0004765308553728854,515,697,182,4,3,3,6,3,322,563,145
829,0,102,1,941,940,0,4,1,423,422,0.0,0.00017018959120460194,1,561,560,4,-1,5,2,0,817,990,318
830,8,214,561,980,419,12,12,604,604,0,6.807583648184077e-05,0.0002382654276864427,443,598,155,3,4,4,2,2,943,549,827
831,0,0,1,1,0,0,0,1,1,0,0.0,0.0,1,1,0,-1,-1,-1,14,0,127,423,611
832,125,125,913,913,0,104,104,950,950,0,0.0019741992579733825,0.0019741992579733825,888,888,0,-1,2,2,5,20,238,189,908
833,16,117,580,912,332,46,46,709,709,0,0.00013615167296368154,0.00013615167296368154,501,501,0,5,3,3,6,1,514,110,320
834,39,39,805,805,0,28,28,738,738,0,0.0010892133837094523,0.0010892133837094523,822,822,0,-1,3,3,3,11,989,118,976
835,0,0,1,1,0,0,0,1,1,0,0.0,0.0,1,1,0,-1,-1,-1,21,0,74,201,660
836,38,38,810,810,0,24,24,766,766,0,0.0007147962830593281,0.0007147962830593281,761,761,0,-1,3,3,3,10,901,272,955
837,46,147,802,941,139,64,64,815,815,0,0.0006467204465774873,0.0006807583648184077,731,740,9,5,3,3,7,6,400,432,687
838,74,74,850,850,0,98,98,878,878,0,0.002825147213996392,0.002825147213996392,919,919,0,-1,2,2,9,6,126,46,649
839,2,2,369,369,0,4,4,370,370,0,3.4037918240920386e-05,3.4037918240920386e-05,400,400,0,-1,5,5,3,2,636,679,994
840,0,0,1,1,0,0,0,1,1,0,0.0,0.0,1,1,0,-1,-1,-1,11,0,176,995,565
841,5,106,442,923,481,10,10,436,436,0,0.00010211375472276115,0.00017018959120460194,479,540,61,5,5,5,5,4,452,442,708
842,2,2,362,362,0,8,8,412,412,0,0.00010211375472276115,0.00010211375472276115,474,474,0,-1,5,5,4,1,832,594,974
843,34,34,761,761,0,38,38,712,712,0,0.0004084550188910446,0.0004084550188910446,680,680,0,-1,3,3,6,7,251,237,673
844,9,9,595,595,0,12,12,616,616,0,0.00037441710065012424,0.00037441710065012424,666,666,0,-1,4,4,2,5,937,619,515
845,0,102,1,898,897,0,17,1,392,391,0.0,6.807583648184077e-05,1,445,444,4,-1,5,10,0,293,276,770
846,0,0,1,1,0,0,0,1,1,0,0.0,0.0,1,1,0,-1,-1,-1,7,0,179,843,747
847,22,124,683,929,246,30,30,699,699,0,0.0006126825283365669,0.0006467204465774873,745,750,5,4,3,3,4,3,354,209,152
848,6,107,562,969,407,3,3,405,405,0,0.00013615167296368154,0.00013615167296368154,531,531,0,5,5,5,2,6,866,279,526
849,0,101,1,876,875,0,11,1,332,331,0.0,0.0,1,1,0,6,-1,7,11,0,163,845,140
850,6,6,460,460,0,12,12,492,492,0,0.00017018959120460194,0.00017018959120460194,542,542,0,-1,4,4,4,4,462,409,997
851,88,294,855,974,119,132,132,885,885,0,0.0008169100377820892,0.0017018959120460194,772,866,94,3,3,3,12,14,212,243,99
852,6,6,398,398,0,36,36,451,451,0,6.807583648184077e-05,6.807583648184077e-05,435,435,0,-1,4,4,14,1,172,555,884
853,0,0,1,1,0,0,0,1,1,0,0.0,0.0,1,1,0,-1,-1,-1,3,0,585,436,978
854,24,126,662,911,249,90,90,805,805,0,0.0007147962830593281,0.0008509479560230097,742,775,33,4,3,3,10,3,256,103,160
855,102,102,874,874,0,130,130,782,782,0,0.0016338200755641784,0.0016338200755641784,860,860,0,-1,3,3,15,15,49,138,815
856,14,14,506,506,0,58,58,482,482,0,0.00010211375472276115,0.00010211375472276115,476,476,0,-1,4,4,19,3,48,596,754
857,7,213,518,964,446,22,27,490,536,46,6.807583648184077e-05,0.0005105687736138058,449,713,264,3,4,4,8,3,318,761,252
858,22,22,613,613,0,66,66,557,557,0,0.00013615167296368154,0.00013615167296368154,516,516,0,-1,3,3,14,2,127,491,709
859,18,18,685,685,0,26,26,748,748,0,0.0002382654276864427,0.0002382654276864427,597,597,0,-1,3,3,4,2,633,724,846
860,206,412,965,987,22,88,88,958,958,0,0.003710133088260322,0.005377991082065421,942,965,23,3,2,2,4,31,493,35,141
861,14,14,669,669,0,14,14,629,629,0,0.00030634126416828345,0.00030634126416828345,642,642,0,-1,4,4,3,9,867,317,644
862,6,108,510,955,445,7,8,534,545,11,6.807583648184077e-05,0.0007828721195411688,460,790,330,4,4,4,2,1,998,402,155
863,0,206,1,961,960,0,28,1,548,547,0.0,0.0017359338302869397,1,871,870,3,-1,4,6,0,356,815,158
864,0,101,1,886,885,0,10,1,331,330,0.0,0.0,1,1,0,5,-1,6,10,0,128,574,342
865,0,206,1,963,962,0,34,1,526,525,0.0,0.0013955546478777359,1,841,840,3,-1,4,9,1,166,742,45
866,34,34,744,744,0,44,44,663,663,0,0.00034037918240920387,0.00034037918240920387,663,663,0,-1,3,3,7,4,714,167,786
867,15,221,674,979,305,9,9,512,512,0,0.00013615167296368154,0.0005786446100956465,532,742,210,3,4,4,3,4,871,315,115
868,6,108,476,951,475,8,8,518,518,0,6.807583648184077e-05,0.0005446066918547262,455,736,281,4,4,4,2,2,988,544,473
869,16,16,628,628,0,33,33,690,690,0,0.0007147962830593281,0.0007147962830593281,761,761,0,-1,3,3,6,1,237,500,860
870,0,206,1,977,976,0,10,1,492,491,0.0,0.0002042275094455223,1,577,576,3,-1,4,3,0,958,952,80
871,0,101,1,898,897,0,8,1,332,331,0.0,0.0,1,1,0,5,-1,6,8,0,199,205,463
872,1,103,332,954,622,2,3,332,382,50,0.0,6.807583648184077e-05,1,464,463,4,7,5,2,2,897,344,485
873,0,0,1,1,0,0,0,1,1,0,0.0,0.0,1,1,0,-1,-1,-1,8,0,499,774,777
874,18,120,597,904,307,64,64,614,614,0,0.0002723033459273631,0.0004084550188910446,605,668,63,4,4,4,12,3,212,318,528
875,0,101,1,914,913,0,5,1,332,331,0.0,0.0,1,1,0,5,-1,6,5,0,692,960,320
876,0,101,1,945,944,0,2,1,330,329,0.0,0.00010211375472276115,1,484,483,5,-1,6,2,0,232,276,444
877,22,22,683,683,0,29,29,710,710,0,0.0005446066918547262,0.0005446066918547262,731,731,0,-1,3,3,4,2,949,465,952
878,17,119,650,929,279,34,34,646,646,0,0.00017018959120460194,0.00034037918240920387,552,648,96,4,4,4,7,6,697,199,762
879,20,122,660,927,267,26,26,586,586,0,0.0005786446100956465,0.0008169100377820892,725,774,49,4,3,3,6,3,518,526,316
880,13,114,556,899,343,44,44,603,603,0,0.00010211375472276115,0.00010211375472276115,482,482,0,5,4,4,8,5,434,395,595
881,0,206,1,974,973,0,8,1,491,490,0.0,0.0009870996289866913,1,813,812,3,-1,4,2,0,598,990,100
882,0,0,1,1,0,0,0,1,1,0,0.0,0.0,1,1,0,-1,-1,-1,6,0,515,751,790
883,2,208,354,960,606,12,28,373,490,117,0.0,0.0007147962830593281,1,752,751,3,5,4,8,1,231,337,114
884,0,206,1,936,935,0,33,1,387,386,0.0,0.0002042275094455223,1,561,560,3,-1,4,19,0,35,916,93
885,0,616,1,990,989,0,106,1,602,601,0.0,0.0020082371762143027,1,880,879,2,-1,3,23,0,30,514,213
886,0,0,1,1,0,0,0,1,1,0,0.0,0.0,1,1,0,-1,-1,-1,2,0,684,916,699
887,31,132,788,948,160,40,40,867,867,0,0.0005105687736138058,0.0005105687736138058,705,705,0,5,3,3,4,6,578,4,878
888,0,102,1,948,947,0,8,1,452,451,0.0,0.0005786446100956465,1,743,742,4,-1,5,4,0,480,324,470
889,0,206,1,970,969,0,16,1,533,532,0.0,0.0013274788113958951,1,847,846,3,-1,4,4,0,969,851,59
890,9,9,495,495,0,28,28,473,473,0,0.00013615167296368154,0.00013615167296368154,509,509,0,-1,4,4,10,4,259,581,254
891,16,16,647,647,0,11,11,471,471,0,0.00010211375472276115,0.00010211375472276115,494,494,0,-1,4,4,4,7,824,188,895
892,14,116,618,939,321,30,30,694,694,0,0.00030634126416828345,0.0004765308553728854,636,708,72,4,4,4,5,4,421,637,534
893,6,108,435,916,481,16,16,516,516,0,3.4037918240920386e-05,0.0002723033459273631,395,626,231,4,4,4,4,2,623,544,482
894,0,0,1,1,0,0,0,1,1,0,0.0,0.0,1,1,0,-1,-1,-1,7,0,361,865,832
895,0,206,1,978,977,0,12,1,630,629,0.0,0.0013274788113958951,1,853,852,3,-1,4,2,0,776,228,261
896,0,616,1,992,991,0,42,1,597,596,0.0,0.0018720855032506212,1,872,871,2,-1,3,8,0,358,542,352
897,0,0,1,1,0,0,0,1,1,0,0.0,0.0,1,1,0,-1,-1,-1,4,1,403,660,978
898,0,616,1,994,993,0,80,1,692,691,0.0,0.002552843868069029,1,907,906,2,-1,3,10,0,285,538,15
899,42,144,839,958,119,44,44,939,939,0,0.002586881786309949,0.002723033459273631,912,915,3,4,2,2,3,2,861,634,290
900,0,206,1,984,983,0,18,1,718,717,0.0,0.01317267435923619,1,990,989,3,-1,4,3,3,584,753,2
901,22,228,722,978,256,18,18,658,658,0,0.0005786446100956465,0.0037441710065012424,733,946,213,3,4,4,3,11,756,162,51
902,0,0,1,1,0,0,0,1,1,0,0.0,0.0,1,1,0,-1,-1,-1,5,0,616,959,968
903,0,0,1,1,0,0,0,1,1,0,0.0,0.0,1,1,0,-1,-1,-1,3,0,337,955,367
904,50,256,765,956,191,156,156,829,829,0,0.0007828721195411688,0.001157289220191293,767,829,62,3,3,3,16,9,27,145,212
905,0,206,1,947,946,0,58,1,534,533,0.0,0.0009870996289866913,1,796,795,3,-1,4,15,0,95,928,277
906,0,102,1,878,877,0,22,1,363,362,0.0,3.4037918240920386e-05,1,400,399,4,-1,5,17,0,56,200,279
907,34,135,777,942,165,24,24,708,708,0,0.000442492937131965,0.000442492937131965,699,699,0,5,3,3,3,5,471,178,495
908,14,220,606,972,366,22,30,559,675,116,6.807583648184077e-05,0.004152626025392287,454,952,498,3,4,4,5,7,326,451,50
909,0,102,1,905,904,0,11,1,398,397,0.0,0.0002042275094455223,1,561,560,4,-1,5,6,0,356,696,406
910,6,107,411,899,488,16,16,388,388,0,3.4037918240920386e-05,3.4037918240920386e-05,404,404,0,5,4,4,10,2,243,692,543
911,0,0,1,1,0,0,0,1,1,0,0.0,0.0,1,1,0,-1,-1,-1,4,0,921,649,965
912,3,104,460,945,485,4,4,424,424,0,6.807583648184077e-05,0.00010211375472276115,462,495,33,6,5,5,2,2,548,749,540
913,6,107,437,913,476,15,15,504,504,0,0.00010211375472276115,0.00010211375472276115,491,491,0,5,4,4,4,1,759,935,736
914,0,0,1,1,0,0,0,1,1,0,0.0,0.0,1,1,0,-1,-1,-1,13,0,242,978,986
915,2,208,370,976,606,6,14,420,578,158,6.807583648184077e-05,0.0013955546478777359,444,845,401,3,5,4,3,2,903,325,180
916,80,80,869,869,0,92,92,910,910,0,0.0020082371762143027,0.0020082371762143027,885,885,0,-1,3,3,7,12,214,100,205
917,0,0,1,1,0,0,0,1,1,0,0.0,0.0,1,1,0,-1,-1,-1,2,0,589,934,400
918,0,616,1,997,996,0,30,1,655,654,0.0,0.0026549576227917903,1,902,901,2,-1,3,6,0,373,517,109
919,45,251,827,974,147,34,34,738,738,0,0.001157289220191293,0.0017018959120460194,834,881,47,3,3,3,4,8,532,352,40
920,49,255,836,976,140,48,48,920,920,0,0.0011913271384322134,0.001940161339732462,840,884,44,3,3,3,3,11,930,118,96
921,33,134,801,950,149,28,28,799,799,0,0.0004765308553728854,0.0005446066918547262,699,719,20,5,3,3,3,9,627,343,215
922,22,124,661,916,255,32,32,590,590,0,0.00017018959120460194,0.0006467204465774873,557,746,189,4,4,4,6,6,432,229,413
923,2,2,382,382,0,4,4,432,432,0,0.0,0.0,1,1,0,-1,5,5,2,2,951,560,858
924,0,101,1,948,947,0,3,1,330,329,0.0,3.4037918240920386e-05,1,404,403,5,-1,6,3,0,911,939,691
925,0,0,1,1,0,0,0,1,1,0,0.0,0.0,1,1,0,-1,-1,-1,21,1,3,472,847
926,0,0,1,1,0,0,0,1,1,0,0.0,0.0,1,1,0,-1,-1,-1,9,0,381,966,830
927,6,6,374,374,0,51,51,447,447,0,0.0,0.0,1,1,0,-1,4,4,19,2,89,575,849
928,0,102,1,953,952,0,4,1,386,385,0.0,0.00010211375472276115,1,494,493,4,-1,5,3,0,918,838,481
929,36,36,704,704,0,94,94,688,688,0,0.0009190237925048504,0.0009190237925048504,792,792,0,-1,3,3,14,6,21,289,349
930,53,155,777,917,140,92,92,690,690,0,0.00034037918240920387,0.00034037918240920387,644,644,0,4,3,3,13,7,41,176,537
931,91,297,918,988,70,28,28,819,819,0,0.002552843868069029,0.00353994349705572,913,933,20,3,3,3,3,20,826,94,355
932,4,4,527,527,0,3,3,417,417,0,0.0002042275094455223,0.0002042275094455223,597,597,0,-1,5,5,2,4,962,398,816
933,0,0,1,1,0,0,0,1,1,0,0.0,0.0,1,1,0,-1,-1,-1,5,0,744,871,515
934,74,74,908,908,0,18,18,686,686,0,0.002212464685659825,0.002212464685659825,910,910,0,-1,4,4,3,26,708,127,877
935,186,392,962,986,24,90,90,937,937,0,0.00527587732734266,0.005412029000306341,965,965,0,3,2,2,6,28,624,41,486
936,0,206,1,968,967,0,14,1,491,490,0.0,0.001157289220191293,1,827,826,3,-1,4,5,1,765,830,63
937,0,101,1,916,915,0,5,1,332,331,0.0,0.00010211375472276115,1,483,482,5,-1,6,5,0,662,990,755
938,459,561,994,997,3,94,94,978,978,0,0.013479015623404473,0.013547091459886314,990,990,0,4,2,2,5,91,376,7,406
939,0,102,1,918,917,0,5,1,376,375,0.0,0.00010211375472276115,1,498,497,4,-1,5,3,0,554,707,285
940,7,7,486,486,0,30,30,439,439,0,0.0,0.0,1,1,0,-1,4,4,13,3,113,631,428
941,0,206,1,977,976,0,14,1,578,577,0.0,0.005514142755029102,1,956,955,3,-1,4,3,2,844,752,9
942,52,258,759,964,205,112,112,712,712,0,0.0006126825283365669,0.0006807583648184077,719,731,12,3,2,2,17,3,23,173,581
943,6,107,471,947,476,10,10,519,519,0,0.00017018959120460194,0.0002042275094455223,551,583,32,5,4,4,3,2,879,691,581
944,19,19,687,687,0,24,24,695,695,0,0.0002042275094455223,0.0002042275094455223,571,571,0,-1,4,4,4,7,313,237,565
945,18,120,658,928,270,16,16,519,519,0,0.00013615167296368154,0.00034037918240920387,530,660,130,4,4,4,4,4,675,202,398
946,77,179,886,963,77,18,18,624,624,0,0.0011232513019503727,0.001497668402600497,825,858,33,4,4,4,3,20,703,109,343
947,25,127,786,957,171,24,24,821,821,0,0.0004084550188910446,0.0005105687736138058,691,725,34,4,3,3,3,6,569,107,363
948,0,102,1,894,893,0,10,1,350,349,0.0,0.00010211375472276115,1,486,485,4,-1,5,9,0,803,872,208
949,16,16,649,649,0,46,46,833,833,0,0.0005446066918547262,0.0005446066918547262,721,721,0,-1,3,3,5,1,795,480,565
950,0,206,1,963,962,0,18,1,492,491,0.0,0.0007488342013002485,1,760,759,3,-1,4,5,0,492,999,137
951,915,1015,999,999,0,292,292,1000,1000,0,0.017597603730555838,0.01773375540351952,993,993,0,4,2,2,12,98,96,23,395
952,0,102,1,885,884,0,10,1,349,348,0.0,3.4037918240920386e-05,1,395,394,4,-1,5,9,0,414,819,597
953,15,221,603,967,364,38,38,645,645,0,0.00034037918240920387,0.0005446066918547262,657,716,59,3,4,4,7,5,505,454,176
954,28,28,763,763,0,28,28,755,755,0,0.0011232513019503727,0.0011232513019503727,825,825,0,-1,3,3,3,7,577,224,833
955,60,161,899,971,72,12,12,664,664,0,0.0019061234214915416,0.0019061234214915416,892,892,0,6,4,4,2,18,781,82,896
956,56,158,789,919,130,114,114,725,725,0,0.0005786446100956465,0.0006126825283365669,711,721,10,4,3,3,16,11,27,162,606
957,34,240,728,966,238,62,70,702,737,35,0.00013615167296368154,0.0005786446100956465,507,725,218,3,3,3,9,4,213,617,165
958,267,267,985,985,0,44,44,916,916,0,0.008475441641989176,0.008475441641989176,977,977,0,-1,3,3,4,62,827,70,903
959,0,206,1,975,974,0,8,1,484,483,0.0,0.002825147213996392,1,928,927,3,-1,4,2,0,804,571,76
960,309,411,981,988,7,78,78,952,952,0,0.008169100377820893,0.008475441641989176,977,978,1,4,2,2,4,49,509,16,510
961,0,102,1,891,890,0,14,1,377,376,0.0,0.0,1,1,0,4,-1,5,10,0,258,894,238
962,106,312,904,980,76,86,86,920,920,0,0.002314578440382586,0.0026889955410327104,895,908,13,3,3,3,6,15,514,158,630
963,6,107,436,924,488,8,8,439,439,0,6.807583648184077e-05,6.807583648184077e-05,438,438,0,5,4,4,2,2,893,714,743
964,0,0,1,1,0,0,0,1,1,0,0.0,0.0,1,1,0,-1,-1,-1,2,0,868,843,943
965,44,250,726,955,229,124,124,695,695,0,0.0005446066918547262,0.0006126825283365669,689,708,19,3,3,3,20,7,70,422,570
966,0,616,1,993,992,0,108,1,818,817,0.0,0.00970080669866231,1,979,978,2,-1,3,12,0,62,782,37
967,12,12,707,707,0,12,12,755,755,0,0.0011232513019503727,0.0011232513019503727,839,839,0,-1,4,4,2,6,987,471,844
968,2,104,357,906,549,9,10,391,404,13,0.0,0.00017018959120460194,1,538,537,4,5,5,5,2,818,885,724
969,361,463,986,990,4,78,78,958,958,0,0.010858095918853602,0.011300588855985567,984,985,1,4,2,2,4,59,921,6,264
970,8,8,495,495,0,28,28,469,469,0,0.00010211375472276115,0.00010211375472276115,481,481,0,-1,4,4,10,2,256,749,917
971,28,129,770,952,182,18,18,613,613,0,0.0005446066918547262,0.0005446066918547262,726,726,0,6,4,4,3,13,651,217,621
972,2,104,370,932,562,4,4,394,394,0,0.00013615167296368154,0.0002723033459273631,523,621,98,4,5,5,2,1,752,799,862
973,0,0,1,1,0,0,0,1,1,0,0.0,0.0,1,1,0,-1,-1,-1,12,0,187,569,388
974,0,0,1,1,0,0,0,1,1,0,0.0,0.0,1,1,0,-1,-1,-1,15,0,81,367,766
975,0,206,1,952,951,0,44,1,527,526,0.0,0.0009870996289866913,1,800,799,3,-1,4,10,1,285,830,137
976,0,102,1,913,912,0,7,1,368,367,0.0,0.00013615167296368154,1,500,499,4,-1,5,5,2,457,752,314
977,0,0,1,1,0,0,0,1,1,0,0.0,0.0,1,1,0,-1,-1,-1,12,0,219,942,428
978,0,0,1,1,0,0,0,1,1,0,0.0,0.0,1,1,0,-1,-1,-1,19,0,148,905,498
979,79,285,847,969,122,106,110,834,860,26,0.002825147213996392,0.002995336805200994,915,921,6,3,2,2,11,10,215,296,165
980,0,0,1,1,0,0,0,1,1,0,0.0,0.0,1,1,0,-1,-1,-1,2,0,894,868,851
981,129,231,915,962,47,118,118,926,926,0,0.0022465026039007454,0.0024166921951053475,889,897,8,4,2,2,9,15,178,53,536
982,0,102,1,906,905,0,8,1,383,382,0.0,0.00030634126416828345,1,634,633,4,-1,5,5,0,599,498,450
983,56,56,816,816,0,74,74,806,806,0,0.0006467204465774873,0.0006467204465774873,737,737,0,-1,3,3,8,6,383,192,863
984,0,0,1,1,0,0,0,1,1,0,0.0,0.0,1,1,0,-1,-1,-1,3,0,826,388,614
985,14,14,568,568,0,29,29,505,505,0,0.00030634126416828345,0.00030634126416828345,629,629,0,-1,4,4,9,3,168,653,744
986,0,0,1,1,0,0,0,1,1,0,0.0,0.0,1,1,0,-1,-1,-1,4,0,659,911,892
987,1,103,332,960,628,2,3,332,390,58,3.4037918240920386e-05,0.00013615167296368154,413,529,116,4,6,5,2,1,996,924,549
988,45,146,848,959,111,45,45,941,941,0,0.0038462847612240037,0.003914360597705844,935,938,3,5,2,2,4,4,679,164,532
989,6,108,463,933,470,10,10,473,473,0,0.0,0.00017018959120460194,1,543,542,4,4,4,3,1,626,463,741
990,9,111,621,966,345,6,6,459,459,0,0.0007828721195411688,0.0011232513019503727,774,826,52,4,5,5,3,8,786,257,178
991,6,6,403,403,0,28,28,431,431,0,3.4037918240920386e-05,3.4037918240920386e-05,406,406,0,-1,4,4,12,2,96,550,991
992,6,6,438,438,0,18,18,503,503,0,0.0,0.0,1,1,0,-1,4,4,5,1,665,873,887
993,263,365,982,992,10,32,32,906,906,0,0.009734844616903231,0.009836958371625992,982,982,0,4,3,3,2,54,954,19,392
994,0,0,1,1,0,0,0,1,1,0,0.0,0.0,1,1,0,-1,-1,-1,10,0,189,992,813
995,18,224,667,972,305,26,34,717,767,50,0.00017018959120460194,0.00439089145307873,562,953,391,3,3,3,4,2,641,584,31
996,0,206,1,967,966,0,18,1,455,454,0.0,0.00017018959120460194,1,550,549,3,-1,4,8,0,449,824,450
997,0,102,1,912,911,0,7,1,373,372,0.0,0.00017018959120460194,1,550,549,4,-1,5,5,0,311,777,230
998,10,10,533,533,0,17,17,435,435,0,3.4037918240920386e-05,3.4037918240920386e-05,399,399,0,-1,4,4,7,3,361,485,950
999,0,102,1,943,942,0,4,1,382,381,0.0,0.00010211375472276115,1,492,491,4,-1,5,3,0,840,723,899
