,FreeNet_pre_score,FreeNet_post_score,FreeNet_pre_rank,FreeNet_post_rank,FreeNet_delta_ranks,Reversed_pre_score,Reversed_post_score,Reversed_pre_rank,Reversed_post_rank,Reversed_delta_ranks,Random_pre_score,Random_post_score,Random_pre_rank,Random_post_rank,Random_delta_ranks,dist_victim_relayer,dist_victim_vilain_pre,dist_victim_vilain_post,out_deg_victim,in_deg_villain,victim,villain,relayer
0,0,206,1,966,965,0,11,1,421,420,0.0,0.00010211375472276115,1,486,485,3,-1,4,4,0,509,538,609
1,0,0,1,1,0,0,0,1,1,0,0.0,0.0,1,1,0,-1,-1,-1,16,1,60,529,960
2,0,0,1,1,0,0,0,1,1,0,0.0,0.0,1,1,0,-1,-1,-1,6,0,251,201,946
3,292,292,966,966,0,246,246,980,980,0,0.004152626025392287,0.004152626025392287,943,943,0,-1,2,2,13,32,41,26,433
4,0,0,1,1,0,0,0,1,1,0,0.0,0.0,1,1,0,-1,-1,-1,7,1,141,472,910
5,0,206,1,951,950,0,29,1,464,463,0.0,0.00088498587426393,1,770,769,3,-1,4,11,1,333,685,490
6,0,101,1,940,939,0,4,1,331,330,0.0,3.4037918240920386e-05,1,403,402,5,-1,6,4,0,789,905,274
7,0,102,1,926,925,0,5,1,380,379,0.0,0.00010211375472276115,1,484,483,4,-1,5,3,0,864,983,371
8,6,6,426,426,0,24,24,571,571,0,0.00010211375472276115,0.00010211375472276115,486,486,0,-1,4,4,6,2,582,785,753
9,0,616,1,991,990,0,60,1,566,565,0.0,0.0012594029749140542,1,818,817,2,-1,3,13,0,120,985,206
10,16,118,638,928,290,52,52,902,902,0,0.0006467204465774873,0.0006467204465774873,745,745,0,4,3,3,5,2,570,223,553
11,2,104,361,916,555,5,8,361,405,44,0.0,0.0005786446100956465,1,737,736,4,5,5,4,1,354,543,186
12,6,107,444,927,483,11,11,462,462,0,6.807583648184077e-05,0.0002042275094455223,452,573,121,5,4,4,4,2,740,325,829
13,0,206,1,966,965,0,15,1,476,475,0.0,0.000442492937131965,1,688,687,3,-1,4,4,0,448,489,622
14,30,131,704,915,211,60,60,683,683,0,0.0002042275094455223,0.0002042275094455223,572,572,0,5,3,3,9,6,217,435,298
15,0,101,1,953,952,0,3,1,330,329,0.0,0.00010211375472276115,1,484,483,5,-1,6,3,0,875,996,700
16,474,474,1000,1000,0,56,56,997,997,0,0.022601177711971135,0.022601177711971135,997,997,0,-1,2,2,2,127,821,11,803
17,16,632,633,998,365,44,54,829,886,57,0.0008509479560230097,0.0026209197045508697,793,909,116,2,3,3,4,1,304,612,471
18,0,101,1,933,932,0,4,1,332,331,0.0,0.0,1,1,0,7,-1,8,4,2,679,752,181
19,0,0,1,1,0,0,0,1,1,0,0.0,0.0,1,1,0,-1,-1,-1,6,0,387,941,529
20,24,230,700,971,271,62,62,852,852,0,0.0007488342013002485,0.0019741992579733825,761,881,120,3,3,3,6,4,267,326,174
21,0,0,1,1,0,0,0,1,1,0,0.0,0.0,1,1,0,-1,-1,-1,10,0,437,880,356
22,0,102,1,933,932,0,4,1,363,362,0.0,0.00013615167296368154,1,518,517,4,-1,5,3,0,640,533,370
23,0,101,1,934,933,0,2,1,331,330,0.0,3.4037918240920386e-05,1,401,400,5,-1,6,2,0,926,959,602
24,8,214,566,976,410,12,12,609,609,0,6.807583648184077e-05,0.0019741992579733825,447,891,444,3,4,4,2,2,976,697,15
25,198,198,943,943,0,108,108,913,913,0,0.003812246842983083,0.003812246842983083,943,943,0,-1,3,3,8,26,411,112,533
26,73,73,804,804,0,152,152,750,750,0,0.0012934408931549745,0.0012934408931549745,824,824,0,-1,2,2,21,8,1,204,638
27,0,102,1,938,937,0,4,1,370,369,0.0,0.00010211375472276115,1,481,480,4,-1,5,3,0,835,875,406
28,6,6,417,417,0,20,20,447,447,0,6.807583648184077e-05,6.807583648184077e-05,452,452,0,-1,4,4,8,1,186,463,766
29,0,0,1,1,0,0,0,1,1,0,0.0,0.0,1,1,0,-1,-1,-1,11,0,227,324,539
30,0,206,1,963,962,0,30,1,615,614,0.0,0.0028591851322373124,1,921,920,3,-1,4,5,0,347,889,126
31,112,214,889,952,63,174,174,905,905,0,0.0027911092957554717,0.0028591851322373124,911,913,2,4,2,2,15,12,95,100,762
32,133,339,921,979,58,100,100,819,819,0,0.0018720855032506212,0.0020763130126961434,871,886,15,3,3,3,10,20,149,71,545
33,6,6,445,445,0,10,10,468,468,0,0.00017018959120460194,0.00017018959120460194,550,550,0,-1,4,4,3,1,839,394,944
34,46,46,846,846,0,32,32,883,883,0,0.0023486163586235067,0.0023486163586235067,904,904,0,-1,3,3,2,6,828,73,952
35,42,144,768,929,161,58,58,706,706,0,0.0013615167296368155,0.0014636304843595766,836,845,9,4,3,3,8,6,218,397,332
36,41,247,773,962,189,72,72,810,810,0,0.0007828721195411688,0.0015657442390823377,772,858,86,3,3,3,7,5,296,216,113
37,0,102,1,900,899,0,6,1,372,371,0.0,0.00017018959120460194,1,546,545,4,-1,5,4,0,300,766,371
38,16,222,534,950,416,86,86,662,662,0,0.0002042275094455223,0.00176997174852786,568,871,303,3,3,3,13,3,165,260,153
39,22,228,599,957,358,72,72,549,549,0,0.00017018959120460194,0.0004765308553728854,539,688,149,3,3,3,17,2,23,491,465
40,0,0,1,1,0,0,0,1,1,0,0.0,0.0,1,1,0,-1,-1,-1,7,0,118,995,988
41,0,0,1,1,0,0,0,1,1,0,0.0,0.0,1,1,0,-1,-1,-1,6,0,237,426,995
42,12,113,580,924,344,10,10,449,449,0,0.0002042275094455223,0.0002723033459273631,564,620,56,5,4,4,3,3,459,290,761
43,0,102,1,883,882,0,12,1,359,358,0.0,0.00010211375472276115,1,478,477,4,-1,5,10,0,256,696,749
44,6,6,404,404,0,17,17,408,408,0,3.4037918240920386e-05,3.4037918240920386e-05,405,405,0,-1,4,4,8,1,358,743,573
45,2,208,349,950,601,12,30,349,448,99,0.0,0.0005446066918547262,1,715,714,3,5,4,11,1,167,621,288
46,9,215,501,954,453,46,50,544,558,14,0.00010211375472276115,0.0002723033459273631,485,605,120,3,4,4,11,3,220,508,797
47,0,102,1,933,932,0,4,1,393,392,0.0,0.001157289220191293,1,838,837,4,-1,5,2,3,429,882,166
48,0,0,1,1,0,0,0,1,1,0,0.0,0.0,1,1,0,-1,-1,-1,2,0,880,664,426
49,0,102,1,911,910,0,6,1,372,371,0.0,0.00013615167296368154,1,522,521,4,-1,5,4,0,917,955,121
50,12,113,605,935,330,14,14,505,505,0,0.00017018959120460194,0.00017018959120460194,549,549,0,5,4,4,5,9,629,29,739
51,0,0,1,1,0,0,0,1,1,0,0.0,0.0,1,1,0,-1,-1,-1,13,0,67,750,702
52,0,101,1,910,909,0,5,1,332,331,0.0,0.00013615167296368154,1,511,510,5,-1,6,5,0,537,969,585
53,0,0,1,1,0,0,0,1,1,0,0.0,0.0,1,1,0,-1,-1,-1,6,0,352,731,701
54,100,100,856,856,0,100,100,679,679,0,0.018142210422410564,0.018142210422410564,993,993,0,-1,1,1,15,36,49,48,901
55,40,40,727,727,0,88,88,644,644,0,0.00037441710065012424,0.00037441710065012424,667,667,0,-1,3,3,15,5,107,636,564
56,0,0,1,1,0,0,0,1,1,0,0.0,0.0,1,1,0,-1,-1,-1,6,1,606,742,883
57,34,240,809,983,174,18,18,675,675,0,0.0006807583648184077,0.0008169100377820892,753,782,29,3,4,4,3,9,628,391,636
58,30,30,789,789,0,20,20,659,659,0,0.0007828721195411688,0.0007828721195411688,780,780,0,-1,4,4,4,8,679,204,994
59,0,0,1,1,0,0,0,1,1,0,0.0,0.0,1,1,0,-1,-1,-1,9,0,136,912,872
60,6,108,547,964,417,4,4,470,470,0,0.00017018959120460194,0.0011232513019503727,555,834,279,4,5,5,2,5,788,241,297
61,0,0,1,1,0,0,0,1,1,0,0.0,0.0,1,1,0,-1,-1,-1,6,0,470,800,852
62,0,0,1,1,0,0,0,1,1,0,0.0,0.0,1,1,0,-1,-1,-1,12,3,184,746,660
63,0,0,1,1,0,0,0,1,1,0,0.0,0.0,1,1,0,-1,-1,-1,19,0,19,892,905
64,31,133,793,952,159,22,22,750,750,0,0.0008169100377820892,0.0008169100377820892,777,777,0,4,3,3,2,6,966,232,416
65,0,0,1,1,0,0,0,1,1,0,0.0,0.0,1,1,0,-1,-1,-1,2,0,988,701,428
66,40,246,771,969,198,58,62,837,837,0,0.0017018959120460194,0.003267640151128357,870,928,58,3,2,2,6,1,255,420,304
67,41,657,730,991,261,116,134,707,773,66,0.00034037918240920387,0.0019061234214915416,640,874,234,2,3,3,17,7,24,329,94
68,0,206,1,973,972,0,8,1,488,487,0.0,0.0009190237925048504,1,805,804,3,-1,4,2,0,596,455,163
69,16,16,658,658,0,18,18,756,756,0,0.0002382654276864427,0.0002382654276864427,604,604,0,-1,3,3,2,1,750,891,668
70,16,632,576,990,414,44,80,602,788,186,0.00030634126416828345,0.0034718676605738795,626,934,308,2,3,3,9,1,316,869,74
71,13,13,578,578,0,10,10,433,433,0,0.00013615167296368154,0.00013615167296368154,516,516,0,-1,4,4,3,5,731,274,747
72,6,6,430,430,0,16,16,459,459,0,6.807583648184077e-05,6.807583648184077e-05,449,449,0,-1,4,4,6,1,518,756,821
73,6,107,404,884,480,24,24,425,425,0,3.4037918240920386e-05,6.807583648184077e-05,404,444,40,5,4,4,11,1,279,601,781
74,34,240,721,965,244,64,64,729,729,0,0.00034037918240920387,0.0008509479560230097,639,769,130,3,3,3,8,3,303,280,415
75,0,206,1,971,970,0,26,1,624,623,0.0,0.003369753905851118,1,934,933,3,-1,4,5,0,688,254,51
76,16,117,671,941,270,30,30,796,796,0,0.00030634126416828345,0.00034037918240920387,635,650,15,5,3,3,4,1,679,810,762
77,6,6,426,426,0,18,18,446,446,0,3.4037918240920386e-05,3.4037918240920386e-05,391,391,0,-1,4,4,8,3,270,676,833
78,0,616,1,991,990,0,106,1,833,832,0.0,0.010619830491167161,1,976,975,2,-1,3,11,0,215,629,11
79,0,616,1,994,993,0,32,1,496,495,0.0,0.0013615167296368155,1,834,833,2,-1,3,10,0,109,790,317
80,0,0,1,1,0,0,0,1,1,0,0.0,0.0,1,1,0,-1,-1,-1,5,0,382,942,909
81,0,102,1,874,873,0,22,1,379,378,0.0,0.00013615167296368154,1,503,502,4,-1,5,15,0,0,768,586
82,0,102,1,876,875,0,21,1,361,360,0.0,3.4037918240920386e-05,1,395,394,4,-1,5,17,0,73,608,598
83,0,0,1,1,0,0,0,1,1,0,0.0,0.0,1,1,0,-1,-1,-1,5,0,551,674,836
84,0,206,1,962,961,0,22,1,466,465,0.0,0.0002382654276864427,1,593,592,3,-1,4,8,1,420,835,29
85,9,215,564,972,408,20,24,609,680,71,0.0002382654276864427,0.0018720855032506212,581,879,298,3,4,4,4,5,545,722,133
86,14,1654,481,1000,519,96,184,552,809,257,0.00013615167296368154,0.007454304094761564,505,968,463,1,4,2,20,5,5,710,133
87,44,250,816,976,160,56,56,837,837,0,0.0010211375472276116,0.002723033459273631,820,906,86,3,3,3,6,8,373,264,61
88,2,208,363,971,608,5,12,364,486,122,0.0,0.0007828721195411688,1,780,779,3,5,4,4,2,401,509,53
89,4,106,407,903,496,16,17,411,417,6,6.807583648184077e-05,0.00017018959120460194,448,541,93,4,5,5,9,3,339,598,447
90,63,63,926,926,0,38,38,957,957,0,0.004152626025392287,0.004152626025392287,952,952,0,-1,3,3,3,15,853,53,517
91,7,7,559,559,0,6,6,449,449,0,0.00017018959120460194,0.00017018959120460194,558,558,0,-1,5,5,3,7,854,427,728
92,18,120,703,950,247,12,12,612,612,0,0.0005446066918547262,0.0006807583648184077,725,751,26,4,4,4,2,8,849,345,365
93,128,334,902,971,69,178,178,916,916,0,0.0020082371762143027,0.0028591851322373124,888,919,31,3,2,2,14,11,154,83,242
94,23,23,693,693,0,34,34,622,622,0,0.00010211375472276115,0.00010211375472276115,476,476,0,-1,3,3,7,4,482,581,744
95,0,0,1,1,0,0,0,1,1,0,0.0,0.0,1,1,0,-1,-1,-1,7,1,331,828,657
96,10,216,633,981,348,12,12,664,664,0,0.0006467204465774873,0.0053099152455835805,757,962,205,3,4,4,2,4,781,326,19
97,114,114,935,935,0,50,50,850,850,0,0.003165526396405596,0.003165526396405596,929,929,0,-1,3,3,5,27,688,69,235
98,0,102,1,961,960,0,3,1,383,382,0.0,0.00034037918240920387,1,662,661,4,-1,5,2,0,799,990,288
99,0,101,1,920,919,0,3,1,332,331,0.0,0.0,1,1,0,5,-1,6,3,0,585,945,463
100,78,78,823,823,0,188,188,846,846,0,0.0009530617107457708,0.0009530617107457708,785,785,0,-1,2,2,19,5,83,338,706
101,0,0,1,1,0,0,0,1,1,0,0.0,0.0,1,1,0,-1,-1,-1,3,0,585,813,713
102,18,18,656,656,0,30,30,690,690,0,0.0002042275094455223,0.0002042275094455223,562,562,0,-1,3,3,4,2,759,465,456
103,0,206,1,973,972,0,10,1,516,515,0.0,0.0012253650566731338,1,840,839,3,-1,4,3,0,683,967,255
104,0,102,1,877,876,0,18,1,375,374,0.0,0.00013615167296368154,1,509,508,4,-1,5,13,0,90,571,596
105,46,46,737,737,0,130,130,798,798,0,0.0011913271384322134,0.0011913271384322134,822,822,0,-1,2,2,14,2,122,453,954
106,1,1,332,332,0,5,5,332,332,0,0.00010211375472276115,0.00010211375472276115,483,483,0,-1,6,6,5,3,426,708,965
107,2,104,352,886,534,17,18,387,395,8,3.4037918240920386e-05,6.807583648184077e-05,396,438,42,4,5,5,10,1,105,558,654
108,2,208,354,961,607,10,38,379,629,250,3.4037918240920386e-05,0.0017359338302869397,409,871,462,3,5,4,7,1,364,687,35
109,16,16,590,590,0,30,30,566,566,0,0.00017018959120460194,0.00017018959120460194,545,545,0,-1,3,3,8,1,309,152,921
110,0,206,1,971,970,0,13,1,478,477,0.0,0.0006467204465774873,1,750,749,3,-1,4,5,0,612,887,218
111,0,102,1,948,947,0,4,1,380,379,0.0,0.00013615167296368154,1,535,534,4,-1,5,3,0,718,843,899
112,202,818,949,995,46,186,206,940,956,16,0.00445896728956057,0.005786446100956465,947,959,12,2,2,2,13,25,41,47,177
113,8,214,514,969,455,14,18,452,496,44,6.807583648184077e-05,0.0005446066918547262,450,725,275,3,4,4,5,5,392,476,387
114,6,6,453,453,0,11,11,465,465,0,0.00010211375472276115,0.00010211375472276115,483,483,0,-1,4,4,4,2,401,550,767
115,28,129,765,942,177,42,42,864,864,0,0.0006467204465774873,0.0006467204465774873,748,748,0,5,3,3,5,6,663,494,238
116,0,0,1,1,0,0,0,1,1,0,0.0,0.0,1,1,0,-1,-1,-1,11,0,174,812,548
117,0,206,1,985,984,0,9,1,588,587,0.0,0.000442492937131965,1,695,694,3,-1,4,3,0,852,880,253
118,14,14,627,627,0,16,16,555,555,0,0.0002042275094455223,0.0002042275094455223,565,565,0,-1,4,4,4,8,787,477,835
119,3,3,473,473,0,4,4,446,446,0,3.4037918240920386e-05,3.4037918240920386e-05,407,407,0,-1,5,5,2,2,985,549,735
120,0,616,1,994,993,0,44,1,688,687,0.0,0.0025188059498281084,1,907,906,2,-1,3,7,2,118,684,141
121,0,101,1,925,924,0,3,1,331,330,0.0,0.0,1,1,0,8,-1,9,3,0,583,426,972
122,20,20,795,795,0,18,18,844,844,0,0.0005105687736138058,0.0005105687736138058,733,733,0,-1,4,4,3,6,812,658,823
123,1,1641,333,1000,667,4,50,333,909,576,0.0,0.0265495762279179,1,996,995,1,6,2,4,1,424,603,50
124,16,16,597,597,0,35,35,667,667,0,0.0002042275094455223,0.0002042275094455223,569,569,0,-1,3,3,7,4,698,512,513
125,0,102,1,920,919,0,7,1,401,400,0.0,0.0002382654276864427,1,586,585,4,-1,5,4,0,741,973,291
126,1,102,331,954,623,3,3,331,331,0,0.0,0.0,1,1,0,5,8,6,3,2,875,582,663
127,99,201,899,963,64,70,70,903,903,0,0.0017359338302869397,0.0018720855032506212,864,873,9,4,3,3,5,18,382,82,178
128,131,337,905,973,68,178,178,896,896,0,0.0018040096667687805,0.0020082371762143027,869,877,8,3,3,3,18,19,29,144,252
129,6,6,387,387,0,41,41,421,421,0,0.0,0.0,1,1,0,-1,4,4,19,1,38,879,751
130,0,206,1,972,971,0,14,1,469,468,0.0,0.0002723033459273631,1,627,626,3,-1,4,5,0,616,614,245
131,1,1,333,333,0,2,2,333,333,0,0.0,0.0,1,1,0,-1,6,6,2,3,589,748,542
132,78,284,891,982,91,40,40,822,822,0,0.001497668402600497,0.0015317063208414173,863,866,3,3,3,3,5,17,574,96,762
133,6,108,468,931,463,18,18,658,658,0,0.000442492937131965,0.0005105687736138058,702,725,23,4,4,4,3,1,588,168,762
134,6,212,461,974,513,16,16,554,554,0,0.00013615167296368154,0.0006126825283365669,520,744,224,3,4,4,4,1,617,741,295
135,118,118,907,907,0,82,82,840,840,0,0.0016338200755641784,0.0016338200755641784,854,854,0,-1,3,3,7,19,193,59,669
136,100,100,866,866,0,100,100,787,787,0,0.01695088328397835,0.016984921202219273,991,991,0,3,1,1,11,23,227,106,566
137,8,214,486,953,467,46,50,504,519,15,0.0002723033459273631,0.00034037918240920387,597,631,34,3,4,4,13,3,160,441,531
138,0,0,1,1,0,0,0,1,1,0,0.0,0.0,1,1,0,-1,-1,-1,8,0,411,522,820
139,75,75,921,921,0,22,22,837,837,0,0.0018040096667687805,0.0018040096667687805,878,878,0,-1,3,3,2,17,618,45,472
140,9,9,541,541,0,20,20,564,564,0,0.00010211375472276115,0.00010211375472276115,485,485,0,-1,4,4,4,3,516,458,773
141,49,151,843,948,105,34,34,797,797,0,0.0013274788113958951,0.0013955546478777359,849,860,11,4,3,3,4,11,401,193,617
142,7,213,484,957,473,29,33,467,487,20,0.00010211375472276115,0.001157289220191293,474,815,341,3,4,4,11,2,379,566,193
143,10,216,574,972,398,12,16,483,540,57,6.807583648184077e-05,0.00176997174852786,447,871,424,3,4,4,4,3,545,353,203
144,65,271,898,987,89,12,12,655,655,0,0.002110350930937064,0.002280540522141666,902,909,7,3,4,4,2,22,874,203,285
145,0,0,1,1,0,0,0,1,1,0,0.0,0.0,1,1,0,-1,-1,-1,8,0,434,911,744
146,6,108,506,952,446,8,8,589,589,0,0.00017018959120460194,0.0006807583648184077,555,775,220,4,4,4,2,1,821,667,193
147,186,287,978,988,10,48,48,967,967,0,0.006297014874570271,0.006331052792811192,968,968,0,5,3,3,3,49,535,31,383
148,36,242,805,979,174,38,38,886,886,0,0.0009530617107457708,0.001599782157323258,802,868,66,3,3,3,3,6,855,234,412
149,0,101,1,919,918,0,2,1,331,330,0.0,3.4037918240920386e-05,1,387,386,5,-1,6,2,3,893,882,896
150,0,206,1,970,969,0,26,1,637,636,0.0,0.0053099152455835805,1,959,958,3,-1,4,5,0,656,367,70
151,0,206,1,977,976,0,8,1,502,501,0.0,0.0004084550188910446,1,683,682,3,-1,4,2,0,761,522,351
152,50,152,865,968,103,12,12,640,640,0,0.00176997174852786,0.001940161339732462,887,891,4,4,4,4,2,17,816,60,263
153,2,104,388,957,569,3,4,393,451,58,0.0,0.00017018959120460194,1,566,565,4,5,5,2,1,974,853,557
154,40,40,707,707,0,164,164,855,855,0,0.0008509479560230097,0.0008509479560230097,771,771,0,-1,2,2,15,1,51,480,811
155,307,409,985,992,7,54,54,930,930,0,0.00616086320160659,0.0061949011198475104,968,969,1,4,3,3,4,61,562,14,464
156,0,0,1,1,0,0,0,1,1,0,0.0,0.0,1,1,0,-1,-1,-1,3,1,855,835,498
157,0,102,1,944,943,0,3,1,378,377,0.0,0.0002042275094455223,1,583,582,4,-1,5,2,0,986,686,537
158,0,616,1,989,988,0,122,1,788,787,0.0,0.00793083495013445,1,969,968,2,-1,3,15,0,81,635,1
159,22,22,623,623,0,63,63,605,605,0,0.00010211375472276115,0.00010211375472276115,487,487,0,-1,3,3,12,3,44,290,445
160,0,206,1,948,947,0,36,1,471,470,0.0,0.0006807583648184077,1,743,742,3,-1,4,12,0,116,768,147
161,12,113,650,954,304,12,12,678,678,0,0.0008169100377820892,0.0008169100377820892,790,790,0,6,4,4,2,2,895,475,788
162,1,1,330,330,0,11,11,330,330,0,0.0,0.0,1,1,0,-1,6,6,11,2,271,663,478
163,0,101,1,909,908,0,5,1,332,331,0.0,0.00010211375472276115,1,484,483,5,-1,6,5,0,390,356,360
164,1,102,333,950,617,2,2,333,333,0,0.0,3.4037918240920386e-05,1,404,403,5,6,6,2,1,809,896,661
165,6,212,432,970,538,10,14,454,540,86,0.0,0.00013615167296368154,1,507,506,3,4,4,3,1,930,449,406
166,0,1640,1,1000,999,0,102,1,918,917,0.0,0.017903944994724124,1,990,989,1,-1,2,8,0,646,816,24
167,109,109,916,916,0,38,38,799,799,0,0.0020082371762143027,0.0020082371762143027,886,886,0,-1,3,3,3,26,837,127,423
168,22,228,780,986,206,18,18,775,775,0,0.0005786446100956465,0.0007488342013002485,727,772,45,3,4,4,3,9,875,245,379
169,91,91,901,901,0,50,50,850,850,0,0.00176997174852786,0.00176997174852786,872,872,0,-1,3,3,5,20,688,71,478
170,100,100,825,825,0,100,100,458,458,0,0.0160318594914735,0.0160318594914735,992,992,0,-1,1,1,33,75,9,24,864
171,1,207,332,987,655,2,7,332,599,267,0.0,0.0004084550188910446,1,702,701,3,8,4,2,1,987,857,210
172,4,4,479,479,0,3,3,392,392,0,6.807583648184077e-05,6.807583648184077e-05,463,463,0,-1,5,5,2,3,868,534,620
173,0,102,1,905,904,0,7,1,349,348,0.0,0.0,1,1,0,4,-1,5,6,0,498,400,225
174,10,10,607,607,0,10,10,517,517,0,0.0004084550188910446,0.0004084550188910446,681,681,0,-1,4,4,3,4,716,365,963
175,8,109,562,943,381,8,8,500,500,0,3.4037918240920386e-05,6.807583648184077e-05,408,452,44,5,4,4,2,2,779,251,596
176,12,628,501,990,489,60,70,587,647,60,0.00037441710065012424,0.0008509479560230097,658,765,107,2,4,3,12,2,87,473,318
177,341,443,986,992,6,102,102,997,997,0,0.009939072126348753,0.010075223799312433,984,984,0,4,2,2,4,59,401,5,244
178,0,0,1,1,0,0,0,1,1,0,0.0,0.0,1,1,0,-1,-1,-1,10,2,161,709,998
179,2,2,347,347,0,23,23,360,360,0,0.0,0.0,1,1,0,-1,5,5,20,2,88,692,918
180,0,102,1,926,925,0,6,1,367,366,0.0,3.4037918240920386e-05,1,405,404,4,-1,5,5,0,376,201,503
181,72,688,828,995,167,104,114,762,797,35,0.0007828721195411688,0.0017359338302869397,765,862,97,2,3,3,14,15,47,219,326
182,2,2,356,356,0,8,8,366,366,0,3.4037918240920386e-05,3.4037918240920386e-05,408,408,0,-1,5,5,6,2,378,656,875
183,1,103,333,931,598,3,5,333,383,50,0.0,0.00013615167296368154,1,521,520,4,6,5,3,2,842,357,325
184,33,135,780,945,165,44,44,846,846,0,0.0015317063208414173,0.0018040096667687805,861,876,15,4,3,3,4,3,559,438,770
185,30,646,659,993,334,110,128,738,800,62,0.00034037918240920387,0.008407365805507334,644,968,324,2,3,3,16,5,72,252,10
186,3,104,420,926,506,8,8,436,436,0,3.4037918240920386e-05,3.4037918240920386e-05,416,416,0,5,5,5,4,3,740,441,331
187,16,16,520,520,0,94,94,623,623,0,0.0002382654276864427,0.0002382654276864427,587,587,0,-1,3,3,18,1,86,689,515
188,16,118,648,935,287,26,26,728,728,0,0.00010211375472276115,0.0002042275094455223,489,588,99,4,3,3,4,1,649,666,110
189,24,24,588,588,0,76,76,483,483,0,6.807583648184077e-05,6.807583648184077e-05,452,452,0,-1,3,3,22,4,18,581,860
190,58,1698,880,1000,120,38,72,923,990,67,0.002280540522141666,0.03621634500833929,905,997,92,1,3,2,3,18,953,63,443
191,6,6,418,418,0,16,16,450,450,0,0.0,0.0,1,1,0,-1,4,4,6,1,470,506,388
192,52,258,772,961,189,130,130,799,799,0,0.0011913271384322134,0.0015317063208414173,815,863,48,3,3,3,15,7,65,150,289
193,0,0,1,1,0,0,0,1,1,0,0.0,0.0,1,1,0,-1,-1,-1,5,0,557,965,925
194,6,108,541,966,425,8,8,599,599,0,0.0002723033459273631,0.0005446066918547262,630,743,113,4,4,4,2,1,805,500,389
195,14,220,581,961,380,34,42,547,593,46,0.00010211375472276115,0.001055175465468532,491,800,309,3,4,4,9,7,289,451,206
196,41,143,801,952,151,42,42,829,829,0,0.0010892133837094523,0.0012594029749140542,819,837,18,4,3,3,5,6,502,368,350
197,0,206,1,952,951,0,15,1,385,384,0.0,0.0002723033459273631,1,598,597,3,-1,4,10,0,254,863,509
198,0,206,1,971,970,0,10,1,486,485,0.0,0.0005105687736138058,1,720,719,3,-1,4,3,0,620,359,233
199,0,101,1,887,886,0,11,1,332,331,0.0,0.0,1,1,0,5,-1,6,11,0,234,886,896
200,0,206,1,950,949,0,46,1,500,499,0.0,0.0013955546478777359,1,832,831,3,-1,4,13,0,120,900,95
201,0,206,1,977,976,0,8,1,496,495,0.0,0.00017018959120460194,1,558,557,3,-1,4,3,0,716,880,444
202,1,1,332,332,0,2,2,332,332,0,0.0,0.0,1,1,0,-1,7,7,2,1,974,469,851
203,0,101,1,919,918,0,4,1,332,331,0.0,0.0,1,1,0,5,-1,6,4,0,741,917,743
204,107,107,899,899,0,72,72,852,852,0,0.001599782157323258,0.001599782157323258,860,860,0,-1,3,3,7,18,335,54,943
205,6,6,504,504,0,12,12,634,634,0,0.00017018959120460194,0.00017018959120460194,562,562,0,-1,4,4,2,1,681,711,832
206,8,109,566,942,376,4,4,406,406,0,6.807583648184077e-05,6.807583648184077e-05,450,450,0,9,5,5,2,5,734,274,647
207,17,118,650,930,280,20,20,694,694,0,0.0002042275094455223,0.0002042275094455223,566,566,0,5,3,3,3,3,687,263,893
208,90,192,894,962,68,46,46,802,802,0,0.0013274788113958951,0.0018040096667687805,842,871,29,4,3,3,5,19,396,59,386
209,0,206,1,946,945,0,37,1,470,469,0.0,0.000442492937131965,1,681,680,3,-1,4,13,0,185,651,257
210,12,114,592,934,342,22,22,576,576,0,0.0006126825283365669,0.0008509479560230097,742,787,45,4,4,4,5,2,517,524,467
211,52,153,837,948,111,30,30,704,704,0,0.0008509479560230097,0.0008509479560230097,796,796,0,6,3,3,4,7,694,422,344
212,30,132,770,942,172,34,34,738,738,0,0.0005446066918547262,0.0006467204465774873,732,763,31,4,3,3,4,4,652,328,567
213,1,103,331,976,645,2,4,331,525,194,0.0,0.0004765308553728854,1,717,716,4,6,5,2,1,973,687,64
214,0,0,1,1,0,0,0,1,1,0,0.0,0.0,1,1,0,-1,-1,-1,7,0,193,894,726
215,16,16,619,619,0,28,28,688,688,0,0.0007147962830593281,0.0007147962830593281,762,762,0,-1,3,3,5,1,519,869,851
216,2,2,371,371,0,5,5,410,410,0,3.4037918240920386e-05,3.4037918240920386e-05,394,394,0,-1,5,5,3,1,523,606,735
217,13,219,638,978,340,12,12,520,520,0,0.00010211375472276115,0.0009190237925048504,493,801,308,3,4,4,4,5,679,314,147
218,0,101,1,945,944,0,3,1,330,329,0.0,3.4037918240920386e-05,1,399,398,5,-1,6,3,0,790,803,441
219,8,624,572,999,427,10,28,523,835,312,0.00013615167296368154,0.006943735321147759,517,968,451,2,4,3,3,3,785,505,9
220,5,106,521,959,438,5,5,432,432,0,6.807583648184077e-05,0.00017018959120460194,452,562,110,5,5,5,3,6,668,406,904
221,7,109,517,923,406,12,12,487,487,0,0.0002042275094455223,0.00030634126416828345,577,643,66,4,4,4,4,3,401,631,904
222,1,617,333,992,659,22,63,333,455,122,0.0,0.0009530617107457708,1,784,783,2,6,3,22,1,33,437,366
223,0,206,1,962,961,0,14,1,440,439,0.0,0.000442492937131965,1,680,679,3,-1,4,5,0,546,426,246
224,288,494,984,995,11,38,38,882,882,0,0.00622893903808843,0.007386228258279724,967,975,8,3,3,3,3,55,620,21,82
225,8,214,550,977,427,5,10,393,492,99,0.00010211375472276115,0.0013615167296368155,493,852,359,3,5,4,3,4,844,164,71
226,0,101,1,905,904,0,6,1,332,331,0.0,0.0,1,1,0,5,-1,6,6,0,419,838,225
227,16,632,498,991,493,53,88,442,554,112,0.0002042275094455223,0.0009870996289866913,554,788,234,2,4,3,19,4,46,208,224
228,8,8,535,535,0,30,30,710,710,0,3.4037918240920386e-05,3.4037918240920386e-05,400,400,0,-1,4,4,5,2,795,628,932
229,133,133,935,935,0,54,54,869,869,0,0.003165526396405596,0.003165526396405596,933,933,0,-1,3,3,4,20,567,94,632
230,0,616,1,994,993,0,58,1,550,549,0.0,0.0013615167296368155,1,839,838,2,-1,3,14,0,79,836,103
231,0,0,1,1,0,0,0,1,1,0,0.0,0.0,1,1,0,-1,-1,-1,3,0,899,922,841
232,19,225,600,952,352,84,104,593,679,86,0.00030634126416828345,0.0022465026039007454,615,890,275,3,3,3,17,4,63,287,44
233,0,101,1,945,944,0,2,1,331,330,0.0,6.807583648184077e-05,1,460,459,5,-1,6,2,0,951,975,579
234,0,0,1,1,0,0,0,1,1,0,0.0,0.0,1,1,0,-1,-1,-1,5,0,557,600,664
235,0,206,1,944,943,0,51,1,501,500,0.0,0.00037441710065012424,1,655,654,3,-1,4,14,1,108,428,160
236,6,6,380,380,0,36,36,390,390,0,0.0,0.0,1,1,0,-1,4,4,21,3,3,466,644
237,19,225,683,976,293,20,20,591,591,0,0.00030634126416828345,0.0014636304843595766,639,856,217,3,4,4,4,5,475,241,180
238,72,72,873,873,0,68,68,948,948,0,0.002757071377514551,0.002757071377514551,917,917,0,-1,2,2,4,14,444,190,854
239,84,700,846,993,147,118,128,818,851,33,0.0016678579938050988,0.003369753905851118,857,927,70,2,3,3,13,11,91,166,269
240,6,622,427,996,569,24,42,553,730,177,0.00030634126416828345,0.0022465026039007454,625,899,274,2,4,3,6,2,251,670,84
241,17,223,659,973,314,18,18,529,529,0,0.0005786446100956465,0.0006807583648184077,719,755,36,3,4,4,5,6,430,516,149
242,27,129,802,957,155,24,24,838,838,0,0.0013274788113958951,0.0013955546478777359,846,850,4,4,3,3,3,10,911,272,570
243,7,109,513,922,409,12,14,453,474,21,0.00013615167296368154,0.0006126825283365669,511,734,223,4,4,4,5,5,656,476,516
244,0,206,1,975,974,0,8,1,484,483,0.0,0.00030634126416828345,1,647,646,3,-1,4,2,0,804,957,305
245,4,106,415,909,494,5,5,377,377,0,3.4037918240920386e-05,0.0006467204465774873,407,754,347,4,5,5,3,2,471,547,194
246,65,65,862,862,0,62,62,954,954,0,0.005071649817897137,0.005071649817897137,962,962,0,-1,2,2,3,5,930,216,446
247,98,200,922,976,54,38,38,897,897,0,0.0028932230504782326,0.003778208924742163,920,935,15,4,3,3,3,24,288,129,281
248,100,100,943,943,0,100,100,996,996,0,0.051363218625548865,0.05200993907212635,999,1000,1,3,1,1,3,8,798,257,264
249,30,236,827,985,158,20,20,741,741,0,0.0007828721195411688,0.0014295925661186562,785,855,70,3,4,4,4,16,860,113,490
250,56,56,848,848,0,60,60,898,898,0,0.0020422750944552232,0.0020422750944552232,888,888,0,-1,3,3,5,8,314,174,912
251,2,208,387,980,593,4,8,468,570,102,0.0,0.003608019333537561,1,946,945,3,5,4,2,2,995,544,5
252,2,104,353,909,556,12,13,382,385,3,0.0,0.0,1,1,0,4,5,5,8,2,286,320,337
253,6,212,482,977,495,18,18,678,678,0,0.00034037918240920387,0.002825147213996392,666,922,256,3,4,4,3,1,530,869,108
254,0,0,1,1,0,0,0,1,1,0,0.0,0.0,1,1,0,-1,-1,-1,4,2,641,431,359
255,6,108,538,967,429,6,6,480,480,0,0.0002723033459273631,0.00030634126416828345,636,660,24,4,5,5,3,5,853,562,110
256,16,632,642,999,357,16,26,546,744,198,0.00030634126416828345,0.004118588107151367,629,947,318,2,4,3,4,6,550,258,126
257,85,187,861,949,88,78,78,787,787,0,0.0017018959120460194,0.0017359338302869397,862,865,3,4,3,3,8,15,434,206,300
258,0,102,1,905,904,0,8,1,363,362,0.0,0.00010211375472276115,1,478,477,4,-1,5,6,0,498,740,231
259,37,37,835,835,0,18,18,736,736,0,0.0012934408931549745,0.0012934408931549745,847,847,0,-1,4,4,3,11,535,166,632
260,1,103,332,926,594,2,4,332,382,50,0.0,0.0002382654276864427,1,601,600,4,6,5,2,2,971,739,688
261,53,53,890,890,0,22,22,860,860,0,0.0018040096667687805,0.0018040096667687805,888,888,0,-1,3,3,2,17,994,131,815
262,2,208,360,967,607,10,14,435,472,37,6.807583648184077e-05,0.0004765308553728854,460,712,252,3,5,4,5,4,565,512,150
263,12,114,579,929,350,24,24,613,613,0,0.0002382654276864427,0.000442492937131965,592,688,96,4,4,4,4,4,304,346,797
264,0,0,1,1,0,0,0,1,1,0,0.0,0.0,1,1,0,-1,-1,-1,7,0,216,848,665
265,6,108,465,939,474,12,12,518,518,0,6.807583648184077e-05,0.0007488342013002485,450,769,319,4,4,4,4,1,603,152,190
266,110,316,892,975,83,124,124,834,834,0,0.0013615167296368155,0.001497668402600497,837,846,9,3,3,3,13,18,67,64,354
267,1,1,332,332,0,2,2,332,332,0,0.0,0.0,1,1,0,-1,7,7,2,1,993,972,673
268,29,645,715,994,279,46,56,668,735,67,0.00034037918240920387,0.0013955546478777359,637,836,199,2,3,3,8,5,325,487,610
269,2,2,379,379,0,3,3,382,382,0,3.4037918240920386e-05,3.4037918240920386e-05,419,419,0,-1,5,5,2,2,928,509,936
270,22,638,639,993,354,56,66,651,734,83,0.0002382654276864427,0.001055175465468532,593,803,210,2,3,3,9,2,213,770,683
271,0,0,1,1,0,0,0,1,1,0,0.0,0.0,1,1,0,-1,-1,-1,5,0,247,974,932
272,36,137,775,938,163,44,44,836,836,0,0.001157289220191293,0.0012253650566731338,831,838,7,5,3,3,4,5,717,403,319
273,6,6,412,412,0,24,24,472,472,0,6.807583648184077e-05,6.807583648184077e-05,443,443,0,-1,4,4,8,2,350,544,986
274,5,107,487,945,458,4,4,407,407,0,3.4037918240920386e-05,0.0007147962830593281,399,768,369,4,5,5,2,4,713,398,53
275,41,247,854,985,131,12,12,633,633,0,0.0008509479560230097,0.0016678579938050988,799,881,82,3,4,4,2,19,469,184,186
276,14,116,515,888,373,64,64,525,525,0,0.0002723033459273631,0.0002723033459273631,595,595,0,4,4,4,16,3,59,93,506
277,100,100,856,856,0,190,190,875,875,0,0.0011232513019503727,0.0011232513019503727,811,811,0,-1,3,3,18,12,34,163,800
278,18,18,645,645,0,56,56,839,839,0,0.0002042275094455223,0.0002042275094455223,569,569,0,-1,3,3,6,3,587,354,951
279,50,256,844,977,133,36,36,768,768,0,0.0007488342013002485,0.0012594029749140542,762,830,68,3,3,3,5,12,601,159,160
280,0,206,1,940,939,0,34,1,393,392,0.0,0.00030634126416828345,1,624,623,3,-1,4,19,0,148,844,521
281,6,107,469,935,466,12,12,604,604,0,0.0,0.0,1,1,0,6,4,4,2,1,589,609,671
282,2,2,370,370,0,5,5,394,394,0,0.0,0.0,1,1,0,-1,5,5,3,1,710,530,789
283,136,342,934,983,49,52,52,841,841,0,0.0019741992579733825,0.0024166921951053475,873,894,21,3,3,3,6,27,575,61,136
284,14,115,620,938,318,14,14,543,543,0,0.00034037918240920387,0.00037441710065012424,648,665,17,5,4,4,3,3,626,93,837
285,125,226,939,973,34,44,44,856,856,0,0.0022465026039007454,0.0022465026039007454,899,899,0,6,3,3,4,23,280,106,357
286,1,103,332,934,602,3,5,332,391,59,0.0,0.00030634126416828345,1,628,627,4,6,5,3,3,912,708,232
287,0,0,1,1,0,0,0,1,1,0,0.0,0.0,1,1,0,-1,-1,-1,7,0,364,740,877
288,0,0,1,1,0,0,0,1,1,0,0.0,0.0,1,1,0,-1,-1,-1,8,0,158,826,554
289,8,8,513,513,0,16,16,495,495,0,0.00013615167296368154,0.00013615167296368154,522,522,0,-1,4,4,4,2,870,724,901
290,2,104,365,919,554,8,9,390,409,19,3.4037918240920386e-05,3.4037918240920386e-05,406,406,0,4,5,5,5,1,464,853,607
291,0,0,1,1,0,0,0,1,1,0,0.0,0.0,1,1,0,-1,-1,-1,14,0,85,728,201
292,30,236,676,956,280,66,70,623,647,24,0.00034037918240920387,0.0006807583648184077,640,733,93,3,3,3,12,9,87,29,258
293,3,104,429,925,496,5,5,381,381,0,0.0,0.0,1,1,0,7,5,5,3,3,620,563,972
294,2,208,361,972,611,4,14,362,519,157,3.4037918240920386e-05,0.0010892133837094523,401,818,417,3,5,4,3,3,834,484,174
295,0,0,1,1,0,0,0,1,1,0,0.0,0.0,1,1,0,-1,-1,-1,5,0,452,349,644
296,0,101,1,918,917,0,2,1,331,330,0.0,0.00013615167296368154,1,522,521,5,-1,6,2,0,909,974,631
297,2,103,381,954,573,5,5,387,387,0,0.0,0.00013615167296368154,1,527,526,5,5,5,4,1,860,878,411
298,39,39,831,831,0,30,30,810,810,0,0.0010892133837094523,0.0010892133837094523,824,824,0,-1,3,3,4,9,603,375,955
299,0,0,1,1,0,0,0,1,1,0,0.0,0.0,1,1,0,-1,-1,-1,7,0,221,915,955
300,94,94,910,910,0,40,40,798,798,0,0.0026209197045508697,0.0026209197045508697,908,908,0,-1,3,3,5,27,435,69,962
301,6,212,379,944,565,33,64,401,512,111,3.4037918240920386e-05,0.0012594029749140542,401,831,430,3,4,4,16,1,27,639,180
302,0,1640,1,1000,999,0,58,1,903,902,0.0,0.031212771026923995,1,996,995,1,-1,2,4,0,493,766,37
303,8,214,462,949,487,47,52,460,482,22,0.00013615167296368154,0.0002042275094455223,503,570,67,3,4,4,16,3,195,441,323
304,2,208,358,966,608,5,24,358,589,231,0.0,0.0017018959120460194,1,871,870,3,5,4,4,1,493,893,116
305,0,0,1,1,0,0,0,1,1,0,0.0,0.0,1,1,0,-1,-1,-1,2,0,963,426,847
306,44,146,803,939,136,44,44,806,806,0,0.00088498587426393,0.0009190237925048504,790,793,3,4,3,3,4,9,509,245,618
307,26,128,755,943,188,24,24,681,681,0,0.0005446066918547262,0.0007147962830593281,723,767,44,4,4,4,4,10,619,272,198
308,8,214,487,958,471,20,46,417,584,167,0.0,0.0009870996289866913,1,803,802,3,4,4,9,2,245,602,206
309,0,102,1,865,864,0,26,1,353,352,0.0,0.0,1,1,0,4,-1,5,24,0,28,993,460
310,0,206,1,980,979,0,14,1,624,623,0.0,0.0030293747234419145,1,929,928,3,-1,4,3,0,654,816,48
311,0,102,1,903,902,0,7,1,355,354,0.0,0.0,1,1,0,4,-1,5,6,0,451,997,321
312,59,59,789,789,0,136,136,789,789,0,0.0006807583648184077,0.0006807583648184077,743,743,0,-1,3,3,15,11,51,83,967
313,11,113,680,965,285,8,8,592,592,0,0.00037441710065012424,0.0007488342013002485,681,770,89,4,4,4,2,5,997,124,295
314,0,0,1,1,0,0,0,1,1,0,0.0,0.0,1,1,0,-1,-1,-1,8,0,257,997,898
315,0,102,1,941,940,0,4,1,375,374,0.0,0.00010211375472276115,1,493,492,4,-1,5,3,0,916,695,670
316,34,135,719,921,202,42,42,561,561,0,0.0004765308553728854,0.0004765308553728854,701,701,0,5,4,4,9,10,245,262,563
317,1,207,332,972,640,3,8,332,474,142,0.0,0.0002723033459273631,1,624,623,3,6,4,3,1,923,140,530
318,0,101,1,960,959,0,2,1,331,330,0.0,0.0,1,1,0,5,-1,6,2,0,847,946,958
319,0,0,1,1,0,0,0,1,1,0,0.0,0.0,1,1,0,-1,-1,-1,10,0,169,776,990
320,0,0,1,1,0,0,0,1,1,0,0.0,0.0,1,1,0,-1,-1,-1,5,1,386,780,999
321,28,129,730,929,199,52,52,779,779,0,0.0006467204465774873,0.0006467204465774873,742,742,0,5,3,3,7,4,477,407,788
322,0,616,1,988,987,0,286,1,802,801,0.0,0.006297014874570271,1,958,957,2,-1,3,33,0,9,433,32
323,14,116,591,929,338,24,24,623,623,0,0.00037441710065012424,0.0005446066918547262,648,714,66,4,4,4,4,3,887,280,86
324,17,17,663,663,0,34,34,738,738,0,0.0002723033459273631,0.0002723033459273631,620,620,0,-1,3,3,4,2,304,323,926
325,0,0,1,1,0,0,0,1,1,0,0.0,0.0,1,1,0,-1,-1,-1,3,0,857,793,946
326,56,158,860,957,97,28,28,772,772,0,0.002586881786309949,0.0026549576227917903,905,907,2,4,3,3,3,15,592,158,301
327,0,206,1,970,969,0,16,1,544,543,0.0,0.00034037918240920387,1,653,652,3,-1,4,5,0,908,834,317
328,0,102,1,865,864,0,25,1,351,350,0.0,0.0,1,1,0,4,-1,5,23,1,8,513,885
329,8,214,556,975,419,18,18,651,651,0,0.0006126825283365669,0.0013274788113958951,751,848,97,3,4,4,3,3,699,299,92
330,0,0,1,1,0,0,0,1,1,0,0.0,0.0,1,1,0,-1,-1,-1,12,1,194,583,429
331,0,102,1,928,927,0,3,1,370,369,0.0,6.807583648184077e-05,1,448,447,4,-1,5,2,0,752,934,441
332,44,44,794,794,0,44,44,705,705,0,0.00034037918240920387,0.00034037918240920387,648,648,0,-1,3,3,7,11,362,316,917
333,2,2,386,386,0,4,4,451,451,0,0.00013615167296368154,0.00013615167296368154,514,514,0,-1,5,5,2,2,890,223,672
334,8,8,620,620,0,8,8,609,609,0,0.00010211375472276115,0.00010211375472276115,490,490,0,-1,4,4,2,2,873,453,966
335,19,635,687,997,310,18,36,528,760,232,0.00037441710065012424,0.007692569522448007,662,973,311,2,4,3,5,5,533,591,30
336,22,228,750,983,233,12,12,698,698,0,0.0006807583648184077,0.00176997174852786,764,885,121,3,4,4,2,9,906,414,58
337,22,22,782,782,0,12,12,706,706,0,0.0006467204465774873,0.0006467204465774873,769,769,0,-1,4,4,2,5,914,273,324
338,0,206,1,978,977,0,9,1,504,503,0.0,0.0005786446100956465,1,731,730,3,-1,4,4,2,789,431,314
339,0,102,1,929,928,0,4,1,361,360,0.0,0.00010211375472276115,1,492,491,4,-1,5,3,0,801,574,631
340,8,624,501,994,493,22,48,483,701,218,3.4037918240920386e-05,0.002382654276864427,399,902,503,2,4,3,7,2,450,408,297
341,16,16,634,634,0,18,18,620,620,0,0.00030634126416828345,0.00030634126416828345,634,634,0,-1,4,4,3,5,636,252,887
342,0,616,1,990,989,0,98,1,735,734,0.0,0.006433166547533953,1,967,966,2,-1,3,12,1,239,705,19
343,0,101,1,886,885,0,11,1,332,331,0.0,0.0,1,1,0,5,-1,6,11,0,230,989,578
344,0,0,1,1,0,0,0,1,1,0,0.0,0.0,1,1,0,-1,-1,-1,3,0,918,915,995
345,0,616,1,996,995,0,32,1,603,602,0.0,0.0011232513019503727,1,820,819,2,-1,3,7,0,658,963,227
346,2,618,364,999,635,3,22,365,759,394,6.807583648184077e-05,0.007011811157629599,461,975,514,2,5,3,2,1,643,592,6
347,197,298,957,977,20,110,110,904,904,0,0.003608019333537561,0.003608019333537561,932,932,0,5,3,3,10,38,427,111,748
348,32,132,775,939,164,50,50,846,846,0,0.001055175465468532,0.00176997174852786,823,872,49,4,3,3,5,5,552,403,62
349,22,228,597,952,355,104,104,628,628,0,0.0004084550188910446,0.0004084550188910446,657,657,0,3,3,3,21,3,2,197,714
350,310,516,974,991,17,154,154,949,949,0,0.005446066918547262,0.005650294427992784,961,964,3,3,2,2,10,31,128,76,628
351,14,115,649,943,294,12,12,588,588,0,0.001055175465468532,0.0011913271384322134,819,838,19,5,4,4,2,7,598,224,755
352,2,103,367,933,566,7,7,413,413,0,6.807583648184077e-05,6.807583648184077e-05,446,446,0,5,5,5,4,1,581,837,873
353,0,206,1,950,949,0,30,1,474,473,0.0,0.00037441710065012424,1,654,653,3,-1,4,10,3,310,882,479
354,0,0,1,1,0,0,0,1,1,0,0.0,0.0,1,1,0,-1,-1,-1,2,0,715,864,930
355,215,215,963,963,0,110,110,918,918,0,0.003982436434187685,0.003982436434187685,943,943,0,-1,3,3,10,36,527,48,890
356,0,102,1,913,912,0,5,1,355,354,0.0,6.807583648184077e-05,1,452,451,4,-1,5,4,0,632,983,518
357,55,261,850,977,127,24,24,664,664,0,0.0009530617107457708,0.0012934408931549745,810,843,33,3,4,4,4,15,513,92,407
358,108,108,957,957,0,46,46,974,974,0,0.0053099152455835805,0.0053099152455835805,961,961,0,-1,2,2,2,26,809,127,693
359,6,622,381,993,612,41,90,478,691,213,0.0,0.003267640151128357,1,928,927,2,4,3,13,1,92,935,17
360,0,101,1,897,896,0,6,1,332,331,0.0,0.0,1,1,0,5,-1,6,6,0,368,822,736
361,6,6,525,525,0,8,8,562,562,0,0.00030634126416828345,0.00030634126416828345,655,655,0,-1,4,4,2,2,994,691,702
362,99,201,917,970,53,50,50,888,888,0,0.0019741992579733825,0.002144388849177984,884,892,8,4,3,3,5,23,376,117,282
363,142,244,939,974,35,54,54,875,875,0,0.0024507301133462676,0.002552843868069029,910,912,2,4,3,3,4,24,540,119,581
364,2,104,371,927,556,5,5,391,391,0,0.00013615167296368154,0.0002382654276864427,523,606,83,4,5,5,3,2,831,805,785
365,0,0,1,1,0,0,0,1,1,0,0.0,0.0,1,1,0,-1,-1,-1,3,0,737,429,898
366,32,648,728,997,269,58,58,758,758,0,0.00030634126416828345,0.0015317063208414173,621,855,234,2,3,3,7,2,171,827,440
367,24,230,695,971,276,34,34,736,736,0,0.0005105687736138058,0.0023486163586235067,703,897,194,3,3,3,4,4,887,557,38
368,46,46,746,746,0,110,110,750,750,0,0.0007147962830593281,0.0007147962830593281,750,750,0,-1,3,3,15,6,104,295,977
369,0,616,1,1000,999,0,17,1,931,930,0.0,0.009632730862180468,1,979,978,2,-1,3,2,0,956,965,467
370,0,0,1,1,0,0,0,1,1,0,0.0,0.0,1,1,0,-1,-1,-1,4,0,870,925,271
371,6,6,466,466,0,16,16,568,568,0,0.00017018959120460194,0.00017018959120460194,546,546,0,-1,4,4,4,1,696,394,953
372,2,2,391,391,0,3,3,396,396,0,3.4037918240920386e-05,3.4037918240920386e-05,396,396,0,-1,5,5,2,1,873,592,995
373,46,147,871,974,103,14,14,736,736,0,0.001599782157323258,0.0016338200755641784,865,866,1,5,4,4,3,13,918,335,748
374,6,6,399,399,0,25,25,461,461,0,0.00010211375472276115,0.00010211375472276115,473,473,0,-1,4,4,9,2,414,719,843
375,833,1039,1000,1000,0,88,88,973,973,0,0.019946220089179345,0.020797168045202357,995,995,0,3,2,2,4,130,736,3,630
376,8,8,539,539,0,10,10,471,471,0,0.0002382654276864427,0.0002382654276864427,606,606,0,-1,4,4,4,3,573,411,780
377,0,206,1,960,959,0,38,1,642,641,0.0,0.0031314884781646754,1,921,920,3,-1,4,7,0,335,228,25
378,193,399,971,988,17,54,54,927,927,0,0.005207801490860819,0.006092787365124749,957,964,7,3,3,3,4,35,635,57,232
379,15,15,610,610,0,22,22,549,549,0,0.0004084550188910446,0.0004084550188910446,683,683,0,-1,4,4,5,4,773,645,901
380,6,212,411,957,546,18,22,474,521,47,0.0002382654276864427,0.000442492937131965,575,682,107,3,4,4,5,1,496,500,454
381,6,6,382,382,0,53,53,463,463,0,3.4037918240920386e-05,3.4037918240920386e-05,400,400,0,-1,4,4,17,2,6,313,745
382,0,101,1,877,876,0,15,1,332,331,0.0,0.0,1,1,0,5,-1,6,15,0,45,966,503
383,229,435,952,980,28,192,192,933,933,0,0.0034037918240920387,0.003642057251778481,936,938,2,3,2,2,14,21,122,157,700
384,29,130,718,936,218,45,45,703,703,0,0.0012253650566731338,0.0013274788113958951,828,837,9,5,3,3,8,5,442,591,311
385,3,104,416,923,507,8,8,408,408,0,6.807583648184077e-05,0.00010211375472276115,441,480,39,5,5,5,4,3,700,373,495
386,6,6,426,426,0,10,10,469,469,0,0.0,0.0,1,1,0,-1,4,4,3,2,471,342,800
387,22,228,646,959,313,56,60,645,666,21,0.0004084550188910446,0.0010211375472276116,676,811,135,3,3,3,9,2,287,453,329
388,2,2,357,357,0,7,7,398,398,0,3.4037918240920386e-05,3.4037918240920386e-05,406,406,0,-1,5,5,4,1,753,577,843
389,15,116,695,963,268,12,12,673,673,0,0.0004765308553728854,0.0004765308553728854,708,708,0,7,4,4,2,6,951,459,181
390,6,107,443,918,475,12,12,496,496,0,0.00013615167296368154,0.00013615167296368154,514,514,0,6,4,4,4,1,520,797,331
391,10,216,532,960,428,21,38,453,585,132,3.4037918240920386e-05,0.0018720855032506212,400,873,473,3,4,4,9,3,168,534,69
392,124,124,894,894,0,122,122,841,841,0,0.0013274788113958951,0.0013274788113958951,832,832,0,-1,3,3,12,18,87,147,587
393,2,104,364,929,565,6,8,391,426,35,0.00010211375472276115,0.0006807583648184077,476,754,278,4,5,5,4,1,458,687,194
394,40,142,733,906,173,122,122,834,834,0,0.0008169100377820892,0.0008169100377820892,775,775,0,4,2,2,12,1,52,404,319
395,24,230,685,967,282,54,54,754,754,0,0.0007828721195411688,0.00088498587426393,777,791,14,3,3,3,7,4,216,326,301
396,2,2,359,359,0,4,4,360,360,0,3.4037918240920386e-05,3.4037918240920386e-05,404,404,0,-1,5,5,3,2,930,842,685
397,6,108,425,904,479,16,16,465,465,0,3.4037918240920386e-05,0.00010211375472276115,390,487,97,4,4,4,6,1,536,531,724
398,10,112,574,934,360,16,16,562,562,0,0.0002723033459273631,0.0007828721195411688,605,779,174,4,4,4,4,3,511,301,267
399,12,12,534,534,0,68,68,632,632,0,0.0006807583648184077,0.0006807583648184077,746,746,0,-1,4,4,12,2,106,473,271
400,0,0,1,1,0,0,0,1,1,0,0.0,0.0,1,1,0,-1,-1,-1,10,0,240,995,742
401,10,10,551,551,0,18,18,519,519,0,0.0002723033459273631,0.0002723033459273631,619,619,0,-1,4,4,5,5,406,722,668
402,0,102,1,954,953,0,3,1,391,390,0.0,0.00010211375472276115,1,506,505,4,-1,5,2,0,868,957,477
403,24,1664,655,1000,345,68,110,641,839,198,0.0002382654276864427,0.011981347220803976,589,982,393,1,3,2,11,3,76,173,12
404,0,616,1,991,990,0,44,1,572,571,0.0,0.0012934408931549745,1,823,822,2,-1,3,9,0,381,975,125
405,45,45,853,853,0,14,14,594,594,0,0.0007147962830593281,0.0007147962830593281,763,763,0,-1,4,4,3,19,590,184,624
406,100,100,862,862,0,100,100,805,805,0,0.014227849824704722,0.014364001497668403,990,991,1,4,1,1,12,12,183,163,682
407,0,0,1,1,0,0,0,1,1,0,0.0,0.0,1,1,0,-1,-1,-1,10,0,310,733,750
408,22,228,753,982,229,18,18,695,695,0,0.0005105687736138058,0.004901460226692535,709,953,244,3,4,4,3,8,902,204,33
409,12,113,583,928,345,24,24,645,645,0,0.0007488342013002485,0.0008169100377820892,765,778,13,5,4,4,4,4,384,440,527
410,6,108,369,875,506,52,52,420,420,0,0.0,0.0,1,1,0,4,4,4,23,2,4,690,320
411,24,126,716,936,220,22,22,569,569,0,0.00030634126416828345,0.0005786446100956465,637,726,89,4,4,4,5,7,284,115,670
412,2,208,360,970,610,4,10,362,467,105,0.0,0.00017018959120460194,1,552,551,3,5,4,3,1,839,540,891
413,61,163,847,947,100,56,56,823,823,0,0.0013955546478777359,0.0015657442390823377,847,857,10,4,3,3,6,11,341,97,101
414,0,102,1,937,936,0,5,1,411,410,0.0,0.0002723033459273631,1,624,623,4,-1,5,3,0,899,845,432
415,0,101,1,867,866,0,35,1,332,331,0.0,3.4037918240920386e-05,1,400,399,5,-1,6,35,0,20,953,578
416,6,6,407,407,0,27,27,465,465,0,6.807583648184077e-05,6.807583648184077e-05,435,435,0,-1,4,4,10,2,169,509,565
417,33,33,770,770,0,32,32,630,630,0,0.00034037918240920387,0.00034037918240920387,653,653,0,-1,4,4,6,7,526,176,542
418,93,299,890,981,91,44,44,818,818,0,0.0021784267674189047,0.0026549576227917903,893,912,19,3,3,3,4,19,516,91,389
419,7,213,509,970,461,17,21,516,598,82,0.00010211375472276115,0.0005786446100956465,485,733,248,3,4,4,5,3,476,196,479
420,6,6,537,537,0,12,12,637,637,0,0.0002723033459273631,0.0002723033459273631,631,631,0,-1,4,4,2,1,913,404,478
421,62,678,804,991,187,114,124,780,799,19,0.0007147962830593281,0.0028932230504782326,745,920,175,2,3,3,14,6,21,461,153
422,16,16,611,611,0,34,34,734,734,0,0.000442492937131965,0.000442492937131965,673,673,0,-1,3,3,4,1,822,404,548
423,0,206,1,971,970,0,10,1,471,470,0.0,0.0004765308553728854,1,707,706,3,-1,4,3,0,900,423,283
424,8,214,469,946,477,41,64,421,496,75,0.00013615167296368154,0.0005446066918547262,512,702,190,3,4,4,18,5,64,464,288
425,100,100,856,856,0,100,100,629,629,0,0.010824058000612683,0.010824058000612683,984,984,0,-1,1,1,18,12,111,58,813
426,76,178,889,964,75,44,44,858,858,0,0.0019741992579733825,0.002212464685659825,887,894,7,4,3,3,4,17,475,180,653
427,216,216,972,972,0,50,50,839,839,0,0.003369753905851118,0.003369753905851118,928,928,0,-1,3,3,5,44,524,27,735
428,9,111,600,943,343,18,18,669,669,0,0.0002382654276864427,0.001599782157323258,597,874,277,4,4,4,3,4,835,230,47
429,400,400,991,991,0,70,70,952,952,0,0.011028285510058205,0.011028285510058205,986,986,0,-1,3,3,5,91,580,7,860
430,10,216,555,966,411,41,42,587,597,10,0.00010211375472276115,0.00034037918240920387,496,646,150,3,4,4,11,6,261,406,454
431,9,9,539,539,0,28,28,526,526,0,0.00013615167296368154,0.00013615167296368154,506,506,0,-1,4,4,8,3,286,214,702
432,0,101,1,916,915,0,7,1,332,331,0.0,6.807583648184077e-05,1,450,449,5,-1,6,7,0,439,817,761
433,9,9,559,559,0,32,32,675,675,0,0.00034037918240920387,0.00034037918240920387,639,639,0,-1,4,4,6,5,494,619,909
434,163,265,961,981,20,64,64,966,966,0,0.005854521937438306,0.00622893903808843,963,969,6,4,2,2,4,27,610,88,827
435,23,125,809,971,162,8,8,591,591,0,0.0006467204465774873,0.0008169100377820892,749,785,36,4,4,4,2,12,968,159,541
436,116,217,913,963,50,68,68,815,815,0,0.002280540522141666,0.002382654276864427,899,902,3,5,3,3,8,24,146,129,196
437,41,143,774,936,162,62,62,789,789,0,0.0007147962830593281,0.0007828721195411688,753,765,12,4,3,3,7,6,171,232,599
438,0,0,1,1,0,0,0,1,1,0,0.0,0.0,1,1,0,-1,-1,-1,4,1,354,789,989
439,0,0,1,1,0,0,0,1,1,0,0.0,0.0,1,1,0,-1,-1,-1,12,0,292,813,944
440,9,111,653,969,316,8,8,615,615,0,0.0002723033459273631,0.0005786446100956465,634,755,121,4,4,4,2,3,866,458,589
441,7,213,505,973,468,20,20,553,553,0,0.00010211375472276115,0.0007147962830593281,479,758,279,3,4,4,4,2,822,700,97
442,0,0,1,1,0,0,0,1,1,0,0.0,0.0,1,1,0,-1,-1,-1,2,0,866,757,514
443,0,102,1,936,935,0,6,1,452,451,0.0,0.0008169100377820892,1,786,785,4,-1,5,3,0,961,707,59
444,0,102,1,936,935,0,4,1,371,370,0.0,6.807583648184077e-05,1,445,444,4,-1,5,3,0,961,911,208
445,80,80,851,851,0,110,110,873,873,0,0.0007147962830593281,0.0007147962830593281,740,740,0,-1,3,3,10,10,152,405,943
446,12,12,599,599,0,26,26,645,645,0,0.00010211375472276115,0.00010211375472276115,479,479,0,-1,4,4,5,2,430,468,813
447,52,258,812,971,159,88,88,878,878,0,0.0019741992579733825,0.0022465026039007454,877,898,21,3,2,2,8,3,443,382,759
448,20,226,665,967,302,28,28,566,566,0,0.000442492937131965,0.0015657442390823377,689,858,169,3,4,4,6,4,387,504,147
449,0,102,1,947,946,0,3,1,377,376,0.0,3.4037918240920386e-05,1,401,400,4,-1,5,2,0,684,548,662
450,3,3,452,452,0,4,4,405,405,0,6.807583648184077e-05,6.807583648184077e-05,447,447,0,-1,5,5,2,2,976,627,705
451,52,52,871,871,0,12,12,631,631,0,0.0010892133837094523,0.0010892133837094523,832,832,0,-1,4,4,2,17,776,96,747
452,410,1026,994,1000,6,96,96,991,991,0,0.020252561353347628,0.03441233534157051,993,997,4,2,2,2,3,85,756,0,23
453,9,215,515,958,443,23,27,445,486,41,0.00010211375472276115,0.00030634126416828345,481,644,163,3,4,4,9,3,140,411,645
454,67,273,919,993,74,38,38,954,954,0,0.0016678579938050988,0.004901460226692535,874,954,80,3,3,3,3,20,915,49,25
455,0,101,1,908,907,0,5,1,331,330,0.0,0.0,1,1,0,5,-1,6,5,0,669,989,676
456,17,17,641,641,0,42,42,745,745,0,0.0007488342013002485,0.0007488342013002485,761,761,0,-1,3,3,6,3,575,299,952
457,0,206,1,968,967,0,8,1,440,439,0.0,6.807583648184077e-05,1,443,442,3,-1,4,3,0,725,801,441
458,0,0,1,1,0,0,0,1,1,0,0.0,0.0,1,1,0,-1,-1,-1,2,0,905,970,832
459,6,6,407,407,0,21,21,424,424,0,3.4037918240920386e-05,3.4037918240920386e-05,402,402,0,-1,4,4,9,1,245,558,678
460,10,626,506,993,487,36,50,507,585,78,6.807583648184077e-05,0.0006126825283365669,447,734,287,2,4,3,10,7,128,451,168
461,6,6,415,415,0,14,14,435,435,0,3.4037918240920386e-05,3.4037918240920386e-05,399,399,0,-1,4,4,5,2,349,648,913
462,51,51,833,833,0,44,44,850,850,0,0.0017359338302869397,0.0017359338302869397,868,868,0,-1,3,3,4,9,539,277,947
463,1,1,333,333,0,8,8,333,333,0,0.0,0.0,1,1,0,-1,6,6,8,1,499,972,833
464,0,206,1,966,965,0,16,1,449,448,0.0,0.0007828721195411688,1,770,769,3,-1,4,6,0,470,838,97
465,29,29,786,786,0,18,18,693,693,0,0.0006467204465774873,0.0006467204465774873,754,754,0,-1,4,4,3,10,564,413,830
466,40,40,771,771,0,78,78,894,894,0,0.00088498587426393,0.00088498587426393,784,784,0,-1,3,3,7,5,196,338,868
467,16,118,579,911,332,16,16,428,428,0,0.00010211375472276115,0.00030634126416828345,488,640,152,4,4,4,6,4,378,164,505
468,8,109,578,951,373,12,12,714,714,0,0.0006126825283365669,0.0007147962830593281,753,776,23,5,4,4,2,5,876,535,931
469,1,1,333,333,0,4,4,333,333,0,0.0,0.0,1,1,0,-1,6,6,4,1,458,924,976
470,8,624,570,998,428,10,20,516,779,263,6.807583648184077e-05,0.003642057251778481,466,940,474,2,4,3,3,4,530,346,141
471,24,230,677,963,286,58,62,768,775,7,0.00034037918240920387,0.003199564314646516,650,928,278,3,3,3,7,4,417,479,75
472,26,128,769,949,180,24,24,768,768,0,0.0012253650566731338,0.0016338200755641784,837,876,39,4,3,3,3,5,729,308,396
473,630,630,993,993,0,296,296,998,998,0,0.01317267435923619,0.01317267435923619,984,984,0,-1,2,2,11,75,360,24,820
474,143,143,916,916,0,132,132,891,891,0,0.0024166921951053475,0.0024166921951053475,900,900,0,-1,3,3,12,15,184,53,789
475,1,103,333,868,535,19,22,333,353,20,0.0,6.807583648184077e-05,1,445,444,4,6,5,19,3,35,181,594
476,2,208,348,950,602,21,60,388,608,220,3.4037918240920386e-05,0.002280540522141666,402,894,492,3,5,4,12,1,184,606,135
477,309,309,985,985,0,62,62,965,965,0,0.008679669151434699,0.008679669151434699,978,978,0,-1,2,2,3,59,627,5,789
478,29,131,753,943,190,24,24,647,647,0,0.0010211375472276116,0.0010211375472276116,809,809,0,4,4,4,4,8,495,161,964
479,14,116,523,894,371,65,65,525,525,0,0.000442492937131965,0.0004765308553728854,664,678,14,4,4,4,17,3,63,653,964
480,100,100,892,892,0,100,100,939,939,0,0.034820790360461554,0.035025017869907075,999,999,0,4,1,1,7,69,637,12,591
481,94,300,867,973,106,90,90,758,758,0,0.0017359338302869397,0.0018380475850097008,872,878,6,3,3,3,10,13,285,42,720
482,346,346,969,969,0,442,442,967,967,0,0.00353994349705572,0.00353994349705572,930,930,0,-1,2,2,30,31,7,35,952
483,0,102,1,893,892,0,11,1,385,384,0.0,0.0002382654276864427,1,592,591,4,-1,5,7,0,335,985,645
484,38,244,762,973,211,52,52,706,706,0,0.0004084550188910446,0.0007147962830593281,688,756,68,3,3,3,8,8,646,386,258
485,0,0,1,1,0,0,0,1,1,0,0.0,0.0,1,1,0,-1,-1,-1,12,1,183,738,971
486,8,110,531,934,403,12,12,567,567,0,0.00030634126416828345,0.0006467204465774873,634,746,112,4,4,4,2,3,846,354,810
487,60,161,838,946,108,78,78,859,859,0,0.00445896728956057,0.00445896728956057,945,945,0,5,2,2,8,6,270,199,734
488,0,206,1,952,951,0,36,1,505,504,0.0,0.0007828721195411688,1,762,761,3,-1,4,10,0,205,817,79
489,91,297,870,977,107,82,82,857,857,0,0.00176997174852786,0.0023486163586235067,869,905,36,3,3,3,7,15,417,137,352
490,0,102,1,912,911,0,5,1,365,364,0.0,3.4037918240920386e-05,1,401,400,4,-1,5,4,0,717,822,442
491,6,108,450,938,488,10,10,480,480,0,3.4037918240920386e-05,0.0002042275094455223,402,560,158,4,4,4,3,2,901,342,392
492,2,2,354,354,0,26,26,399,399,0,0.00010211375472276115,0.00010211375472276115,473,473,0,-1,5,5,15,1,68,537,772
493,1,102,331,974,643,2,2,331,331,0,0.0,6.807583648184077e-05,1,450,449,6,6,6,2,2,973,374,567
494,0,102,1,895,894,0,13,1,382,381,0.0,0.00030634126416828345,1,637,636,4,-1,5,9,0,367,702,516
495,1,103,333,897,564,5,10,333,394,61,0.0,0.00030634126416828345,1,636,635,4,6,5,5,2,238,357,175
496,0,102,1,901,900,0,10,1,375,374,0.0,0.00010211375472276115,1,478,477,4,-1,5,7,0,171,388,239
497,8,8,584,584,0,8,8,531,531,0,6.807583648184077e-05,6.807583648184077e-05,462,462,0,-1,4,4,2,3,851,496,205
498,64,166,844,947,103,62,62,807,807,0,0.0016678579938050988,0.0019061234214915416,867,880,13,4,3,3,7,10,335,405,645
499,109,315,938,989,51,22,22,764,764,0,0.0026549576227917903,0.003199564314646516,916,927,11,3,3,3,2,23,934,66,589
500,116,322,900,978,78,98,98,874,874,0,0.002144388849177984,0.0026549576227917903,895,913,18,3,3,3,8,15,218,153,184
501,0,0,1,1,0,0,0,1,1,0,0.0,0.0,1,1,0,-1,-1,-1,7,3,400,882,951
502,6,108,426,906,480,38,38,564,564,0,0.0002723033459273631,0.00037441710065012424,619,660,41,4,4,4,9,3,388,285,592
503,8,214,535,970,435,16,16,530,530,0,6.807583648184077e-05,0.0009870996289866913,455,813,358,3,4,4,4,2,755,724,399
504,22,124,708,939,231,28,28,753,753,0,0.00037441710065012424,0.0006126825283365669,667,737,70,4,3,3,3,2,743,827,810
505,6,108,439,913,474,16,16,496,496,0,0.0,3.4037918240920386e-05,1,399,398,4,4,4,4,1,572,661,347
506,36,36,835,835,0,14,14,628,628,0,0.0011232513019503727,0.0011232513019503727,828,828,0,-1,4,4,3,17,768,269,733
507,0,0,1,1,0,0,0,1,1,0,0.0,0.0,1,1,0,-1,-1,-1,3,2,869,633,954
508,0,206,1,960,959,0,23,1,478,477,0.0,0.0006467204465774873,1,735,734,3,-1,4,8,0,521,517,413
509,0,616,1,992,991,0,94,1,833,832,0.0,0.01334286395044079,1,985,984,2,-1,3,9,0,123,987,2
510,70,172,883,963,80,20,20,613,613,0,0.0012253650566731338,0.0015317063208414173,831,862,31,4,4,4,4,19,787,59,465
511,0,102,1,926,925,0,6,1,386,385,0.0,0.00010211375472276115,1,491,490,4,-1,5,4,0,682,934,325
512,7,623,549,999,450,10,28,530,846,316,0.00017018959120460194,0.004731270635487933,545,954,409,2,4,3,3,2,797,22,57
513,5,106,487,945,458,4,4,424,424,0,0.0,0.0002382654276864427,1,612,611,5,5,5,2,3,817,485,805
514,0,206,1,967,966,0,17,1,496,495,0.0,0.00034037918240920387,1,662,661,3,-1,4,5,0,677,897,132
515,31,31,770,770,0,34,34,744,744,0,0.0004765308553728854,0.0004765308553728854,707,707,0,-1,3,3,4,5,504,165,632
516,0,206,1,978,977,0,10,1,527,526,0.0,0.002144388849177984,1,894,893,3,-1,4,3,0,693,825,65
517,0,0,1,1,0,0,0,1,1,0,0.0,0.0,1,1,0,-1,-1,-1,3,0,796,884,539
518,110,212,920,969,49,48,48,904,904,0,0.0025188059498281084,0.0027911092957554717,910,923,13,4,3,3,3,15,490,158,134
519,0,102,1,940,939,0,5,1,368,367,0.0,0.00010211375472276115,1,478,477,4,-1,5,4,1,794,806,319
520,160,160,954,954,0,54,54,906,906,0,0.003710133088260322,0.003710133088260322,938,938,0,-1,3,3,4,26,690,112,254
521,52,258,829,973,144,48,48,738,738,0,0.0004084550188910446,0.0008509479560230097,674,789,115,3,3,3,7,9,698,154,471
522,0,206,1,953,952,0,34,1,515,514,0.0,0.0012594029749140542,1,822,821,3,-1,4,9,1,140,920,45
523,2,104,364,922,558,10,10,425,425,0,3.4037918240920386e-05,3.4037918240920386e-05,399,399,0,4,5,5,5,1,691,623,225
524,13,115,699,966,267,14,14,720,720,0,0.0005786446100956465,0.0010211375472276116,728,818,90,4,4,4,3,7,852,224,194
525,3,3,451,451,0,3,3,370,370,0,3.4037918240920386e-05,3.4037918240920386e-05,406,406,0,-1,5,5,2,3,947,761,349
526,6,212,417,964,547,27,31,488,517,29,0.00013615167296368154,0.0005786446100956465,515,721,206,3,4,4,8,3,297,309,275
527,0,102,1,905,904,0,10,1,400,399,0.0,0.00034037918240920387,1,643,642,4,-1,5,5,0,347,977,479
528,9,111,586,933,347,16,16,554,554,0,0.00017018959120460194,0.0013615167296368155,549,852,303,4,4,4,4,3,706,536,106
529,0,206,1,965,964,0,26,1,480,479,0.0,0.0011232513019503727,1,810,809,3,-1,4,11,0,261,533,116
530,16,16,554,554,0,74,74,748,748,0,0.0004765308553728854,0.0004765308553728854,689,689,0,-1,3,3,9,1,381,80,472
531,46,662,786,993,207,98,128,868,943,75,0.0018380475850097008,0.009530617107457708,878,977,99,2,2,2,9,2,316,475,19
532,13,13,561,561,0,32,32,564,564,0,0.0002723033459273631,0.0002723033459273631,599,599,0,-1,4,4,8,5,521,636,933
533,16,222,615,970,355,34,34,705,705,0,0.0004765308553728854,0.00088498587426393,705,797,92,3,3,3,4,1,870,480,338
534,19,19,667,667,0,30,30,663,663,0,0.0002723033459273631,0.0002723033459273631,619,619,0,-1,4,4,5,10,677,266,201
535,16,117,638,933,295,30,30,738,738,0,0.00030634126416828345,0.00034037918240920387,640,660,20,6,3,3,4,2,280,384,640
536,2,104,371,941,570,4,5,372,399,27,3.4037918240920386e-05,0.0002382654276864427,399,607,208,4,5,5,3,1,590,543,636
537,6,108,529,958,429,8,8,564,564,0,0.00017018959120460194,0.00037441710065012424,551,674,123,4,4,4,2,1,890,531,481
538,0,206,1,957,956,0,16,1,454,453,0.0,0.0002382654276864427,1,592,591,3,-1,4,6,0,281,936,268
539,10,112,540,913,373,16,16,459,459,0,0.00030634126416828345,0.0004084550188910446,631,674,43,4,4,4,6,4,356,443,527
540,6,212,420,965,545,50,50,638,638,0,0.00010211375472276115,0.0010211375472276116,482,801,319,3,4,4,9,1,180,282,243
541,0,206,1,975,974,0,14,1,591,590,0.0,0.0017018959120460194,1,874,873,3,-1,4,3,0,845,588,96
542,0,206,1,979,978,0,8,1,589,588,0.0,0.0012934408931549745,1,853,852,3,-1,4,2,0,283,989,129
543,3,104,459,956,497,3,3,388,388,0,6.807583648184077e-05,0.00013615167296368154,456,527,71,5,5,5,2,2,792,694,401
544,12,12,605,605,0,22,22,629,629,0,0.00010211375472276115,0.00010211375472276115,487,487,0,-1,4,4,5,3,629,300,367
545,0,616,1,993,992,0,48,1,562,561,0.0,0.0028932230504782326,1,919,918,2,-1,3,11,0,271,723,56
546,753,959,994,997,3,302,302,991,991,0,0.012764219340345145,0.01317267435923619,988,991,3,3,2,2,15,85,102,0,262
547,44,44,779,779,0,84,84,765,765,0,0.0007147962830593281,0.0007147962830593281,752,752,0,-1,2,2,11,4,174,230,783
548,0,206,1,957,956,0,18,1,428,427,0.0,0.0004084550188910446,1,681,680,3,-1,4,7,0,179,725,246
549,2,208,353,957,604,10,20,353,427,74,0.0,0.0002723033459273631,1,610,609,3,5,4,9,1,315,603,553
550,0,206,1,970,969,0,14,1,490,489,0.0,0.0004765308553728854,1,696,695,3,-1,4,5,0,291,912,288
551,0,206,1,955,954,0,26,1,466,465,0.0,0.0011913271384322134,1,825,824,3,-1,4,9,0,274,669,180
552,8,109,542,928,386,10,10,472,472,0,0.00013615167296368154,0.00013615167296368154,514,514,0,9,4,4,3,2,900,523,647
553,0,101,1,914,913,0,5,1,332,331,0.0,3.4037918240920386e-05,1,405,404,5,-1,6,5,0,561,803,599
554,36,242,795,979,184,48,48,851,851,0,0.0007828721195411688,0.0032336022328874367,779,926,147,3,3,3,6,6,486,192,111
555,88,88,859,859,0,78,78,776,776,0,0.0011232513019503727,0.0011232513019503727,808,808,0,-1,3,3,10,12,272,172,812
556,39,39,794,794,0,34,34,731,731,0,0.0007488342013002485,0.0007488342013002485,770,770,0,-1,3,3,4,9,759,198,992
557,0,102,1,937,936,0,3,1,366,365,0.0,0.00010211375472276115,1,486,485,4,-1,5,2,0,598,800,391
558,102,204,931,977,46,44,44,890,890,0,0.0026209197045508697,0.0026549576227917903,911,911,0,4,3,3,4,17,607,81,667
559,0,0,1,1,0,0,0,1,1,0,0.0,0.0,1,1,0,-1,-1,-1,5,0,376,867,728
560,60,266,861,979,118,28,28,780,780,0,0.0007488342013002485,0.0012253650566731338,771,835,64,3,3,3,3,12,588,172,461
561,698,799,1000,1000,0,72,72,993,993,0,0.035603662480002726,0.03577385207120733,997,997,0,5,2,2,3,157,797,2,459
562,6,6,439,439,0,20,20,560,560,0,6.807583648184077e-05,6.807583648184077e-05,447,447,0,-1,4,4,4,1,445,720,522
563,0,101,1,948,947,0,2,1,331,330,0.0,6.807583648184077e-05,1,456,455,5,-1,6,2,0,895,696,879
564,20,636,619,990,371,42,56,512,600,88,0.00034037918240920387,0.001497668402600497,635,845,210,2,4,3,11,4,307,210,148
565,0,0,1,1,0,0,0,1,1,0,0.0,0.0,1,1,0,-1,-1,-1,4,0,822,201,956
566,16,16,527,527,0,44,44,484,484,0,0.00037441710065012424,0.00037441710065012424,650,650,0,-1,4,4,14,4,181,315,845
567,1,103,332,923,591,6,8,332,373,41,0.0,6.807583648184077e-05,1,457,456,4,6,5,6,1,657,671,251
568,0,102,1,915,914,0,5,1,360,359,0.0,0.00013615167296368154,1,514,513,4,-1,5,4,0,354,786,586
569,313,415,988,993,5,38,38,899,899,0,0.0088498587426393,0.00891793457912114,977,978,1,4,3,3,3,81,732,32,518
570,37,243,794,973,179,26,26,613,613,0,0.0009190237925048504,0.002484768031587188,795,908,113,3,4,4,5,14,561,175,47
571,0,206,1,972,971,0,8,1,472,471,0.0,0.00030634126416828345,1,641,640,3,-1,4,2,0,828,620,267
572,92,298,890,980,90,50,50,825,825,0,0.002382654276864427,0.0028591851322373124,905,919,14,3,3,3,5,22,605,203,299
573,18,120,605,904,299,112,112,814,814,0,0.0008509479560230097,0.0011913271384322134,780,826,46,4,3,3,12,3,106,299,362
574,0,206,1,955,954,0,21,1,461,460,0.0,0.00030634126416828345,1,622,621,3,-1,4,8,1,443,767,378
575,0,102,1,881,880,0,14,1,367,366,0.0,6.807583648184077e-05,1,458,457,4,-1,5,11,0,220,819,523
576,2,208,361,971,610,6,26,361,615,254,0.0,0.0014636304843595766,1,860,859,3,5,4,5,1,314,402,82
577,90,90,911,911,0,46,46,804,804,0,0.0016678579938050988,0.0016678579938050988,872,872,0,-1,3,3,6,24,661,129,808
578,0,0,1,1,0,0,0,1,1,0,0.0,0.0,1,1,0,-1,-1,-1,8,1,434,949,916
579,31,31,764,764,0,36,36,709,709,0,0.0007147962830593281,0.0007147962830593281,757,757,0,-1,4,4,6,10,373,296,940
580,0,206,1,972,971,0,12,1,489,488,0.0,0.0022465026039007454,1,899,898,3,-1,4,4,0,631,821,47
581,0,206,1,956,955,0,44,1,516,515,0.0,0.0006807583648184077,1,744,743,3,-1,4,12,0,106,822,273
582,0,0,1,1,0,0,0,1,1,0,0.0,0.0,1,1,0,-1,-1,-1,2,0,967,632,793
583,0,206,1,940,939,0,76,1,491,490,0.0,0.0006467204465774873,1,731,730,3,-1,4,22,0,33,707,438
584,0,0,1,1,0,0,0,1,1,0,0.0,0.0,1,1,0,-1,-1,-1,2,1,873,852,968
585,0,0,1,1,0,0,0,1,1,0,0.0,0.0,1,1,0,-1,-1,-1,8,0,186,976,713
586,17,17,769,769,0,8,8,638,638,0,0.0005786446100956465,0.0005786446100956465,742,742,0,-1,4,4,2,8,933,284,941
587,14,220,599,970,371,26,26,561,561,0,0.00013615167296368154,0.0005446066918547262,526,724,198,3,4,4,7,3,697,222,312
588,0,206,1,953,952,0,33,1,473,472,0.0,0.0015317063208414173,1,857,856,3,-1,4,11,0,224,565,157
589,29,235,734,972,238,28,32,531,558,27,0.00017018959120460194,0.002552843868069029,550,903,353,3,4,4,8,13,449,256,88
590,0,102,1,918,917,0,7,1,391,390,0.0,0.00013615167296368154,1,503,502,4,-1,5,4,0,832,946,404
591,12,218,594,974,380,16,16,571,571,0,0.00034037918240920387,0.0004765308553728854,661,705,44,3,4,4,4,3,461,505,360
592,31,31,734,734,0,40,40,704,704,0,0.0008509479560230097,0.0008509479560230097,784,784,0,-1,3,3,5,5,818,216,554
593,100,100,864,864,0,100,100,720,720,0,0.03100854351747847,0.03100854351747847,1000,1000,0,-1,1,1,13,127,41,11,522
594,8,109,536,929,393,12,12,458,458,0,6.807583648184077e-05,0.00010211375472276115,446,478,32,5,4,4,5,2,765,244,543
595,0,0,1,1,0,0,0,1,1,0,0.0,0.0,1,1,0,-1,-1,-1,3,3,930,854,768
596,36,36,795,795,0,28,28,737,737,0,0.0008509479560230097,0.0008509479560230097,795,795,0,-1,3,3,3,6,737,234,979
597,10,10,573,573,0,15,15,478,478,0,0.0002723033459273631,0.0002723033459273631,619,619,0,-1,4,4,6,5,764,710,747
598,10,111,672,969,297,8,8,609,609,0,0.0002042275094455223,0.0002723033459273631,584,636,52,5,4,4,2,6,873,613,477
599,0,102,1,945,944,0,5,1,395,394,0.0,0.0002382654276864427,1,601,600,4,-1,5,3,0,535,784,584
600,4,106,443,933,490,7,8,410,429,19,0.0002042275094455223,0.0004765308553728854,573,692,119,4,5,5,4,5,648,464,634
601,0,0,1,1,0,0,0,1,1,0,0.0,0.0,1,1,0,-1,-1,-1,16,0,78,824,715
602,0,206,1,950,949,0,36,1,504,503,0.0,0.00030634126416828345,1,626,625,3,-1,4,10,0,310,995,493
603,0,206,1,964,963,0,22,1,484,483,0.0,0.0005105687736138058,1,708,707,3,-1,4,7,0,324,728,377
604,0,0,1,1,0,0,0,1,1,0,0.0,0.0,1,1,0,-1,-1,-1,2,0,643,978,915
605,0,0,1,1,0,0,0,1,1,0,0.0,0.0,1,1,0,-1,-1,-1,7,0,299,929,818
606,38,139,841,964,123,22,22,828,828,0,0.0010211375472276116,0.0010211375472276116,825,825,0,6,3,3,2,13,757,340,331
607,54,260,772,959,187,128,132,754,766,12,0.0008169100377820892,0.0016678579938050988,758,853,95,3,3,3,17,4,94,40,139
608,10,216,574,973,399,14,22,495,604,109,0.00010211375472276115,0.0024507301133462676,479,906,427,3,4,4,5,3,908,347,25
609,0,0,1,1,0,0,0,1,1,0,0.0,0.0,1,1,0,-1,-1,-1,5,0,766,498,513
610,0,101,1,928,927,0,4,1,332,331,0.0,0.0,1,1,0,5,-1,6,4,0,562,954,152
611,24,230,645,953,308,78,82,635,656,21,0.0002042275094455223,0.0009190237925048504,560,789,229,3,3,3,14,4,47,287,207
612,31,133,705,920,215,88,88,776,776,0,0.0005786446100956465,0.0006467204465774873,718,734,16,4,3,3,11,8,155,257,904
613,0,101,1,927,926,0,3,1,332,331,0.0,0.0,1,1,0,5,-1,6,3,1,861,738,552
614,0,102,1,898,897,0,19,1,404,403,0.0,0.0005105687736138058,1,706,705,4,-1,5,10,0,293,483,396
615,18,120,668,929,261,28,28,745,745,0,0.0005105687736138058,0.0006807583648184077,724,763,39,4,3,3,3,3,726,525,869
616,0,0,1,1,0,0,0,1,1,0,0.0,0.0,1,1,0,-1,-1,-1,3,0,707,953,954
617,29,29,749,749,0,36,36,754,754,0,0.00088498587426393,0.00088498587426393,781,781,0,-1,3,3,5,4,534,557,455
618,38,38,769,769,0,40,40,706,706,0,0.00034037918240920387,0.00034037918240920387,653,653,0,-1,3,3,5,8,719,286,678
619,0,0,1,1,0,0,0,1,1,0,0.0,0.0,1,1,0,-1,-1,-1,7,0,207,977,918
620,6,6,422,422,0,17,17,428,428,0,0.0,0.0,1,1,0,-1,4,4,8,2,225,320,786
621,0,102,1,878,877,0,17,1,358,357,0.0,0.00010211375472276115,1,486,485,4,-1,5,15,0,107,669,646
622,0,206,1,975,974,0,15,1,536,535,0.0,0.00034037918240920387,1,653,652,3,-1,4,4,0,475,980,505
623,14,14,651,651,0,12,12,627,627,0,0.0006467204465774873,0.0006467204465774873,753,753,0,-1,4,4,2,5,993,306,611
624,0,0,1,1,0,0,0,1,1,0,0.0,0.0,1,1,0,-1,-1,-1,4,0,460,937,815
625,11,217,633,978,345,8,12,512,609,97,0.0002042275094455223,0.0014295925661186562,584,866,282,3,4,4,2,4,948,365,109
626,12,12,508,508,0,28,28,447,447,0,6.807583648184077e-05,6.807583648184077e-05,437,437,0,-1,4,4,10,3,240,585,349
627,18,18,602,602,0,43,43,604,604,0,0.0002723033459273631,0.0002723033459273631,606,606,0,-1,3,3,9,2,414,22,583
628,49,151,847,956,109,34,34,774,774,0,0.0007488342013002485,0.0011232513019503727,770,832,62,4,3,3,4,11,475,97,521
629,0,0,1,1,0,0,0,1,1,0,0.0,0.0,1,1,0,-1,-1,-1,6,3,630,854,608
630,0,101,1,956,955,0,2,1,331,330,0.0,6.807583648184077e-05,1,456,455,5,-1,6,2,3,982,746,314
631,64,64,834,834,0,90,90,841,841,0,0.0007828721195411688,0.0007828721195411688,766,766,0,-1,2,2,9,4,126,259,428
632,13,219,525,953,428,33,39,469,488,19,0.0,0.0006126825283365669,1,725,724,3,4,4,12,3,183,580,306
633,0,102,1,948,947,0,8,1,452,451,0.0,0.0014636304843595766,1,849,848,4,-1,5,4,0,480,936,227
634,0,206,1,958,957,0,60,1,669,668,0.0,0.0061949011198475104,1,962,961,3,-1,4,10,0,409,900,7
635,6,6,414,414,0,33,33,578,578,0,0.00013615167296368154,0.00013615167296368154,508,508,0,-1,4,4,7,1,324,904,777
636,12,218,514,951,437,56,64,583,618,35,0.00010211375472276115,0.0011913271384322134,487,818,331,3,4,4,12,2,292,468,106
637,2,2,355,355,0,6,6,356,356,0,0.0,0.0,1,1,0,-1,5,5,5,1,793,861,685
638,18,120,623,910,287,28,28,554,554,0,0.0002042275094455223,0.00034037918240920387,570,644,74,4,4,4,6,8,560,417,931
639,1,1,333,333,0,5,5,333,333,0,0.0,0.0,1,1,0,-1,7,7,5,2,363,344,895
640,66,168,844,948,104,98,98,913,913,0,0.002144388849177984,0.002484768031587188,892,902,10,4,3,3,8,12,365,100,459
641,61,267,841,975,134,90,90,931,931,0,0.0020422750944552232,0.003165526396405596,882,926,44,3,2,2,6,9,514,293,232
642,0,206,1,969,968,0,12,1,446,445,0.0,0.00030634126416828345,1,633,632,3,-1,4,5,1,528,920,275
643,353,353,980,980,0,164,164,961,961,0,0.005514142755029102,0.005514142755029102,961,961,0,-1,2,2,10,57,99,50,939
644,6,108,422,912,490,21,21,474,474,0,0.00013615167296368154,0.0002382654276864427,507,587,80,4,4,4,7,1,359,607,363
645,34,240,717,962,245,74,78,655,675,20,0.00037441710065012424,0.0012253650566731338,672,826,154,3,3,3,12,5,116,252,326
646,2,208,343,947,604,18,27,352,387,35,0.0,6.807583648184077e-05,1,440,439,3,5,4,16,3,145,708,549
647,50,50,803,803,0,68,68,693,693,0,0.00037441710065012424,0.00037441710065012424,667,667,0,-1,3,3,10,7,149,389,890
648,8,109,566,945,379,14,14,625,625,0,0.0002042275094455223,0.0002723033459273631,567,606,39,5,4,4,3,3,693,508,464
649,6,6,449,449,0,12,12,485,485,0,0.00010211375472276115,0.00010211375472276115,476,476,0,-1,4,4,4,1,458,810,359
650,0,102,1,923,922,0,8,1,373,372,0.0,3.4037918240920386e-05,1,406,405,4,-1,5,6,1,657,949,384
651,6,6,410,410,0,20,20,426,426,0,3.4037918240920386e-05,3.4037918240920386e-05,407,407,0,-1,4,4,9,1,319,601,737
652,26,226,754,978,224,18,18,673,673,0,0.0012594029749140542,0.002110350930937064,839,893,54,3,4,4,3,8,844,174,281
653,2,104,380,958,578,3,3,382,382,0,6.807583648184077e-05,0.0002042275094455223,447,573,126,4,5,5,2,1,878,334,625
654,7,109,617,974,357,4,4,496,496,0,6.807583648184077e-05,0.0006467204465774873,455,767,312,4,5,5,2,4,872,208,289
655,6,212,416,964,548,28,32,534,572,38,0.00017018959120460194,0.0009530617107457708,541,793,252,3,4,4,8,1,371,870,362
656,178,178,926,926,0,292,292,956,956,0,0.0027911092957554717,0.0027911092957554717,921,921,0,-1,2,2,19,15,89,151,914
657,0,102,1,921,920,0,6,1,384,383,0.0,0.00010211375472276115,1,486,485,4,-1,5,4,0,659,923,424
658,16,222,637,977,340,34,34,775,775,0,0.0006467204465774873,0.0017359338302869397,749,871,122,3,3,3,4,1,397,80,393
659,341,442,987,990,3,64,64,956,956,0,0.008543517478471017,0.008543517478471017,977,977,0,5,3,3,4,70,740,18,581
660,0,101,1,903,902,0,6,1,332,331,0.0,0.0,1,1,0,6,-1,7,6,1,606,456,663
661,89,89,859,859,0,86,86,765,765,0,0.0014295925661186562,0.0014295925661186562,850,850,0,-1,3,3,10,14,189,139,855
662,6,6,396,396,0,27,27,421,421,0,0.0,0.0,1,1,0,-1,4,4,12,1,175,837,903
663,6,212,479,976,497,10,10,525,525,0,3.4037918240920386e-05,0.0002382654276864427,405,602,197,3,4,4,3,3,888,260,655
664,0,102,1,925,924,0,8,1,426,425,0.0,0.00034037918240920387,1,647,646,4,-1,5,4,0,633,901,461
665,0,101,1,913,912,0,4,1,331,330,0.0,0.0,1,1,0,5,-1,6,4,0,614,686,862
666,34,136,816,956,140,28,28,849,849,0,0.001157289220191293,0.0012934408931549745,837,854,17,4,3,3,3,6,899,397,722
667,6,6,407,407,0,46,46,585,585,0,0.0002723033459273631,0.0002723033459273631,605,605,0,-1,4,4,9,1,245,474,975
668,54,54,832,832,0,64,64,788,788,0,0.0007488342013002485,0.0007488342013002485,766,766,0,-1,3,3,8,8,158,264,638
669,0,206,1,950,949,0,52,1,556,555,0.0,0.0017018959120460194,1,864,863,3,-1,4,12,0,62,423,91
670,0,206,1,956,955,0,12,1,415,414,0.0,0.00017018959120460194,1,541,540,3,-1,4,4,0,503,961,308
671,0,0,1,1,0,0,0,1,1,0,0.0,0.0,1,1,0,-1,-1,-1,17,0,94,614,548
672,32,134,730,926,196,42,42,629,629,0,0.000442492937131965,0.0005446066918547262,698,729,31,4,4,4,7,8,678,386,662
673,2,104,367,934,567,6,6,395,395,0,3.4037918240920386e-05,0.0004084550188910446,401,686,285,4,5,5,4,3,811,460,368
674,18,18,624,624,0,34,34,539,539,0,0.00037441710065012424,0.00037441710065012424,655,655,0,-1,4,4,9,6,190,229,849
675,172,378,932,982,50,192,192,936,936,0,0.0028932230504782326,0.0030974505599237552,924,933,9,3,2,2,13,15,165,158,365
676,67,267,883,980,97,22,22,779,779,0,0.0020082371762143027,0.003914360597705844,895,947,52,3,3,3,2,18,990,63,76
677,2,208,361,970,609,3,9,333,433,100,0.0,0.00017018959120460194,1,554,553,3,6,4,3,5,471,605,636
678,0,102,1,937,936,0,4,1,394,393,0.0,0.00017018959120460194,1,542,541,4,-1,5,2,0,598,912,176
679,12,114,515,895,380,58,58,630,630,0,0.00088498587426393,0.0014636304843595766,784,853,69,4,4,4,11,2,234,475,296
680,120,222,937,972,35,48,48,904,904,0,0.003710133088260322,0.003778208924742163,938,938,0,4,3,3,3,20,836,38,251
681,23,229,727,973,246,24,24,666,666,0,0.0005446066918547262,0.002586881786309949,730,914,184,3,4,4,4,9,649,293,26
682,0,206,1,960,959,0,22,1,482,481,0.0,0.0004765308553728854,1,689,688,3,-1,4,7,0,450,979,159
683,120,222,946,976,30,34,34,837,837,0,0.003812246842983083,0.004186663943633207,941,952,11,4,3,3,4,28,603,41,473
684,1,102,333,913,580,8,8,333,333,0,3.4037918240920386e-05,3.4037918240920386e-05,408,408,0,5,6,6,8,3,468,708,640
685,50,151,810,937,127,60,60,836,836,0,0.0011913271384322134,0.0012253650566731338,819,823,4,6,2,2,5,4,546,557,437
686,12,628,492,991,499,52,98,472,620,148,6.807583648184077e-05,0.0030634126416828346,456,918,462,2,4,3,18,2,111,680,48
687,0,0,1,1,0,0,0,1,1,0,0.0,0.0,1,1,0,-1,-1,-1,10,1,205,835,895
688,7,213,542,977,435,8,12,489,585,96,0.00017018959120460194,0.0011913271384322134,540,837,297,3,4,4,2,2,934,724,403
689,18,18,628,628,0,48,48,657,657,0,0.00030634126416828345,0.00030634126416828345,622,622,0,-1,3,3,9,3,177,354,587
690,56,158,846,956,110,64,64,923,923,0,0.002825147213996392,0.0028932230504782326,915,916,1,4,2,2,5,8,363,497,710
691,16,118,656,937,281,22,22,675,675,0,0.000442492937131965,0.0005446066918547262,697,723,26,4,3,3,4,1,619,394,879
692,14,14,593,593,0,20,20,554,554,0,0.000442492937131965,0.000442492937131965,685,685,0,-1,4,4,4,3,717,507,478
693,0,206,1,976,975,0,7,1,477,476,0.0,0.0004084550188910446,1,670,669,3,-1,4,2,0,733,784,136
694,0,0,1,1,0,0,0,1,1,0,0.0,0.0,1,1,0,-1,-1,-1,2,0,849,604,943
695,176,382,969,991,22,44,44,859,859,0,0.0031314884781646754,0.005616256509751864,932,967,35,3,3,3,4,44,313,27,56
696,16,222,594,968,374,16,16,491,491,0,0.0002042275094455223,0.0006807583648184077,555,760,205,3,4,4,4,4,493,380,616
697,0,0,1,1,0,0,0,1,1,0,0.0,0.0,1,1,0,-1,-1,-1,9,1,395,472,939
698,0,101,1,919,918,0,4,1,331,330,0.0,0.0,1,1,0,5,-1,6,4,0,550,849,763
699,0,101,1,881,880,0,9,1,332,331,0.0,3.4037918240920386e-05,1,392,391,5,-1,6,9,0,101,998,466
700,1,102,332,916,584,3,3,332,332,0,0.0,3.4037918240920386e-05,1,392,391,5,9,6,3,1,726,647,585
701,0,101,1,874,873,0,17,1,332,331,0.0,3.4037918240920386e-05,1,396,395,5,-1,6,17,0,112,968,656
702,6,212,427,960,533,14,30,414,550,136,0.00010211375472276115,0.0018380475850097008,487,873,386,3,5,4,7,3,466,353,69
703,96,198,840,937,97,216,216,835,835,0,0.0011232513019503727,0.0011913271384322134,810,818,8,4,2,2,22,9,33,242,452
704,0,0,1,1,0,0,0,1,1,0,0.0,0.0,1,1,0,-1,-1,-1,3,1,915,472,897
705,12,12,545,545,0,20,20,531,531,0,0.0002382654276864427,0.0002382654276864427,588,588,0,-1,4,4,4,2,448,770,436
706,0,102,1,911,910,0,6,1,361,360,0.0,0.0002382654276864427,1,577,576,4,-1,5,5,0,407,847,648
707,14,220,542,957,415,36,36,493,493,0,0.0002723033459273631,0.0004765308553728854,611,695,84,3,4,4,12,3,93,378,134
708,34,136,678,906,228,118,118,757,757,0,0.0005786446100956465,0.0009190237925048504,706,786,80,4,3,3,16,3,134,280,170
709,19,225,722,979,257,18,18,671,671,0,0.0004084550188910446,0.003948398515946765,681,942,261,3,4,4,3,6,590,381,31
710,0,102,1,864,863,0,17,1,348,347,0.0,3.4037918240920386e-05,1,394,393,4,-1,5,16,0,132,916,621
711,0,206,1,978,977,0,8,1,524,523,0.0,0.0007488342013002485,1,773,772,3,-1,4,2,0,895,786,179
712,30,30,711,711,0,54,54,661,661,0,0.0005786446100956465,0.0005786446100956465,725,725,0,-1,3,3,8,6,231,379,568
713,22,22,750,750,0,12,12,631,631,0,0.000442492937131965,0.000442492937131965,686,686,0,-1,4,4,2,7,894,422,866
714,109,210,913,967,54,54,54,864,864,0,0.0028591851322373124,0.0028591851322373124,916,916,0,6,3,3,4,19,638,91,692
715,178,178,941,941,0,128,128,939,939,0,0.003608019333537561,0.003608019333537561,930,930,0,-1,2,2,9,20,178,109,898
716,31,31,782,782,0,24,24,740,740,0,0.0007828721195411688,0.0007828721195411688,787,787,0,-1,3,3,3,6,864,295,863
717,9,111,582,939,357,14,14,577,577,0,6.807583648184077e-05,0.0004765308553728854,450,691,241,4,4,4,3,3,912,508,399
718,0,0,1,1,0,0,0,1,1,0,0.0,0.0,1,1,0,-1,-1,-1,7,1,591,835,426
719,40,656,783,998,215,72,76,893,895,2,0.001599782157323258,0.004220701861874128,853,947,94,2,2,2,6,1,549,727,69
720,0,0,1,1,0,0,0,1,1,0,0.0,0.0,1,1,0,-1,-1,-1,4,1,578,705,539
721,6,107,401,884,483,26,26,467,467,0,6.807583648184077e-05,6.807583648184077e-05,450,450,0,5,4,4,9,2,274,419,717
722,2,104,354,900,546,8,10,354,370,16,0.0,6.807583648184077e-05,1,466,465,4,5,5,7,2,179,721,602
723,16,117,710,961,251,22,22,856,856,0,0.0004084550188910446,0.000442492937131965,699,713,14,5,3,3,2,1,914,681,464
724,16,117,670,948,278,20,20,772,772,0,0.00013615167296368154,0.00017018959120460194,531,558,27,6,3,3,3,3,958,260,764
725,2,104,367,931,564,4,6,368,418,50,0.0,0.00013615167296368154,1,520,519,4,5,5,3,1,627,687,107
726,16,222,553,956,403,62,62,640,640,0,0.0006126825283365669,0.0009190237925048504,732,790,58,3,3,3,10,1,105,80,329
727,6,107,490,955,465,12,12,682,682,0,0.0002042275094455223,0.0002382654276864427,575,599,24,5,4,4,2,1,702,958,748
728,107,313,872,969,97,198,198,858,858,0,0.0011232513019503727,0.001157289220191293,815,820,5,3,2,2,19,10,35,405,370
729,0,102,1,870,869,0,18,1,348,347,0.0,0.0,1,1,0,4,-1,5,17,0,10,824,592
730,0,206,1,981,980,0,8,1,547,546,0.0,0.002382654276864427,1,912,911,3,-1,4,2,0,792,542,27
731,16,118,494,880,386,104,104,619,619,0,0.00013615167296368154,0.00017018959120460194,516,549,33,4,3,3,19,3,31,260,509
732,30,30,683,683,0,66,66,639,639,0,0.00037441710065012424,0.00037441710065012424,664,664,0,-1,3,3,12,9,183,341,672
733,0,0,1,1,0,0,0,1,1,0,0.0,0.0,1,1,0,-1,-1,-1,5,0,766,942,933
734,18,120,732,960,228,14,14,626,626,0,0.0002723033459273631,0.0004084550188910446,626,686,60,4,4,4,3,6,718,46,379
735,0,206,1,953,952,0,30,1,494,493,0.0,0.0007828721195411688,1,760,759,3,-1,4,9,1,140,949,397
736,6,108,396,890,494,53,54,531,534,3,0.00030634126416828345,0.0007488342013002485,624,762,138,4,4,4,13,1,67,452,284
737,38,139,786,944,158,40,40,764,764,0,0.0007488342013002485,0.0007828721195411688,762,765,3,5,3,3,5,7,407,169,631
738,27,128,846,975,129,12,12,810,810,0,0.0009530617107457708,0.0014636304843595766,820,873,53,5,4,4,2,14,962,175,405
739,22,22,751,751,0,10,10,517,517,0,0.0007828721195411688,0.0007828721195411688,788,788,0,-1,4,4,3,14,683,387,944
740,1,103,332,926,594,4,7,332,398,66,0.0,0.0002382654276864427,1,593,592,4,6,5,4,2,740,764,553
741,2,104,358,919,561,5,6,385,407,22,0.0,3.4037918240920386e-05,1,392,391,4,5,5,3,1,726,337,536
742,18,120,720,959,239,24,24,757,757,0,0.0006467204465774873,0.0009190237925048504,750,800,50,4,4,4,4,5,754,221,329
743,1,1,333,333,0,5,5,333,333,0,0.0,0.0,1,1,0,-1,6,6,5,4,406,595,905
744,100,100,844,844,0,100,100,520,520,0,0.006058749446883829,0.00616086320160659,957,958,1,3,1,1,25,2,17,827,719
745,12,113,598,931,333,26,26,659,659,0,0.0002382654276864427,0.00030634126416828345,595,627,32,5,4,4,5,2,612,827,164
746,16,222,509,944,435,66,71,486,509,23,3.4037918240920386e-05,0.00030634126416828345,395,619,224,3,3,3,19,1,89,623,156
747,48,254,844,977,133,28,28,792,792,0,0.001157289220191293,0.001599782157323258,837,871,34,3,3,3,3,15,864,137,490
748,0,206,1,951,950,0,29,1,491,490,0.0,0.000442492937131965,1,683,682,3,-1,4,9,0,414,863,404
749,0,0,1,1,0,0,0,1,1,0,0.0,0.0,1,1,0,-1,-1,-1,23,1,30,742,735
750,445,651,990,996,6,104,104,983,983,0,0.010007147962830594,0.010687906327649,982,984,2,3,2,2,5,78,311,9,289
751,0,0,1,1,0,0,0,1,1,0,0.0,0.0,1,1,0,-1,-1,-1,8,3,236,882,823
752,2,2,356,356,0,15,15,416,416,0,3.4037918240920386e-05,3.4037918240920386e-05,408,408,0,-1,5,5,8,3,158,321,916
753,136,238,948,973,25,60,60,912,912,0,0.003710133088260322,0.003948398515946765,942,947,5,4,3,3,5,25,430,105,653
754,25,231,695,968,273,58,58,780,780,0,0.000442492937131965,0.00088498587426393,699,794,95,3,3,3,7,5,320,510,308
755,1,103,332,947,615,2,4,332,410,78,0.0,0.00017018959120460194,1,559,558,4,6,5,2,1,928,717,101
756,7,7,540,540,0,9,9,495,495,0,0.00013615167296368154,0.00013615167296368154,510,510,0,-1,4,4,3,3,628,196,934
757,19,121,700,939,239,12,12,562,562,0,0.0004765308553728854,0.0005446066918547262,711,728,17,4,4,4,2,5,971,510,168
758,33,33,761,761,0,36,36,645,645,0,0.00034037918240920387,0.00034037918240920387,651,651,0,-1,4,4,6,11,356,316,990
759,1,207,332,979,647,3,13,332,620,288,3.4037918240920386e-05,0.00088498587426393,398,794,396,3,6,4,3,2,867,292,387
760,2,104,368,930,562,5,6,368,385,17,3.4037918240920386e-05,0.00013615167296368154,394,511,117,4,5,5,4,1,563,437,419
761,24,24,773,773,0,32,32,939,939,0,0.0022465026039007454,0.0022465026039007454,906,906,0,-1,3,3,2,4,957,281,769
762,70,172,820,932,112,172,172,870,870,0,0.0018380475850097008,0.001940161339732462,871,878,7,4,3,3,17,9,63,277,791
763,2,104,352,891,539,11,12,369,376,7,3.4037918240920386e-05,3.4037918240920386e-05,402,402,0,4,5,5,8,2,411,764,837
764,0,102,1,938,937,0,4,1,395,394,0.0,0.000442492937131965,1,687,686,4,-1,5,2,1,596,573,616
765,6,212,419,962,543,26,26,512,512,0,3.4037918240920386e-05,0.0002723033459273631,405,605,200,3,4,4,7,1,265,718,667
766,6,212,399,954,555,46,46,543,543,0,0.0002382654276864427,0.0005446066918547262,576,713,137,3,4,4,11,1,233,711,250
767,0,206,1,966,965,0,12,1,438,437,0.0,0.00030634126416828345,1,628,627,3,-1,4,4,1,540,747,237
768,0,0,1,1,0,0,0,1,1,0,0.0,0.0,1,1,0,-1,-1,-1,4,0,652,777,792
769,6,107,470,943,473,18,18,649,649,0,0.00017018959120460194,0.00017018959120460194,543,543,0,5,4,4,3,1,903,741,879
770,0,101,1,933,932,0,4,1,332,331,0.0,6.807583648184077e-05,1,456,455,5,-1,6,4,1,679,780,580
771,0,206,1,983,982,0,8,1,545,544,0.0,0.0016678579938050988,1,874,873,3,-1,4,2,1,965,706,128
772,2,2,374,374,0,4,4,404,404,0,0.0002042275094455223,0.0002042275094455223,577,577,0,-1,5,5,2,1,977,452,850
773,0,102,1,926,925,0,5,1,390,389,0.0,6.807583648184077e-05,1,453,452,4,-1,5,3,0,831,888,212
774,0,206,1,956,955,0,22,1,438,437,0.0,0.000442492937131965,1,682,681,3,-1,4,9,0,200,944,328
775,0,101,1,915,914,0,5,1,332,331,0.0,3.4037918240920386e-05,1,407,406,5,-1,6,5,0,570,982,408
776,17,17,718,718,0,10,10,531,531,0,0.0006467204465774873,0.0006467204465774873,753,753,0,-1,4,4,3,6,569,467,808
777,6,107,433,919,486,14,14,479,479,0,6.807583648184077e-05,6.807583648184077e-05,448,448,0,5,4,4,5,2,538,652,878
778,18,120,658,928,270,24,24,677,677,0,0.00010211375472276115,0.0004084550188910446,496,688,192,4,4,4,4,3,675,301,391
779,42,248,739,957,218,86,86,669,669,0,0.00037441710065012424,0.0006126825283365669,656,724,68,3,3,3,14,11,108,162,248
780,6,6,416,416,0,15,15,426,426,0,0.00010211375472276115,0.00010211375472276115,479,479,0,-1,4,4,7,1,118,503,825
781,2,103,364,928,564,9,9,426,426,0,0.00010211375472276115,0.00013615167296368154,493,525,32,6,5,5,5,1,601,537,605
782,15,15,636,636,0,14,14,543,543,0,0.0002723033459273631,0.0002723033459273631,612,612,0,-1,4,4,3,4,626,86,611
783,74,175,868,956,88,50,50,830,830,0,0.0024507301133462676,0.002484768031587188,904,905,1,5,3,3,5,11,438,166,837
784,24,24,619,619,0,54,54,496,496,0,0.00017018959120460194,0.00017018959120460194,539,539,0,-1,4,4,15,9,37,317,987
785,54,155,869,970,101,22,22,805,805,0,0.0014295925661186562,0.0014636304843595766,853,859,6,6,3,3,2,14,609,84,694
786,0,0,1,1,0,0,0,1,1,0,0.0,0.0,1,1,0,-1,-1,-1,5,0,407,665,774
787,42,1642,792,1000,208,53,53,788,788,0,0.0022465026039007454,0.01494264610776405,894,989,95,1,2,2,7,2,207,749,414
788,6,6,498,498,0,7,7,513,513,0,3.4037918240920386e-05,3.4037918240920386e-05,403,403,0,-1,4,4,2,2,942,662,966
789,16,222,668,979,311,22,22,796,796,0,0.0018720855032506212,0.002110350930937064,883,900,17,3,3,3,2,1,705,537,586
790,62,62,811,811,0,140,140,905,905,0,0.0012253650566731338,0.0012253650566731338,823,823,0,-1,2,2,11,5,66,306,824
791,401,503,985,991,6,144,144,988,988,0,0.011130399264780965,0.011164437183021887,983,983,0,4,2,2,6,61,352,14,325
792,8,8,504,504,0,18,18,440,440,0,0.0002382654276864427,0.0002382654276864427,590,590,0,-1,4,4,8,2,309,523,445
793,0,616,1,993,992,0,38,1,677,676,0.0,0.0038462847612240037,1,944,943,2,-1,3,6,0,498,969,33
794,8,110,576,956,380,10,10,584,584,0,0.00017018959120460194,0.0002042275094455223,547,580,33,4,4,4,3,4,984,239,958
795,127,229,935,974,39,68,68,965,965,0,0.005105687736138058,0.005446066918547262,959,963,4,4,2,2,4,15,655,36,810
796,0,102,1,945,944,0,4,1,426,425,0.0,0.0008509479560230097,1,797,796,4,-1,5,2,0,998,967,79
797,6,212,396,950,554,40,56,480,560,80,6.807583648184077e-05,0.0017359338302869397,445,870,425,3,4,4,12,2,175,492,171
798,7,7,560,560,0,6,6,453,453,0,0.0002723033459273631,0.0002723033459273631,617,617,0,-1,5,5,3,7,535,427,733
799,0,206,1,974,973,0,10,1,505,504,0.0,0.0005105687736138058,1,713,712,3,-1,4,3,0,748,889,390
800,42,144,813,952,139,50,50,871,871,0,0.0016338200755641784,0.00176997174852786,853,863,10,4,3,3,5,7,843,224,652
801,76,282,836,970,134,130,130,858,858,0,0.0016338200755641784,0.0019741992579733825,855,878,23,3,3,3,15,13,110,261,173
802,16,118,688,954,266,18,18,806,806,0,0.0004084550188910446,0.0010211375472276116,675,828,153,4,3,3,2,1,771,759,113
803,12,113,634,942,308,12,12,616,616,0,0.00037441710065012424,0.0004084550188910446,669,683,14,5,4,4,2,2,734,465,274
804,0,206,1,967,966,0,24,1,598,597,0.0,0.00176997174852786,1,870,869,3,-1,4,4,0,385,984,73
805,99,305,878,976,98,118,118,910,910,0,0.001940161339732462,0.002484768031587188,884,912,28,3,2,2,9,11,213,97,418
806,0,0,1,1,0,0,0,1,1,0,0.0,0.0,1,1,0,-1,-1,-1,2,0,596,643,725
807,18,224,560,945,385,72,85,509,552,43,0.0002042275094455223,0.0006467204465774873,569,730,161,3,3,3,20,5,88,476,249
808,40,142,719,917,198,132,132,848,848,0,0.0014636304843595766,0.0017359338302869397,854,871,17,4,2,2,13,1,90,612,262
809,0,0,1,1,0,0,0,1,1,0,0.0,0.0,1,1,0,-1,-1,-1,3,0,707,884,981
810,99,200,932,977,45,22,22,781,781,0,0.0028932230504782326,0.0028932230504782326,929,929,0,5,3,3,2,20,907,94,578
811,31,647,757,996,239,40,50,767,841,74,0.0006467204465774873,0.002995336805200994,737,924,187,2,3,3,5,9,561,145,329
812,0,206,1,938,937,0,73,1,506,505,0.0,0.0007147962830593281,1,753,752,3,-1,4,21,0,3,836,490
813,353,353,973,973,0,486,486,978,978,0,0.004322815616596889,0.004322815616596889,939,939,0,-1,2,2,30,30,7,39,514
814,0,102,1,907,906,0,7,1,379,378,0.0,0.00010211375472276115,1,487,486,4,-1,5,5,0,412,843,239
815,100,100,889,889,0,100,100,972,972,0,0.032336022328874364,0.032336022328874364,999,999,0,-1,1,1,5,19,793,144,684
816,2,103,384,953,569,4,4,428,428,0,0.0,0.00017018959120460194,1,555,554,5,5,5,2,2,715,648,862
817,20,226,631,957,326,42,46,522,541,19,0.0002382654276864427,0.00037441710065012424,587,659,72,3,4,4,11,4,230,164,215
818,0,616,1,998,997,0,34,1,743,742,0.0,0.007216038667075122,1,973,972,2,-1,3,4,0,832,574,18
819,100,202,915,969,54,34,34,774,774,0,0.0020422750944552232,0.0020422750944552232,885,885,0,4,3,3,4,20,280,109,463
820,8,1648,501,1000,499,24,66,515,834,319,6.807583648184077e-05,0.01678069369277375,444,991,547,1,4,2,6,2,630,724,16
821,32,238,618,941,323,252,252,740,740,0,0.0004765308553728854,0.0005105687736138058,670,679,9,3,3,3,36,3,16,354,627
822,126,126,923,923,0,50,50,807,807,0,0.002723033459273631,0.002723033459273631,913,913,0,-1,3,3,5,20,377,38,860
823,10,216,570,971,401,28,32,601,624,23,0.00017018959120460194,0.0035059055788147996,546,935,389,3,4,4,6,4,253,617,14
824,0,0,1,1,0,0,0,1,1,0,0.0,0.0,1,1,0,-1,-1,-1,4,0,623,986,349
825,7,623,509,998,489,6,28,401,724,323,0.0002382654276864427,0.006399128629293032,597,968,371,2,5,3,3,6,687,613,6
826,44,44,794,794,0,50,50,794,794,0,0.0004084550188910446,0.0004084550188910446,687,687,0,-1,3,3,5,9,818,29,738
827,6,6,377,377,0,43,43,366,366,0,0.0,0.0,1,1,0,-1,4,4,35,1,20,543,472
828,0,102,1,918,917,0,7,1,400,399,0.0,0.0002382654276864427,1,598,597,4,-1,5,4,0,969,533,275
829,753,959,1000,1000,0,104,104,994,994,0,0.020661016372238675,0.02127369890057524,994,995,1,3,2,2,5,157,744,2,415
830,0,0,1,1,0,0,0,1,1,0,0.0,0.0,1,1,0,-1,-1,-1,15,0,102,881,731
831,2,618,355,995,640,8,56,374,825,451,0.0,0.015657442390823378,1,990,989,2,5,3,6,1,295,736,2
832,0,102,1,927,926,0,9,1,412,411,0.0,0.00013615167296368154,1,519,518,4,-1,5,5,1,602,874,380
833,0,101,1,952,951,0,2,1,331,330,0.0,3.4037918240920386e-05,1,408,407,5,-1,6,2,1,715,835,385
834,30,132,786,948,162,22,22,777,777,0,0.00088498587426393,0.0010211375472276116,799,818,19,4,3,3,2,4,926,470,432
835,288,288,979,979,0,134,134,965,965,0,0.007862759113652609,0.007862759113652609,973,973,0,-1,3,3,9,34,177,20,750
836,32,238,707,961,254,82,82,748,748,0,0.000442492937131965,0.002586881786309949,675,904,229,3,3,3,11,3,360,610,41
837,12,12,651,651,0,8,8,539,539,0,0.00030634126416828345,0.00030634126416828345,633,633,0,-1,4,4,2,6,809,494,723
838,0,206,1,964,963,0,22,1,490,489,0.0,0.00037441710065012424,1,665,664,3,-1,4,7,2,273,775,162
839,110,210,953,982,29,32,32,943,943,0,0.005241839409101739,0.005446066918547262,959,960,1,4,3,3,2,31,938,126,371
840,6,108,487,946,459,6,6,443,443,0,3.4037918240920386e-05,0.00013615167296368154,394,522,128,4,5,5,3,3,523,248,485
841,6,6,453,453,0,8,8,460,460,0,3.4037918240920386e-05,3.4037918240920386e-05,397,397,0,-1,4,4,3,1,743,623,713
842,169,271,972,984,12,34,34,837,837,0,0.004322815616596889,0.00445896728956057,953,953,0,4,3,3,4,54,603,28,325
843,0,0,1,1,0,0,0,1,1,0,0.0,0.0,1,1,0,-1,-1,-1,5,0,818,932,792
844,27,128,814,962,148,12,12,664,664,0,0.0005786446100956465,0.0006467204465774873,746,756,10,5,4,4,2,6,781,658,443
845,34,34,793,793,0,28,28,769,769,0,0.00088498587426393,0.00088498587426393,797,797,0,-1,3,3,3,8,829,264,782
846,0,206,1,969,968,0,22,1,558,557,0.0,0.0007828721195411688,1,772,771,3,-1,4,5,0,326,790,224
847,6,6,410,410,0,38,38,526,526,0,0.00010211375472276115,0.00010211375472276115,485,485,0,-1,4,4,9,1,192,958,698
848,12,113,743,977,234,8,8,687,687,0,0.0007488342013002485,0.0007488342013002485,788,788,0,9,4,4,2,6,944,232,647
849,6,108,469,940,471,9,9,475,475,0,0.0,0.00010211375472276115,1,491,490,4,4,4,3,1,676,421,220
850,108,108,896,896,0,124,124,926,926,0,0.003165526396405596,0.003165526396405596,926,926,0,-1,2,2,10,15,409,151,782
851,12,12,526,526,0,28,28,487,487,0,0.00013615167296368154,0.00013615167296368154,508,508,0,-1,4,4,8,3,244,196,901
852,40,246,787,970,183,66,70,913,914,1,0.0018720855032506212,0.003437829742332959,875,935,60,3,2,2,5,1,406,609,69
853,0,102,1,921,920,0,6,1,379,378,0.0,0.00017018959120460194,1,545,544,4,-1,5,4,0,280,992,722
854,0,102,1,913,912,0,5,1,362,361,0.0,0.00013615167296368154,1,513,512,4,-1,5,4,0,520,918,609
855,0,206,1,961,960,0,23,1,483,482,0.0,0.0006807583648184077,1,754,753,3,-1,4,8,0,158,713,355
856,6,6,517,517,0,12,12,686,686,0,0.00013615167296368154,0.00013615167296368154,538,538,0,-1,4,4,2,1,991,561,819
857,25,127,787,962,175,22,22,820,820,0,0.0007488342013002485,0.0007828721195411688,783,789,6,4,3,3,2,9,928,341,360
858,2,208,351,954,603,15,46,360,516,156,0.0,0.0005786446100956465,1,718,717,3,5,4,13,1,242,861,155
859,39,141,811,951,140,22,22,722,722,0,0.0005786446100956465,0.0015317063208414173,731,863,132,4,3,3,2,7,909,422,335
860,105,311,912,980,68,56,56,826,826,0,0.0019741992579733825,0.0024507301133462676,886,910,24,3,3,3,6,24,295,119,145
861,2,2,356,356,0,8,8,356,356,0,3.4037918240920386e-05,3.4037918240920386e-05,407,407,0,-1,5,5,7,2,141,656,798
862,0,0,1,1,0,0,0,1,1,0,0.0,0.0,1,1,0,-1,-1,-1,2,0,941,821,989
863,1,103,333,891,558,11,13,333,364,31,0.0,0.0002042275094455223,1,575,574,4,7,5,11,2,174,582,499
864,65,65,840,840,0,64,64,744,744,0,0.001497668402600497,0.001497668402600497,849,849,0,-1,3,3,9,16,422,113,201
865,6,108,494,942,448,18,18,669,669,0,0.0005446066918547262,0.0012934408931549745,725,847,122,4,4,4,3,1,835,759,97
866,7,7,554,554,0,12,12,616,616,0,0.00017018959120460194,0.00017018959120460194,539,539,0,-1,4,4,2,2,937,628,999
867,6,108,397,890,493,21,24,406,433,27,0.0,0.00034037918240920387,1,640,639,4,4,4,10,2,240,509,115
868,0,206,1,976,975,0,7,1,488,487,0.0,0.0002382654276864427,1,601,600,3,-1,4,2,0,880,990,809
869,0,0,1,1,0,0,0,1,1,0,0.0,0.0,1,1,0,-1,-1,-1,7,0,416,991,884
870,6,108,409,896,487,17,18,405,413,8,3.4037918240920386e-05,0.00013615167296368154,403,528,125,4,4,4,9,1,200,853,452
871,24,230,718,975,257,30,34,735,770,35,0.0002723033459273631,0.00088498587426393,606,793,187,3,3,3,4,4,424,202,155
872,0,0,1,1,0,0,0,1,1,0,0.0,0.0,1,1,0,-1,-1,-1,3,0,668,990,488
873,32,32,757,757,0,40,40,798,798,0,0.00037441710065012424,0.00037441710065012424,656,656,0,-1,3,3,4,2,385,682,850
874,0,102,1,927,926,0,5,1,383,382,0.0,0.0002723033459273631,1,611,610,4,-1,5,3,0,626,883,256
875,44,146,788,934,146,84,84,866,866,0,0.000442492937131965,0.0005105687736138058,674,702,28,4,3,3,8,7,443,134,567
876,24,24,636,636,0,56,56,586,586,0,0.0002042275094455223,0.0002042275094455223,576,576,0,-1,3,3,11,3,66,378,901
877,0,0,1,1,0,0,0,1,1,0,0.0,0.0,1,1,0,-1,-1,-1,3,0,879,832,726
878,181,283,950,973,23,124,124,918,918,0,0.004152626025392287,0.004152626025392287,946,946,0,4,3,3,9,24,213,13,676
879,44,250,742,959,217,110,110,755,755,0,0.0006467204465774873,0.0009190237925048504,733,785,52,3,3,3,15,4,81,246,217
880,16,222,651,973,322,34,34,784,784,0,0.00010211375472276115,0.0012253650566731338,490,836,346,3,3,3,4,2,784,493,245
881,31,133,765,941,176,44,44,850,850,0,0.0006467204465774873,0.0009190237925048504,754,801,47,4,3,3,4,6,539,471,427
882,451,553,988,991,3,158,158,973,973,0,0.008203138296061813,0.008305252050784574,976,976,0,4,2,2,9,59,180,5,549
883,11,217,588,973,385,20,20,612,612,0,6.807583648184077e-05,0.0002723033459273631,447,614,167,3,4,4,4,5,611,362,332
884,0,206,1,979,978,0,12,1,569,568,0.0,0.0006807583648184077,1,765,764,3,-1,4,4,1,860,874,412
885,24,125,805,968,163,24,24,878,878,0,0.00088498587426393,0.00088498587426393,792,792,0,7,3,3,3,5,852,221,972
886,910,1116,997,1000,3,462,462,1000,1000,0,0.013479015623404473,0.013615167296368155,990,990,0,3,2,2,19,85,46,0,770
887,26,26,748,748,0,34,34,867,867,0,0.000442492937131965,0.000442492937131965,681,681,0,-1,3,3,3,6,901,107,806
888,40,40,848,848,0,12,12,682,682,0,0.001940161339732462,0.001940161339732462,891,891,0,-1,4,4,2,12,702,100,818
889,257,257,960,960,0,196,196,953,953,0,0.005003573981415297,0.005003573981415297,954,954,0,-1,2,2,12,29,239,142,664
890,0,0,1,1,0,0,0,1,1,0,0.0,0.0,1,1,0,-1,-1,-1,2,0,881,834,388
891,217,423,967,987,20,104,104,977,977,0,0.005888559855679227,0.006671431975220395,967,970,3,3,2,2,5,24,349,8,118
892,1,103,333,917,584,5,6,333,365,32,0.0,0.00013615167296368154,1,520,519,4,6,5,5,1,464,763,298
893,104,104,896,896,0,84,84,826,826,0,0.002144388849177984,0.002144388849177984,897,897,0,-1,3,3,9,19,330,91,649
894,56,262,850,977,127,32,36,743,760,17,0.0011913271384322134,0.0020422750944552232,824,886,62,3,3,3,5,15,463,138,64
895,2,2,373,373,0,4,4,377,377,0,3.4037918240920386e-05,3.4037918240920386e-05,409,409,0,-1,5,5,3,1,716,558,909
896,58,264,862,978,116,58,58,940,940,0,0.00176997174852786,0.002757071377514551,881,916,35,3,2,2,4,7,401,169,60
897,0,616,1,992,991,0,42,1,463,462,0.0,0.000442492937131965,1,682,681,2,-1,3,15,0,68,901,182
898,0,102,1,975,974,0,3,1,440,439,0.0,0.00017018959120460194,1,582,581,4,-1,5,2,0,956,629,362
899,6,6,495,495,0,8,8,514,514,0,6.807583648184077e-05,6.807583648184077e-05,441,441,0,-1,4,4,2,1,924,152,845
900,1,207,333,974,641,3,10,333,469,136,3.4037918240920386e-05,0.0006467204465774873,407,752,345,3,6,4,3,2,484,615,415
901,0,206,1,978,977,0,10,1,530,529,0.0,0.002995336805200994,1,925,924,3,-1,4,3,0,600,922,51
902,1,1,332,332,0,3,3,332,332,0,0.0,0.0,1,1,0,-1,6,6,3,1,731,540,604
903,140,140,946,946,0,60,60,908,908,0,0.0026889955410327104,0.0026889955410327104,925,925,0,-1,3,3,5,20,692,38,698
904,12,114,667,963,296,10,10,564,564,0,0.00030634126416828345,0.00088498587426393,650,799,149,4,4,4,3,10,850,266,355
905,2,208,350,960,610,14,48,381,634,253,0.0,0.004833384390210695,1,958,957,3,5,4,8,2,244,662,19
906,0,0,1,1,0,0,0,1,1,0,0.0,0.0,1,1,0,-1,-1,-1,4,0,553,673,707
907,0,0,1,1,0,0,0,1,1,0,0.0,0.0,1,1,0,-1,-1,-1,12,0,187,802,587
908,17,119,608,908,300,46,46,673,673,0,0.0002042275094455223,0.0002042275094455223,563,563,0,4,3,3,6,2,157,101,878
909,5,107,444,929,485,3,3,367,367,0,0.0,3.4037918240920386e-05,1,405,404,4,5,5,2,3,932,580,346
910,6,6,395,395,0,27,27,445,445,0,3.4037918240920386e-05,3.4037918240920386e-05,400,400,0,-1,4,4,11,1,360,594,975
911,0,0,1,1,0,0,0,1,1,0,0.0,0.0,1,1,0,-1,-1,-1,7,0,196,965,950
912,490,696,994,999,5,88,88,979,979,0,0.012185574730249497,0.0123557643214541,989,989,0,3,2,2,4,92,887,30,521
913,0,102,1,930,929,0,4,1,361,360,0.0,0.00010211375472276115,1,493,492,4,-1,5,3,1,833,706,215
914,24,24,676,676,0,48,48,645,645,0,0.0002723033459273631,0.0002723033459273631,608,608,0,-1,3,3,11,3,261,236,980
915,124,226,918,963,45,120,120,929,929,0,0.002484768031587188,0.002586881786309949,901,902,1,4,3,3,10,20,243,95,710
916,0,0,1,1,0,0,0,1,1,0,0.0,0.0,1,1,0,-1,-1,-1,2,0,742,823,882
917,0,0,1,1,0,0,0,1,1,0,0.0,0.0,1,1,0,-1,-1,-1,8,0,199,888,793
918,178,794,936,996,60,214,214,958,958,0,0.004356853534837809,0.006875659484665918,946,962,16,2,2,2,15,19,68,135,38
919,2,104,351,892,541,11,14,351,370,19,0.0,0.0002042275094455223,1,542,541,4,5,5,10,1,169,893,451
920,113,113,946,946,0,32,32,916,916,0,0.0037441710065012424,0.0037441710065012424,936,936,0,-1,3,3,2,19,849,135,433
921,136,342,937,983,46,86,86,939,939,0,0.004050512270669526,0.004186663943633207,947,950,3,3,2,2,7,22,697,128,677
922,0,206,1,969,968,0,16,1,516,515,0.0,0.0006467204465774873,1,757,756,3,-1,4,4,0,641,888,143
923,32,32,784,784,0,28,28,769,769,0,0.0005446066918547262,0.0005446066918547262,718,718,0,-1,3,3,3,11,829,249,841
924,127,229,944,975,31,74,74,955,955,0,0.0036760951700194017,0.003914360597705844,936,943,7,4,2,2,5,22,517,203,323
925,18,224,615,965,350,48,52,599,619,20,0.00037441710065012424,0.0007147962830593281,659,753,94,3,4,4,10,6,211,447,354
926,2,2,362,362,0,6,6,392,392,0,6.807583648184077e-05,6.807583648184077e-05,450,450,0,-1,5,5,3,1,837,481,712
927,277,379,978,987,9,104,104,979,979,0,0.009973110044589673,0.010041185881071514,983,983,0,4,2,2,5,34,467,20,176
928,33,649,768,997,229,40,50,789,850,61,0.0006807583648184077,0.002586881786309949,757,908,151,2,3,3,5,7,662,237,137
929,0,0,1,1,0,0,0,1,1,0,0.0,0.0,1,1,0,-1,-1,-1,16,0,195,511,735
930,6,108,478,939,461,18,18,658,658,0,0.00017018959120460194,0.00030634126416828345,551,638,87,4,4,4,3,1,748,655,592
931,16,16,590,590,0,35,35,631,631,0,0.00010211375472276115,0.00010211375472276115,471,471,0,-1,3,3,7,1,361,594,701
932,6,6,480,480,0,7,7,489,489,0,0.0,0.0,1,1,0,-1,4,4,2,1,880,531,548
933,21,21,710,710,0,16,16,546,546,0,0.00017018959120460194,0.00017018959120460194,540,540,0,-1,4,4,4,7,550,188,948
934,36,652,832,1000,168,24,34,803,893,90,0.0005786446100956465,0.0030293747234419145,736,931,195,2,3,3,3,9,862,391,415
935,56,672,749,991,242,184,194,810,827,17,0.0006467204465774873,0.0013955546478777359,734,839,105,2,2,2,20,8,5,302,232
936,10,216,505,955,450,50,50,518,518,0,0.00010211375472276115,0.0002042275094455223,479,562,83,3,4,4,15,3,138,214,958
937,0,0,1,1,0,0,0,1,1,0,0.0,0.0,1,1,0,-1,-1,-1,3,0,620,776,502
938,0,0,1,1,0,0,0,1,1,0,0.0,0.0,1,1,0,-1,-1,-1,21,2,3,633,790
939,18,120,568,886,318,80,80,555,555,0,0.00013615167296368154,0.00013615167296368154,512,512,0,4,4,4,18,4,64,443,639
940,0,616,1,999,998,0,30,1,777,776,0.0,0.005820484019197386,1,961,960,2,-1,3,4,0,550,951,6
941,0,0,1,1,0,0,0,1,1,0,0.0,0.0,1,1,0,-1,-1,-1,2,0,913,600,886
942,171,787,932,996,64,198,198,889,889,0,0.0015317063208414173,0.0030974505599237552,849,931,82,2,3,3,18,20,34,71,281
943,2,104,353,907,554,13,13,382,382,0,0.0,6.807583648184077e-05,1,436,435,4,5,5,8,1,146,558,310
944,0,102,1,906,905,0,8,1,393,392,0.0,0.00034037918240920387,1,638,637,4,-1,5,4,0,671,769,688
945,0,0,1,1,0,0,0,1,1,0,0.0,0.0,1,1,0,-1,-1,-1,7,0,472,812,786
946,6,6,404,404,0,24,24,461,461,0,3.4037918240920386e-05,3.4037918240920386e-05,405,405,0,-1,4,4,8,1,358,964,819
947,103,309,900,979,79,68,68,821,821,0,0.0020422750944552232,0.0028932230504782326,876,913,37,3,3,3,8,17,449,180,207
948,138,239,969,986,17,38,38,928,928,0,0.0038462847612240037,0.0038462847612240037,939,939,0,6,3,3,3,48,768,56,374
949,0,206,1,971,970,0,10,1,459,458,0.0,0.0005786446100956465,1,727,726,3,-1,4,3,0,577,520,64
950,0,0,1,1,0,0,0,1,1,0,0.0,0.0,1,1,0,-1,-1,-1,9,0,159,455,678
951,0,0,1,1,0,0,0,1,1,0,0.0,0.0,1,1,0,-1,-1,-1,4,1,540,685,822
952,23,23,748,748,0,24,24,775,775,0,0.0004084550188910446,0.0004084550188910446,681,681,0,-1,3,3,3,5,564,570,674
953,0,0,1,1,0,0,0,1,1,0,0.0,0.0,1,1,0,-1,-1,-1,8,0,418,716,952
954,0,101,1,905,904,0,7,1,332,331,0.0,0.0,1,1,0,5,-1,6,7,2,364,775,495
955,0,102,1,943,942,0,4,1,442,441,0.0,0.00034037918240920387,1,663,662,4,-1,5,2,0,876,915,616
956,1,102,333,891,558,7,7,333,333,0,0.0,0.0,1,1,0,6,7,7,7,1,296,469,344
957,9,215,567,971,404,10,14,458,533,75,6.807583648184077e-05,0.0006467204465774873,461,753,292,3,4,4,3,3,836,485,316
958,0,0,1,1,0,0,0,1,1,0,0.0,0.0,1,1,0,-1,-1,-1,3,0,608,715,835
959,0,0,1,1,0,0,0,1,1,0,0.0,0.0,1,1,0,-1,-1,-1,6,0,98,928,796
960,0,0,1,1,0,0,0,1,1,0,0.0,0.0,1,1,0,-1,-1,-1,8,2,225,431,906
961,0,0,1,1,0,0,0,1,1,0,0.0,0.0,1,1,0,-1,-1,-1,3,3,621,348,731
962,20,121,620,903,283,32,32,481,481,0,6.807583648184077e-05,0.00010211375472276115,449,479,30,5,4,4,10,4,135,208,618
963,0,206,1,957,956,0,17,1,412,411,0.0,0.00017018959120460194,1,548,547,3,-1,4,9,2,126,684,363
964,20,121,654,925,271,20,20,548,548,0,0.000442492937131965,0.000442492937131965,684,684,0,5,4,4,4,4,540,333,373
965,83,83,862,862,0,64,64,761,761,0,0.00088498587426393,0.00088498587426393,792,792,0,-1,3,3,8,15,297,219,950
966,0,0,1,1,0,0,0,1,1,0,0.0,0.0,1,1,0,-1,-1,-1,10,1,437,529,871
967,0,102,1,911,910,0,8,1,370,369,0.0,0.00010211375472276115,1,487,486,4,-1,5,6,0,266,833,797
968,2,208,363,971,608,7,12,405,495,90,0.0,0.0009870996289866913,1,790,789,3,5,4,4,1,520,799,444
969,14,220,538,952,414,48,52,520,557,37,0.0002042275094455223,0.0002723033459273631,559,603,44,3,4,4,12,7,143,451,492
970,6,212,545,990,445,8,8,592,592,0,0.0002042275094455223,0.0008509479560230097,578,793,215,3,4,4,2,1,997,727,101
971,0,206,1,971,970,0,10,1,486,485,0.0,0.0005105687736138058,1,721,720,3,-1,4,3,1,620,456,46
972,23,124,802,969,167,12,12,692,692,0,0.0006807583648184077,0.0006807583648184077,766,766,0,6,4,4,2,9,751,293,671
973,150,251,936,970,34,128,128,946,946,0,0.004050512270669526,0.0040845501889104465,944,945,1,5,2,2,9,18,180,171,771
974,46,662,720,989,269,162,172,783,805,22,0.0007488342013002485,0.0016338200755641784,746,863,117,2,2,2,19,2,35,628,264
975,44,44,746,746,0,130,130,810,810,0,0.00088498587426393,0.00088498587426393,780,780,0,-1,3,3,15,6,102,234,856
976,71,71,952,952,0,18,18,932,932,0,0.0032336022328874367,0.0032336022328874367,943,943,0,-1,3,3,2,30,956,65,498
977,24,230,731,975,244,28,28,648,648,0,0.00037441710065012424,0.0013274788113958951,662,842,180,3,4,4,6,6,529,461,277
978,31,31,769,769,0,28,28,749,749,0,0.0010892133837094523,0.0010892133837094523,828,828,0,-1,3,3,3,6,900,232,729
979,0,102,1,922,921,0,4,1,406,405,0.0,0.0006467204465774873,1,754,753,4,-1,5,2,0,990,906,150
980,0,102,1,886,885,0,13,1,374,373,0.0,6.807583648184077e-05,1,449,448,4,-1,5,9,0,327,769,408
981,0,0,1,1,0,0,0,1,1,0,0.0,0.0,1,1,0,-1,-1,-1,5,0,616,911,672
982,0,0,1,1,0,0,0,1,1,0,0.0,0.0,1,1,0,-1,-1,-1,5,0,848,965,632
983,0,0,1,1,0,0,0,1,1,0,0.0,0.0,1,1,0,-1,-1,-1,2,0,890,941,624
984,6,107,492,948,456,12,12,538,538,0,0.00017018959120460194,0.00017018959120460194,540,540,0,5,4,4,4,2,754,223,244
985,20,226,682,973,291,22,34,642,754,112,0.0002382654276864427,0.001599782157323258,598,861,263,3,3,3,4,3,736,458,89
986,0,206,1,970,969,0,11,1,464,463,0.0,0.00034037918240920387,1,656,655,3,-1,4,4,0,401,866,160
987,0,206,1,974,973,0,14,1,542,541,0.0,0.0030974505599237552,1,923,922,3,-1,4,3,0,651,963,28
988,55,55,872,872,0,44,44,913,913,0,0.001599782157323258,0.001599782157323258,867,867,0,-1,3,3,4,12,754,163,520
989,16,16,524,524,0,106,106,718,718,0,0.00010211375472276115,0.00010211375472276115,467,467,0,-1,3,3,15,1,49,667,693
990,68,68,872,872,0,36,36,755,755,0,0.002212464685659825,0.002212464685659825,894,894,0,-1,4,4,6,19,486,91,859
991,31,132,821,963,142,22,22,826,826,0,0.0007828721195411688,0.0007828721195411688,776,776,0,5,3,3,2,9,851,211,244
992,13,13,577,577,0,38,38,607,607,0,0.00030634126416828345,0.00030634126416828345,642,642,0,-1,4,4,7,5,466,362,744
993,6,6,466,466,0,12,12,505,505,0,0.0002042275094455223,0.0002042275094455223,580,580,0,-1,4,4,4,1,696,741,757
994,0,102,1,955,954,0,3,1,388,387,0.0,0.00010211375472276115,1,502,501,4,-1,5,2,0,967,564,314
995,0,206,1,957,956,0,25,1,453,452,0.0,0.0008509479560230097,1,779,778,3,-1,4,9,0,147,909,226
996,4,4,532,532,0,4,4,486,486,0,0.0002042275094455223,0.0002042275094455223,590,590,0,-1,5,5,2,4,884,346,910
997,679,679,995,995,0,168,168,976,976,0,0.012730181422104225,0.012730181422104225,986,986,0,-1,2,2,9,91,381,7,812
998,523,523,991,991,0,198,198,986,986,0,0.01055175465468532,0.01055175465468532,978,978,0,-1,2,2,10,92,293,30,436
999,28,129,795,954,159,22,22,805,805,0,0.0006126825283365669,0.0006467204465774873,746,752,6,5,3,3,2,6,939,192,309
