,FreeNet_pre_score,FreeNet_post_score,FreeNet_pre_rank,FreeNet_post_rank,FreeNet_delta_ranks,Reversed_pre_score,Reversed_post_score,Reversed_pre_rank,Reversed_post_rank,Reversed_delta_ranks,Random_pre_score,Random_post_score,Random_pre_rank,Random_post_rank,Random_delta_ranks,dist_victim_relayer,dist_victim_vilain_pre,dist_victim_vilain_post,out_deg_victim,in_deg_villain,victim,villain,relayer
0,18,18,597,597,0,68,68,627,627,0,0.0002723033459273631,0.0002723033459273631,610,610,0,-1,4,4,12,5,116,688,812
1,62,164,823,936,113,134,134,870,870,0,0.0015317063208414173,0.0015657442390823377,858,862,4,4,2,2,13,7,97,399,260
2,0,101,1,951,950,0,2,1,330,329,0.0,3.4037918240920386e-05,1,396,395,5,-1,6,2,0,830,629,384
3,186,287,934,966,32,268,268,947,947,0,0.002212464685659825,0.002212464685659825,891,891,0,5,2,2,20,15,70,53,402
4,2,103,369,936,567,4,4,371,371,0,0.0,3.4037918240920386e-05,1,405,404,5,5,5,3,1,863,896,398
5,0,616,1,994,993,0,110,1,857,856,0.0,0.008373327887266415,1,972,971,2,-1,3,10,0,149,981,19
6,13,219,594,970,376,26,30,604,673,69,0.0002382654276864427,0.0014295925661186562,596,855,259,3,4,4,5,3,724,385,59
7,0,206,1,977,976,0,12,1,615,614,0.0,0.003948398515946765,1,941,940,3,-1,4,2,0,779,538,31
8,0,0,1,1,0,0,0,1,1,0,0.0,0.0,1,1,0,-1,-1,-1,11,0,230,981,716
9,0,101,1,943,942,0,2,1,330,329,0.0,6.807583648184077e-05,1,454,453,5,-1,6,2,0,876,959,392
10,13,219,619,974,355,16,16,580,580,0,0.00013615167296368154,0.0036760951700194017,519,940,421,3,4,4,4,3,507,347,31
11,37,138,817,949,132,18,18,646,646,0,0.00088498587426393,0.00088498587426393,793,793,0,5,4,4,3,9,626,130,598
12,2,103,360,920,560,7,7,401,401,0,0.0,0.0,1,1,0,5,5,5,4,3,969,466,764
13,18,18,654,654,0,17,17,506,506,0,0.00010211375472276115,0.00010211375472276115,483,483,0,-1,4,4,5,6,487,229,620
14,0,206,1,960,959,0,30,1,539,538,0.0,0.002723033459273631,1,917,916,3,-1,4,7,0,678,838,102
15,12,12,632,632,0,8,8,502,502,0,0.0004084550188910446,0.0004084550188910446,681,681,0,-1,4,4,2,4,980,504,554
16,6,6,432,432,0,10,10,415,415,0,3.4037918240920386e-05,3.4037918240920386e-05,406,406,0,-1,4,4,5,2,677,764,732
17,0,101,1,958,957,0,3,1,330,329,0.0,3.4037918240920386e-05,1,401,400,5,-1,6,3,0,668,930,799
18,2,2,362,362,0,9,9,420,420,0,0.0,0.0,1,1,0,-1,5,5,5,3,647,321,848
19,127,127,892,892,0,192,192,888,888,0,0.0018720855032506212,0.0018720855032506212,878,878,0,-1,3,3,17,18,23,82,792
20,169,271,960,977,17,32,32,882,882,0,0.004833384390210695,0.004833384390210695,957,957,0,4,3,3,2,36,893,48,639
21,0,101,1,945,944,0,2,1,331,330,0.0,3.4037918240920386e-05,1,418,417,5,-1,6,2,0,928,760,481
22,0,0,1,1,0,0,0,1,1,0,0.0,0.0,1,1,0,-1,-1,-1,3,0,867,794,614
23,0,101,1,933,932,0,4,1,332,331,0.0,0.0,1,1,0,5,-1,6,4,1,827,706,357
24,133,234,936,970,34,56,56,816,816,0,0.002382654276864427,0.002382654276864427,908,908,0,5,3,3,6,27,251,61,575
25,0,0,1,1,0,0,0,1,1,0,0.0,0.0,1,1,0,-1,-1,-1,9,0,168,955,478
26,0,102,1,868,867,0,25,1,376,375,0.0,6.807583648184077e-05,1,443,442,4,-1,5,15,0,77,850,586
27,25,25,757,757,0,34,34,813,813,0,0.00030634126416828345,0.00030634126416828345,638,638,0,-1,3,3,4,5,721,510,960
28,0,0,1,1,0,0,0,1,1,0,0.0,0.0,1,1,0,-1,-1,-1,9,0,250,324,456
29,150,150,913,913,0,188,188,926,926,0,0.003948398515946765,0.003948398515946765,944,944,0,-1,2,2,14,18,122,54,999
30,0,101,1,917,916,0,3,1,331,330,0.0,6.807583648184077e-05,1,440,439,5,-1,6,3,0,989,943,597
31,141,141,955,955,0,60,60,919,919,0,0.0046972327172470135,0.0046972327172470135,950,950,0,-1,3,3,5,25,376,105,733
32,14,14,587,587,0,18,18,503,503,0,0.0002042275094455223,0.0002042275094455223,569,569,0,-1,4,4,5,3,531,307,569
33,60,266,856,976,120,54,54,895,895,0,0.0024166921951053475,0.00445896728956057,907,949,42,3,3,3,4,12,832,104,111
34,0,206,1,964,963,0,19,1,446,445,0.0,0.0007488342013002485,1,767,766,3,-1,4,8,2,323,462,120
35,0,616,1,990,989,0,69,1,534,533,0.0,0.0009530617107457708,1,789,788,2,-1,3,18,0,86,993,92
36,60,161,892,969,77,22,22,834,834,0,0.0013615167296368155,0.0013615167296368155,856,856,0,6,3,3,2,14,895,146,861
37,0,206,1,976,975,0,12,1,714,713,0.0,0.0018380475850097008,1,891,890,3,-1,4,2,0,684,804,63
38,0,0,1,1,0,0,0,1,1,0,0.0,0.0,1,1,0,-1,-1,-1,7,0,196,844,673
39,0,206,1,955,954,0,28,1,453,452,0.0,0.0009870996289866913,1,798,797,3,-1,4,10,1,125,835,147
40,0,206,1,978,977,0,8,1,518,517,0.0,0.0011913271384322134,1,831,830,3,-1,4,2,0,979,886,38
41,52,154,856,963,107,24,24,707,707,0,0.0010892133837094523,0.0012934408931549745,820,841,21,4,4,4,4,15,721,92,552
42,1,102,333,920,587,4,4,333,333,0,0.0,0.00010211375472276115,1,488,487,5,7,6,4,3,741,626,615
43,0,0,1,1,0,0,0,1,1,0,0.0,0.0,1,1,0,-1,-1,-1,2,0,997,614,455
44,45,251,763,964,201,70,70,614,614,0,0.0005786446100956465,0.0018720855032506212,728,882,154,3,4,4,13,12,67,159,59
45,23,125,751,950,199,28,28,791,791,0,0.0006126825283365669,0.001497668402600497,743,868,125,4,3,3,3,3,958,280,96
46,16,222,521,951,430,40,48,432,458,26,0.00013615167296368154,0.0002042275094455223,503,561,58,3,3,3,17,1,71,337,491
47,35,241,787,976,189,34,34,752,752,0,0.0011913271384322134,0.0014636304843595766,833,855,22,3,3,3,4,11,512,118,470
48,32,238,736,968,232,54,54,768,768,0,0.0005446066918547262,0.0009530617107457708,704,793,89,3,3,3,7,5,398,182,338
49,0,0,1,1,0,0,0,1,1,0,0.0,0.0,1,1,0,-1,-1,-1,9,3,388,854,836
50,0,0,1,1,0,0,0,1,1,0,0.0,0.0,1,1,0,-1,-1,-1,20,1,61,779,872
51,41,247,771,970,199,70,70,774,774,0,0.0006467204465774873,0.0009530617107457708,738,793,55,3,3,3,9,6,395,232,165
52,0,206,1,956,955,0,30,1,482,481,0.0,0.0010892133837094523,1,811,810,3,-1,4,9,0,306,963,180
53,26,128,795,964,169,28,28,837,837,0,0.0010211375472276116,0.0012594029749140542,807,841,34,4,3,3,3,6,798,379,101
54,0,101,1,931,930,0,5,1,331,330,0.0,0.0,1,1,0,7,-1,8,5,0,695,632,663
55,22,22,760,760,0,12,12,694,694,0,0.0006807583648184077,0.0006807583648184077,760,760,0,-1,4,4,2,7,896,218,758
56,84,700,834,993,159,156,180,783,834,51,0.0007828721195411688,0.0033357159876101976,749,929,180,2,2,2,19,6,83,376,27
57,0,102,1,930,929,0,4,1,403,402,0.0,0.001055175465468532,1,824,823,4,-1,5,2,0,934,713,72
58,62,164,837,940,103,92,92,890,890,0,0.0011232513019503727,0.0011913271384322134,825,836,11,4,2,2,8,5,334,221,290
59,2,2,362,362,0,6,6,362,362,0,3.4037918240920386e-05,3.4037918240920386e-05,402,402,0,-1,5,5,5,1,843,593,709
60,0,0,1,1,0,0,0,1,1,0,0.0,0.0,1,1,0,-1,-1,-1,5,1,537,573,498
61,171,273,939,968,29,146,146,933,933,0,0.003880322679464924,0.0040845501889104465,941,944,3,4,3,3,11,29,215,142,477
62,0,206,1,973,972,0,16,1,539,538,0.0,0.0009870996289866913,1,799,798,3,-1,4,4,0,735,702,174
63,40,40,836,836,0,34,34,844,844,0,0.0013615167296368155,0.0013615167296368155,848,848,0,-1,3,3,4,9,679,130,914
64,9,111,527,909,382,40,40,604,604,0,0.0002042275094455223,0.00037441710065012424,561,664,103,4,4,4,8,4,201,287,523
65,0,206,1,973,972,0,24,1,663,662,0.0,0.002484768031587188,1,911,910,3,-1,4,4,1,513,806,108
66,28,28,767,767,0,22,22,760,760,0,0.0006126825283365669,0.0006126825283365669,741,741,0,-1,3,3,2,5,643,221,726
67,0,206,1,958,957,0,21,1,471,470,0.0,0.0002382654276864427,1,598,597,3,-1,4,7,0,118,638,291
68,12,114,620,948,328,12,12,635,635,0,0.00017018959120460194,0.0008509479560230097,563,794,231,4,4,4,2,4,747,149,155
69,6,6,480,480,0,8,8,499,499,0,0.00010211375472276115,0.00010211375472276115,496,496,0,-1,4,4,2,2,881,597,818
70,31,31,772,772,0,34,34,777,777,0,0.0006807583648184077,0.0006807583648184077,760,760,0,-1,3,3,4,6,513,471,929
71,121,327,915,977,62,122,122,955,955,0,0.003267640151128357,0.004561081044283332,930,946,16,3,2,2,8,15,334,36,261
72,27,233,745,973,228,12,12,549,549,0,0.0006126825283365669,0.0010211375472276116,735,808,73,3,4,4,2,11,909,249,283
73,9,9,552,552,0,20,20,582,582,0,6.807583648184077e-05,6.807583648184077e-05,448,448,0,-1,4,4,5,3,551,485,811
74,85,85,878,878,0,100,100,957,957,0,0.0032336022328874367,0.0032336022328874367,931,931,0,-1,2,2,6,6,266,73,841
75,0,206,1,972,971,0,10,1,460,459,0.0,0.0009190237925048504,1,801,800,3,-1,4,3,0,801,715,63
76,371,577,983,993,10,136,136,987,987,0,0.008135062459579971,0.01143674052894925,976,984,8,3,2,2,7,55,336,21,77
77,66,66,872,872,0,40,40,806,806,0,0.001599782157323258,0.001599782157323258,868,868,0,-1,3,3,5,14,647,146,819
78,39,655,714,992,278,86,96,638,684,46,0.0004765308553728854,0.0018380475850097008,691,877,186,2,3,3,14,5,85,510,189
79,6,6,493,493,0,8,8,504,504,0,0.0002042275094455223,0.0002042275094455223,576,576,0,-1,4,4,2,2,734,785,907
80,0,0,1,1,0,0,0,1,1,0,0.0,0.0,1,1,0,-1,-1,-1,19,0,83,772,455
81,19,121,732,956,224,8,8,534,534,0,0.0007147962830593281,0.00088498587426393,778,809,31,4,4,4,2,8,684,386,566
82,24,24,765,765,0,12,12,631,631,0,0.0007488342013002485,0.0007488342013002485,772,772,0,-1,4,4,2,4,894,470,925
83,9,9,621,621,0,10,10,579,579,0,0.0005786446100956465,0.0005786446100956465,723,723,0,-1,4,4,3,4,786,336,548
84,8,8,531,531,0,24,24,550,550,0,0.0002723033459273631,0.0002723033459273631,612,612,0,-1,4,4,6,2,465,524,912
85,6,108,467,930,463,12,12,485,485,0,0.0,0.00017018959120460194,1,545,544,4,4,4,4,2,475,719,247
86,78,178,856,951,95,84,84,879,879,0,0.0012934408931549745,0.0014295925661186562,832,841,9,4,3,3,8,9,302,242,270
87,36,242,746,970,224,40,40,604,604,0,0.0006807583648184077,0.0010211375472276116,744,808,64,3,4,4,8,6,380,658,187
88,58,159,880,965,85,22,22,823,823,0,0.001157289220191293,0.0012253650566731338,837,841,4,5,3,3,2,18,802,148,601
89,0,101,1,912,911,0,6,1,332,331,0.0,0.0,1,1,0,6,-1,7,6,0,253,538,663
90,85,187,890,965,75,60,60,894,894,0,0.0016678579938050988,0.002144388849177984,863,892,29,4,3,3,5,19,662,144,272
91,0,206,1,977,976,0,8,1,524,523,0.0,0.0007147962830593281,1,766,765,3,-1,4,2,0,975,887,117
92,0,102,1,951,950,0,6,1,443,442,0.0,0.00030634126416828345,1,645,644,4,-1,5,3,0,584,783,610
93,16,16,524,524,0,142,142,822,822,0,0.0006807583648184077,0.0006807583648184077,740,740,0,-1,3,3,15,1,49,612,815
94,28,234,727,972,245,46,46,735,735,0,0.0007147962830593281,0.0011232513019503727,758,820,62,3,3,3,6,4,387,407,221
95,43,43,844,844,0,18,18,708,708,0,0.00088498587426393,0.00088498587426393,795,795,0,-1,4,4,3,17,871,226,793
96,0,206,1,974,973,0,8,1,491,490,0.0,0.0004084550188910446,1,680,679,3,-1,4,2,0,598,201,354
97,94,196,891,963,72,54,54,875,875,0,0.0020422750944552232,0.0021784267674189047,884,895,11,4,3,3,4,17,540,60,682
98,2,104,353,901,548,12,12,390,390,0,0.0,0.0002723033459273631,1,615,614,4,5,5,7,3,207,321,328
99,5,106,420,896,476,16,16,412,412,0,0.00010211375472276115,0.00010211375472276115,485,485,0,8,5,5,8,3,428,534,857
100,0,102,1,906,905,0,6,1,362,361,0.0,6.807583648184077e-05,1,453,452,4,-1,5,4,0,671,649,425
101,30,646,645,988,343,114,204,648,867,219,0.0002382654276864427,0.013036522686272508,588,987,399,2,3,3,19,5,35,487,3
102,0,102,1,930,929,0,5,1,354,353,0.0,0.0,1,1,0,4,-1,5,4,0,562,614,468
103,0,0,1,1,0,0,0,1,1,0,0.0,0.0,1,1,0,-1,-1,-1,4,0,504,919,744
104,38,244,868,991,123,12,12,713,713,0,0.0017018959120460194,0.004118588107151367,881,943,62,3,4,4,2,13,963,42,74
105,0,0,1,1,0,0,0,1,1,0,0.0,0.0,1,1,0,-1,-1,-1,7,0,343,825,833
106,2,208,349,950,601,15,51,368,560,192,0.0,0.0008169100377820892,1,766,765,3,5,4,12,1,194,896,497
107,163,163,957,957,0,90,90,958,958,0,0.004969536063174376,0.004969536063174376,963,963,0,-1,2,2,6,26,373,127,985
108,6,108,470,939,469,12,12,597,597,0,0.00037441710065012424,0.000442492937131965,672,704,32,4,4,4,2,2,972,785,215
109,13,13,640,640,0,18,18,658,658,0,0.0006807583648184077,0.0006807583648184077,763,763,0,-1,4,4,3,5,748,589,963
110,24,126,710,930,220,28,28,654,654,0,0.0002382654276864427,0.0005105687736138058,588,712,124,4,3,3,5,4,467,220,287
111,1,617,332,999,667,2,22,332,786,454,0.0,0.005990673610401988,1,963,962,2,6,3,2,2,804,374,5
112,0,101,1,969,968,0,2,1,330,329,0.0,6.807583648184077e-05,1,460,459,5,-1,6,2,0,962,565,492
113,0,0,1,1,0,0,0,1,1,0,0.0,0.0,1,1,0,-1,-1,-1,3,0,471,996,725
114,22,22,788,788,0,22,22,860,860,0,0.00030634126416828345,0.00030634126416828345,655,655,0,-1,3,3,2,6,994,199,925
115,0,0,1,1,0,0,0,1,1,0,0.0,0.0,1,1,0,-1,-1,-1,5,3,524,753,794
116,26,232,791,982,191,18,18,721,721,0,0.0006467204465774873,0.0028932230504782326,753,927,174,3,4,4,3,9,569,414,26
117,2,208,375,976,601,4,8,427,504,77,6.807583648184077e-05,0.0016338200755641784,452,876,424,3,5,4,2,1,896,771,133
118,0,0,1,1,0,0,0,1,1,0,0.0,0.0,1,1,0,-1,-1,-1,9,0,276,856,782
119,0,206,1,970,969,0,14,1,541,540,0.0,0.0013274788113958951,1,844,843,3,-1,4,3,0,471,833,78
120,0,101,1,897,896,0,6,1,332,331,0.0,0.00010211375472276115,1,491,490,5,-1,6,6,0,368,819,607
121,8,109,526,912,386,20,20,495,495,0,3.4037918240920386e-05,3.4037918240920386e-05,412,412,0,5,4,4,6,3,281,434,618
122,47,47,797,797,0,67,67,763,763,0,0.0005786446100956465,0.0005786446100956465,727,727,0,-1,2,2,9,3,200,580,966
123,64,64,875,875,0,34,34,824,824,0,0.0019741992579733825,0.0019741992579733825,880,880,0,-1,3,3,4,22,696,128,776
124,6,107,445,916,471,13,13,458,458,0,0.00010211375472276115,0.00013615167296368154,486,520,34,5,4,4,5,2,604,342,499
125,67,67,855,855,0,56,56,778,778,0,0.0013274788113958951,0.0013274788113958951,836,836,0,-1,3,3,6,15,352,62,787
126,18,18,691,691,0,32,32,776,776,0,0.0002723033459273631,0.0002723033459273631,614,614,0,-1,3,3,5,5,602,722,725
127,138,754,914,994,80,118,118,914,914,0,0.0023486163586235067,0.003710133088260322,897,938,41,2,2,2,9,12,140,58,269
128,13,115,674,956,282,8,8,544,544,0,0.00030634126416828345,0.0016678579938050988,656,883,227,4,4,4,2,6,781,4,112
129,1,1,332,332,0,2,2,332,332,0,0.0,0.0,1,1,0,-1,7,7,2,1,914,603,235
130,23,23,645,645,0,68,68,713,713,0,0.00030634126416828345,0.00030634126416828345,610,610,0,-1,3,3,8,3,370,291,907
131,6,212,479,974,495,8,12,489,598,109,3.4037918240920386e-05,0.0007488342013002485,410,782,372,3,4,4,2,1,886,718,229
132,68,274,830,971,141,94,98,815,853,38,0.001055175465468532,0.0014636304843595766,817,850,33,3,2,2,9,8,159,286,413
133,0,206,1,940,939,0,35,1,400,399,0.0,0.0002382654276864427,1,587,586,3,-1,4,19,0,48,205,636
134,0,102,1,927,926,0,4,1,392,391,0.0,0.0004765308553728854,1,715,714,4,-1,5,2,0,828,843,159
135,0,102,1,921,920,0,8,1,401,400,0.0,0.00010211375472276115,1,495,494,4,-1,5,5,0,456,201,384
136,0,0,1,1,0,0,0,1,1,0,0.0,0.0,1,1,0,-1,-1,-1,12,0,44,919,889
137,2,2,372,372,0,4,4,446,446,0,0.00010211375472276115,0.00010211375472276115,502,502,0,-1,5,5,2,2,806,648,965
138,11,113,714,973,259,12,12,785,785,0,0.0007488342013002485,0.0009870996289866913,784,816,32,4,4,4,2,7,936,224,232
139,23,124,770,963,193,12,12,668,668,0,0.0007488342013002485,0.0008169100377820892,769,782,13,5,4,4,2,7,618,396,567
140,24,230,657,964,307,47,64,609,716,107,0.00034037918240920387,0.0018040096667687805,656,869,213,3,3,3,9,3,367,653,104
141,13,13,607,607,0,18,18,537,537,0,0.0002723033459273631,0.0002723033459273631,615,615,0,-1,4,4,5,3,688,385,910
142,0,0,1,1,0,0,0,1,1,0,0.0,0.0,1,1,0,-1,-1,-1,21,0,25,735,533
143,28,130,667,912,245,84,84,765,765,0,0.0007828721195411688,0.0009190237925048504,775,795,20,4,3,3,9,4,101,336,617
144,6,108,390,889,499,23,24,394,401,7,0.0,6.807583648184077e-05,1,441,440,4,4,4,13,1,185,265,337
145,8,109,516,920,404,12,12,472,472,0,0.00010211375472276115,0.00013615167296368154,477,513,36,5,4,4,4,2,711,491,334
146,8,8,533,533,0,14,14,543,543,0,3.4037918240920386e-05,3.4037918240920386e-05,401,401,0,-1,4,4,3,2,585,363,921
147,0,0,1,1,0,0,0,1,1,0,0.0,0.0,1,1,0,-1,-1,-1,3,1,621,235,898
148,52,52,815,815,0,80,80,803,803,0,0.0010211375472276116,0.0010211375472276116,808,808,0,-1,2,2,9,5,202,688,750
149,0,206,1,967,966,0,11,1,430,429,0.0,6.807583648184077e-05,1,446,445,3,-1,4,4,0,500,254,435
150,128,128,955,955,0,56,56,984,984,0,0.0061949011198475104,0.0061949011198475104,967,967,0,-1,2,2,2,23,948,117,740
151,0,616,1,995,994,0,68,1,837,836,0.0,0.010109261717553355,1,981,980,2,-1,3,7,0,264,834,11
152,100,100,898,898,0,100,100,958,958,0,0.02729841042921815,0.02729841042921815,996,996,0,-1,1,1,6,21,328,157,789
153,180,282,935,964,29,210,210,925,925,0,0.0023486163586235067,0.0025188059498281084,900,908,8,4,2,2,17,20,10,49,416
154,2,104,359,920,561,6,6,372,372,0,3.4037918240920386e-05,0.0002042275094455223,400,572,172,4,5,5,4,3,736,466,904
155,34,136,809,958,149,18,18,713,713,0,0.0010211375472276116,0.001055175465468532,814,819,5,4,4,4,3,9,674,414,506
156,2,104,355,883,528,15,16,379,387,8,6.807583648184077e-05,0.00013615167296368154,444,508,64,4,5,5,10,3,109,755,362
157,1,1,333,333,0,6,6,333,333,0,0.0,0.0,1,1,0,-1,6,6,6,1,560,140,583
158,18,120,583,898,315,58,58,566,566,0,0.00017018959120460194,0.0002382654276864427,541,584,43,4,3,3,12,3,175,434,687
159,16,16,650,650,0,24,24,675,675,0,0.0006126825283365669,0.0006126825283365669,737,737,0,-1,4,4,4,4,787,185,775
160,22,228,638,966,328,40,40,572,572,0,0.00017018959120460194,0.0005786446100956465,533,713,180,3,4,4,8,6,244,683,160
161,17,119,648,930,282,18,18,595,595,0,0.0004765308553728854,0.0004765308553728854,701,701,0,4,4,4,3,8,892,302,566
162,8,8,591,591,0,10,10,567,567,0,0.0002042275094455223,0.0002042275094455223,590,590,0,-1,4,4,3,2,922,251,271
163,8,8,510,510,0,11,11,432,432,0,6.807583648184077e-05,6.807583648184077e-05,440,440,0,-1,4,4,4,2,516,364,984
164,16,16,620,620,0,28,28,725,725,0,0.0002042275094455223,0.0002042275094455223,566,566,0,-1,3,3,3,2,687,493,546
165,16,222,506,944,438,88,96,555,580,25,6.807583648184077e-05,0.0007147962830593281,446,727,281,3,3,3,19,2,83,652,414
166,0,206,1,980,979,0,9,1,533,532,0.0,0.0008169100377820892,1,798,797,3,-1,4,3,0,984,867,203
167,10,10,501,501,0,36,36,488,488,0,0.00013615167296368154,0.00013615167296368154,514,514,0,-1,4,4,10,3,285,534,874
168,0,0,1,1,0,0,0,1,1,0,0.0,0.0,1,1,0,-1,-1,-1,7,0,472,798,517
169,429,531,987,992,5,104,104,981,981,0,0.0088498587426393,0.009054086252084823,982,982,0,4,2,2,5,69,479,12,80
170,18,18,614,614,0,68,68,768,768,0,0.0009530617107457708,0.0009530617107457708,790,790,0,-1,3,3,8,4,131,440,803
171,12,12,491,491,0,56,56,499,499,0,0.0002382654276864427,0.0002382654276864427,593,593,0,-1,4,4,16,4,195,270,614
172,0,102,1,935,934,0,4,1,410,409,0.0,0.00037441710065012424,1,655,654,4,-1,5,2,0,733,843,473
173,15,117,683,957,274,12,12,538,538,0,0.000442492937131965,0.0007828721195411688,692,774,82,4,4,4,4,8,754,386,310
174,0,206,1,940,939,0,50,1,453,452,0.0,0.000442492937131965,1,681,680,3,-1,4,19,0,48,907,236
175,6,212,396,949,553,46,54,473,500,27,0.0,0.0004765308553728854,1,692,691,3,4,4,15,1,40,607,268
176,13,13,669,669,0,12,12,670,670,0,0.0002723033459273631,0.0002723033459273631,618,618,0,-1,4,4,2,4,946,479,696
177,4,106,433,929,496,7,8,405,439,34,6.807583648184077e-05,0.00017018959120460194,454,549,95,4,5,5,4,4,461,442,958
178,16,222,588,962,374,25,38,480,559,79,0.0004765308553728854,0.00088498587426393,700,784,84,3,3,3,9,2,319,656,46
179,6,108,500,950,450,10,10,531,531,0,3.4037918240920386e-05,0.00017018959120460194,409,551,142,4,4,4,3,2,569,719,238
180,53,259,865,983,118,28,28,794,794,0,0.0016338200755641784,0.002144388849177984,864,897,33,3,3,3,3,13,791,335,438
181,0,102,1,974,973,0,4,1,507,506,0.0,0.005037611899656217,1,963,962,4,-1,5,2,0,944,760,70
182,71,71,927,927,0,22,22,892,892,0,0.002382654276864427,0.002382654276864427,916,916,0,-1,3,3,2,17,997,45,737
183,0,206,1,976,975,0,12,1,585,584,0.0,0.0013274788113958951,1,846,845,3,-1,4,2,0,934,701,109
184,17,118,723,963,240,8,8,546,546,0,0.0006807583648184077,0.0006807583648184077,763,763,0,5,4,4,2,6,965,467,602
185,0,102,1,927,926,0,6,1,359,358,0.0,3.4037918240920386e-05,1,404,403,4,-1,5,5,0,744,457,313
186,0,0,1,1,0,0,0,1,1,0,0.0,0.0,1,1,0,-1,-1,-1,7,0,697,937,940
187,28,644,660,990,330,88,108,717,783,66,0.0007147962830593281,0.010790020082371761,744,977,233,2,3,3,12,4,87,288,37
188,124,225,953,978,25,32,32,900,900,0,0.004561081044283332,0.004595118962524252,947,949,2,5,3,3,2,25,925,105,853
189,2,2,354,354,0,13,13,363,363,0,0.0,0.0,1,1,0,-1,5,5,11,1,215,763,919
190,0,206,1,965,964,0,24,1,570,569,0.0,0.0018040096667687805,1,879,878,3,-1,4,6,0,582,511,44
191,19,225,703,974,271,24,24,683,683,0,0.0005105687736138058,0.0020422750944552232,716,898,182,3,4,4,4,10,633,266,158
192,24,126,826,970,144,12,12,755,755,0,0.0011232513019503727,0.0014636304843595766,839,871,32,4,4,4,2,8,987,161,176
193,0,206,1,948,947,0,39,1,467,466,0.0,0.00030634126416828345,1,611,610,3,-1,4,14,0,172,433,267
194,22,22,696,696,0,34,34,786,786,0,0.000442492937131965,0.000442492937131965,697,697,0,-1,3,3,4,3,740,525,817
195,6,107,418,900,482,20,20,450,450,0,3.4037918240920386e-05,3.4037918240920386e-05,404,404,0,5,4,4,8,1,257,334,853
196,0,102,1,889,888,0,10,1,371,370,0.0,0.00017018959120460194,1,541,540,4,-1,5,7,0,447,643,487
197,0,0,1,1,0,0,0,1,1,0,0.0,0.0,1,1,0,-1,-1,-1,8,0,488,932,574
198,6,6,493,493,0,4,4,417,417,0,0.00010211375472276115,0.00010211375472276115,483,483,0,-1,5,5,2,3,999,301,538
199,42,42,813,813,0,70,70,907,907,0,0.001157289220191293,0.001157289220191293,836,836,0,-1,3,3,5,6,665,289,538
200,4,4,436,436,0,10,10,434,434,0,0.00013615167296368154,0.00013615167296368154,531,531,0,-1,5,5,5,2,795,749,796
201,2,208,363,967,604,5,10,375,439,64,0.0,0.0002042275094455223,1,563,562,3,5,4,3,1,634,593,688
202,50,50,800,800,0,66,66,723,723,0,0.0005446066918547262,0.0005446066918547262,724,724,0,-1,3,3,9,6,803,46,758
203,0,206,1,964,963,0,26,1,512,511,0.0,0.0011232513019503727,1,822,821,3,-1,4,7,0,273,921,122
204,32,32,812,812,0,10,10,529,529,0,0.0006807583648184077,0.0006807583648184077,767,767,0,-1,4,4,3,8,871,250,890
205,0,206,1,968,967,0,11,1,433,432,0.0,0.00034037918240920387,1,657,656,3,-1,4,4,0,694,975,286
206,30,30,683,683,0,62,62,619,619,0,0.0005786446100956465,0.0005786446100956465,707,707,0,-1,4,4,11,6,162,46,903
207,0,0,1,1,0,0,0,1,1,0,0.0,0.0,1,1,0,-1,-1,-1,3,0,707,890,539
208,211,313,948,975,27,124,124,909,909,0,0.002927260968719153,0.002927260968719153,922,922,0,4,3,3,9,24,101,119,506
209,30,132,789,949,160,26,26,782,782,0,0.0006126825283365669,0.001055175465468532,744,819,75,4,3,3,4,6,679,136,275
210,79,79,932,932,0,22,22,875,875,0,0.002314578440382586,0.002314578440382586,909,909,0,-1,3,3,2,26,868,127,685
211,41,41,797,797,0,32,32,638,638,0,0.0008169100377820892,0.0008169100377820892,777,777,0,-1,4,4,6,17,515,131,920
212,0,206,1,949,948,0,36,1,421,420,0.0,0.0002723033459273631,1,611,610,3,-1,4,16,0,26,522,4
213,0,206,1,956,955,0,28,1,535,534,0.0,0.0010211375472276116,1,806,805,3,-1,4,6,0,157,796,297
214,12,114,580,928,348,12,12,467,467,0,6.807583648184077e-05,0.00013615167296368154,457,521,64,4,4,4,4,2,690,576,165
215,0,206,1,960,959,0,28,1,531,530,0.0,0.0015657442390823377,1,857,856,3,-1,4,8,3,521,753,151
216,0,102,1,939,938,0,3,1,371,370,0.0,3.4037918240920386e-05,1,398,397,4,-1,5,2,0,734,669,531
217,0,206,1,947,946,0,28,1,480,479,0.0,0.00030634126416828345,1,617,616,3,-1,4,8,0,411,970,439
218,0,0,1,1,0,0,0,1,1,0,0.0,0.0,1,1,0,-1,-1,-1,13,1,115,706,707
219,0,0,1,1,0,0,0,1,1,0,0.0,0.0,1,1,0,-1,-1,-1,4,0,493,793,913
220,0,616,1,991,990,0,55,1,531,530,0.0,0.0009870996289866913,1,798,797,2,-1,3,15,0,95,522,559
221,44,1684,699,1000,301,154,192,706,785,79,0.0005446066918547262,0.005037611899656217,697,951,254,1,3,2,24,4,28,167,494
222,0,102,1,959,958,0,5,1,438,437,0.0,0.0011232513019503727,1,833,832,4,-1,5,3,0,852,900,106
223,18,18,669,669,0,24,24,566,566,0,0.00037441710065012424,0.00037441710065012424,678,678,0,-1,4,4,6,5,657,362,886
224,2,2,358,358,0,14,14,405,405,0,3.4037918240920386e-05,3.4037918240920386e-05,403,403,0,-1,5,5,7,1,678,449,358
225,62,163,856,955,99,50,50,851,851,0,0.0016338200755641784,0.0016678579938050988,859,862,3,5,3,3,5,10,662,227,861
226,0,616,1,991,990,0,66,1,677,676,0.0,0.002212464685659825,1,893,892,2,-1,3,10,0,310,790,69
227,254,254,971,971,0,144,144,968,968,0,0.00527587732734266,0.00527587732734266,959,959,0,-1,3,3,9,35,319,57,751
228,1,207,332,978,646,3,10,332,530,198,0.0,0.002552843868069029,1,913,912,3,6,4,3,2,600,656,28
229,7,213,488,954,466,56,56,655,655,0,0.0006126825283365669,0.001497668402600497,724,840,116,3,4,4,10,3,169,299,243
230,28,130,756,945,189,19,19,535,535,0,0.0004765308553728854,0.0006126825283365669,709,742,33,4,4,4,6,8,486,250,168
231,2,2,351,351,0,12,12,380,380,0,0.0,0.0,1,1,0,-1,5,5,8,2,541,597,657
232,0,206,1,949,948,0,19,1,422,421,0.0,6.807583648184077e-05,1,441,440,3,-1,4,9,0,202,372,251
233,0,206,1,972,971,0,14,1,483,482,0.0,0.0010892133837094523,1,819,818,3,-1,4,5,0,430,702,64
234,6,212,483,977,494,8,8,505,505,0,6.807583648184077e-05,0.0002723033459273631,452,626,174,3,4,4,2,1,896,689,541
235,0,101,1,882,881,0,13,1,332,331,0.0,3.4037918240920386e-05,1,403,402,5,-1,6,13,0,160,817,748
236,6,107,440,923,483,24,24,646,646,0,6.807583648184077e-05,6.807583648184077e-05,457,457,0,6,4,4,4,1,690,609,861
237,6,108,470,935,465,16,16,588,588,0,6.807583648184077e-05,6.807583648184077e-05,456,456,0,4,4,4,4,1,679,659,384
238,16,118,679,945,266,24,24,785,785,0,0.0002382654276864427,0.0006467204465774873,622,763,141,4,3,3,3,1,530,474,303
239,0,206,1,935,934,0,33,1,384,383,0.0,0.00013615167296368154,1,515,514,3,-1,4,19,0,31,980,527
240,221,427,950,981,31,190,190,922,922,0,0.004493005207801491,0.0046972327172470135,950,950,0,3,2,2,16,29,72,142,283
241,22,228,688,973,285,40,40,733,733,0,0.00037441710065012424,0.0015317063208414173,664,859,195,3,3,3,5,3,392,610,128
242,122,223,939,973,34,50,50,911,911,0,0.002280540522141666,0.002280540522141666,900,900,0,5,3,3,4,20,631,109,606
243,183,389,959,986,27,80,80,916,916,0,0.004901460226692535,0.00704584907587052,962,971,9,3,2,2,6,37,624,74,15
244,72,173,876,964,88,40,40,778,778,0,0.0010892133837094523,0.0010892133837094523,813,813,0,5,3,3,5,17,421,269,449
245,363,569,995,999,4,32,32,945,945,0,0.013479015623404473,0.0156914803090643,993,995,2,3,3,3,2,98,942,23,133
246,5,211,478,978,500,4,8,420,512,92,6.807583648184077e-05,0.0005786446100956465,459,742,283,3,5,4,2,3,757,347,219
247,12,218,558,969,411,24,24,610,610,0,0.0005786446100956465,0.0011232513019503727,732,830,98,3,4,4,4,2,500,475,177
248,100,100,864,864,0,100,100,720,720,0,0.03100854351747847,0.03274447734776541,1000,1000,0,2,1,1,13,127,41,11,81
249,6,212,461,976,515,16,16,566,566,0,0.00010211375472276115,0.0004084550188910446,476,677,201,3,4,4,4,1,563,661,29
250,0,616,1,989,988,0,81,1,489,488,0.0,0.0007828721195411688,1,751,750,2,-1,3,24,0,28,998,293
251,6,212,432,967,535,12,16,450,510,60,0.00013615167296368154,0.00037441710065012424,507,647,140,3,4,4,4,1,887,762,661
252,6,6,489,489,0,10,10,528,528,0,0.00034037918240920387,0.00034037918240920387,645,645,0,-1,4,4,3,1,693,869,943
253,28,130,749,937,188,36,36,743,743,0,0.00010211375472276115,0.0002382654276864427,493,586,93,4,3,3,5,6,552,199,562
254,18,119,725,955,230,12,12,666,666,0,0.00037441710065012424,0.00037441710065012424,671,671,0,5,4,4,2,8,548,345,581
255,20,122,631,917,286,60,60,731,731,0,0.0005446066918547262,0.0007488342013002485,716,755,39,4,3,3,8,3,231,236,378
256,16,222,620,972,352,50,50,815,815,0,0.0011232513019503727,0.0013955546478777359,814,843,29,3,3,3,5,2,407,160,454
257,0,0,1,1,0,0,0,1,1,0,0.0,0.0,1,1,0,-1,-1,-1,7,0,398,808,511
258,2,104,372,955,583,3,3,374,374,0,6.807583648184077e-05,0.0002382654276864427,465,616,151,4,5,5,2,1,806,807,132
259,0,102,1,916,915,0,8,1,414,413,0.0,0.0005105687736138058,1,717,716,4,-1,5,4,0,558,929,154
260,106,312,904,973,69,88,88,881,881,0,0.0024507301133462676,0.0032336022328874367,901,924,23,3,3,3,8,17,308,180,377
261,0,102,1,895,894,0,13,1,389,388,0.0,6.807583648184077e-05,1,449,448,4,-1,5,8,0,297,876,350
262,0,0,1,1,0,0,0,1,1,0,0.0,0.0,1,1,0,-1,-1,-1,7,1,329,529,817
263,235,336,988,993,5,38,38,923,923,0,0.009292351679771264,0.009326389598012186,983,983,0,5,3,3,3,75,707,24,313
264,85,85,882,882,0,36,36,720,720,0,0.0011913271384322134,0.0011913271384322134,832,832,0,-1,3,3,5,18,487,147,735
265,0,101,1,936,935,0,2,1,332,331,0.0,0.0,1,1,0,5,-1,6,2,2,689,709,506
266,12,113,602,934,332,18,18,623,623,0,6.807583648184077e-05,6.807583648184077e-05,446,446,0,6,4,4,3,2,900,468,621
267,0,206,1,963,962,0,14,1,436,435,0.0,0.0002042275094455223,1,559,558,3,-1,4,5,0,818,851,667
268,26,26,735,735,0,30,30,734,734,0,0.00017018959120460194,0.00017018959120460194,543,543,0,-1,3,3,4,4,401,167,825
269,46,46,767,767,0,98,98,734,734,0,0.0009530617107457708,0.0009530617107457708,792,792,0,-1,2,2,13,2,67,770,641
270,12,12,548,548,0,42,42,639,639,0,0.00030634126416828345,0.00030634126416828345,618,618,0,-1,4,4,7,2,340,827,729
271,0,0,1,1,0,0,0,1,1,0,0.0,0.0,1,1,0,-1,-1,-1,3,0,778,624,436
272,3,3,468,468,0,5,5,439,439,0,6.807583648184077e-05,6.807583648184077e-05,455,455,0,-1,5,5,3,3,852,631,947
273,106,1746,882,1000,118,122,166,861,934,73,0.0017018959120460194,0.020150447598624867,860,995,135,1,3,2,12,14,96,84,3
274,6,212,433,968,535,22,26,569,638,69,0.00017018959120460194,0.0029612988869600733,540,924,384,3,4,4,5,2,284,652,28
275,4,4,442,442,0,7,7,406,406,0,0.0,0.0,1,1,0,-1,5,5,4,4,611,442,777
276,22,228,667,969,302,26,26,574,574,0,0.000442492937131965,0.0005786446100956465,689,730,41,3,4,4,5,6,555,376,263
277,0,0,1,1,0,0,0,1,1,0,0.0,0.0,1,1,0,-1,-1,-1,4,0,462,723,975
278,0,0,1,1,0,0,0,1,1,0,0.0,0.0,1,1,0,-1,-1,-1,3,0,530,793,881
279,8,110,482,888,406,56,56,560,560,0,0.00017018959120460194,0.00037441710065012424,557,647,90,4,4,4,12,2,44,323,688
280,104,104,897,897,0,84,84,809,809,0,0.0018380475850097008,0.0018380475850097008,872,872,0,-1,3,3,9,17,803,45,865
281,6,212,404,960,556,16,25,413,490,77,0.0,6.807583648184077e-05,1,450,449,3,4,4,7,1,374,687,233
282,8,214,486,953,467,26,50,413,519,106,0.00017018959120460194,0.0011913271384322134,533,818,285,3,4,4,13,2,160,547,60
283,17,617,715,1000,285,18,18,808,808,0,0.0004765308553728854,0.007556417849484326,708,973,265,2,3,3,2,2,895,101,30
284,0,102,1,937,936,0,4,1,400,399,0.0,0.0002382654276864427,1,595,594,4,-1,5,2,0,689,901,308
285,16,222,669,976,307,24,28,787,805,18,0.0002382654276864427,0.0007147962830593281,597,758,161,3,3,3,3,1,670,609,451
286,155,155,917,917,0,158,158,875,875,0,0.0022465026039007454,0.0022465026039007454,901,901,0,-1,2,2,14,22,122,116,446
287,41,41,810,810,0,48,48,913,913,0,0.0020763130126961434,0.0020763130126961434,891,891,0,-1,2,2,3,4,778,305,897
288,0,0,1,1,0,0,0,1,1,0,0.0,0.0,1,1,0,-1,-1,-1,3,1,835,787,633
289,24,125,704,933,229,30,30,663,663,0,0.0002042275094455223,0.0002042275094455223,575,575,0,9,4,4,5,4,677,259,647
290,0,0,1,1,0,0,0,1,1,0,0.0,0.0,1,1,0,-1,-1,-1,7,1,658,472,848
291,201,303,950,979,29,160,160,954,954,0,0.003914360597705844,0.004016474352428605,943,947,4,4,3,3,10,24,204,13,720
292,39,39,804,804,0,24,24,639,639,0,0.0004765308553728854,0.0004765308553728854,708,708,0,-1,4,4,4,13,558,120,821
293,0,206,1,990,989,0,7,1,599,598,0.0,0.0018720855032506212,1,899,898,3,-1,4,2,2,959,684,166
294,0,102,1,915,914,0,8,1,422,421,0.0,0.0002723033459273631,1,619,618,4,-1,5,4,0,784,860,591
295,725,827,998,998,0,88,88,975,975,0,0.016406276592123625,0.016406276592123625,991,991,0,4,2,2,4,127,858,11,618
296,0,101,1,914,913,0,5,1,332,331,0.0,0.0,1,1,0,5,-1,6,5,0,531,538,739
297,0,101,1,956,955,0,3,1,331,330,0.0,6.807583648184077e-05,1,458,457,5,-1,6,3,0,922,426,408
298,92,298,890,977,87,72,72,853,853,0,0.0017359338302869397,0.002825147213996392,873,919,46,3,3,3,7,14,510,84,128
299,6,108,449,918,469,22,22,582,582,0,0.0002723033459273631,0.0004765308553728854,616,707,91,4,4,4,5,1,412,840,370
300,0,102,1,875,874,0,24,1,389,388,0.0,0.00013615167296368154,1,515,514,4,-1,5,15,0,102,686,741
301,6,107,438,920,482,11,11,448,448,0,3.4037918240920386e-05,6.807583648184077e-05,401,443,42,5,4,4,4,1,444,558,537
302,1,103,332,966,634,2,4,332,443,111,6.807583648184077e-05,0.00013615167296368154,447,515,68,4,6,5,2,3,968,708,553
303,0,102,1,898,897,0,8,1,355,354,0.0,6.807583648184077e-05,1,443,442,4,-1,5,7,0,216,850,484
304,224,430,969,990,21,104,104,993,993,0,0.007386228258279724,0.008373327887266415,971,975,4,3,2,2,5,31,667,34,96
305,1,207,332,975,643,2,12,332,601,269,0.0,0.0004084550188910446,1,670,669,3,6,4,2,2,954,663,609
306,175,175,958,958,0,44,44,867,867,0,0.004969536063174376,0.004969536063174376,957,957,0,-1,3,3,4,29,401,17,887
307,0,102,1,911,910,0,7,1,373,372,0.0,0.00017018959120460194,1,543,542,4,-1,5,5,0,396,651,688
308,16,16,469,469,0,56,56,380,380,0,6.807583648184077e-05,6.807583648184077e-05,442,442,0,-1,3,3,36,2,16,721,478
309,8,110,506,915,409,11,11,436,436,0,0.00010211375472276115,0.00013615167296368154,486,512,26,4,4,4,4,5,391,401,720
310,2,208,379,980,601,3,8,384,539,155,0.0,0.0020763130126961434,1,901,900,3,5,4,2,1,469,503,55
311,95,301,901,981,80,74,74,941,941,0,0.0033016780693692774,0.0040845501889104465,934,951,17,3,2,2,5,14,311,84,340
312,0,616,1,993,992,0,34,1,549,548,0.0,0.0016678579938050988,1,864,863,2,-1,3,8,0,197,824,237
313,0,206,1,957,956,0,24,1,475,474,0.0,0.000442492937131965,1,691,690,3,-1,4,8,0,301,672,185
314,0,0,1,1,0,0,0,1,1,0,0.0,0.0,1,1,0,-1,-1,-1,8,1,646,962,911
315,2,208,350,947,597,23,29,390,408,18,0.00010211375472276115,0.00030634126416828345,471,606,135,3,5,4,14,1,268,899,550
316,2,208,348,939,591,22,45,369,458,89,0.0,0.00034037918240920387,1,634,633,3,5,4,17,1,80,402,417
317,0,101,1,887,886,0,9,1,330,329,0.0,0.0,1,1,0,9,-1,10,9,0,200,546,647
318,2,104,355,901,546,9,9,395,395,0,0.00013615167296368154,0.0002382654276864427,512,591,79,4,5,5,5,3,571,755,110
319,0,102,1,886,885,0,18,1,387,386,0.0,0.00017018959120460194,1,532,531,4,-1,5,11,1,230,583,199
320,0,101,1,960,959,0,2,1,331,330,0.0,0.0,1,1,0,6,-1,7,2,3,847,746,402
321,6,107,439,923,484,14,14,475,475,0,0.00010211375472276115,0.00010211375472276115,479,479,0,5,4,4,5,2,386,215,618
322,12,218,576,973,397,22,26,574,632,58,0.00017018959120460194,0.0010211375472276116,540,813,273,3,4,4,5,2,524,251,395
323,10,112,607,950,343,8,8,510,510,0,0.00013615167296368154,0.0002042275094455223,529,586,57,4,4,4,2,4,964,230,710
324,0,0,1,1,0,0,0,1,1,0,0.0,0.0,1,1,0,-1,-1,-1,10,0,189,844,271
325,0,102,1,893,892,0,7,1,349,348,0.0,0.0,1,1,0,4,-1,5,6,0,514,937,512
326,4,620,442,998,556,6,20,413,746,333,0.00013615167296368154,0.002995336805200994,516,919,403,2,5,3,3,2,935,430,8
327,42,658,759,993,234,58,72,624,701,77,0.0004084550188910446,0.003199564314646516,671,931,260,2,3,3,10,6,128,432,153
328,308,308,969,969,0,206,206,957,957,0,0.004595118962524252,0.004595118962524252,949,949,0,-1,2,2,13,30,41,75,737
329,6,6,422,422,0,21,21,484,484,0,3.4037918240920386e-05,3.4037918240920386e-05,399,399,0,-1,4,4,7,1,361,394,923
330,46,252,799,972,173,102,102,917,917,0,0.0009190237925048504,0.0012594029749140542,784,825,41,3,2,2,8,3,199,525,160
331,228,228,969,969,0,44,44,818,818,0,0.00439089145307873,0.00439089145307873,947,947,0,-1,3,3,4,45,516,77,838
332,0,101,1,912,911,0,5,1,332,331,0.0,3.4037918240920386e-05,1,395,394,5,-1,6,5,0,247,817,460
333,45,146,758,916,158,96,96,698,698,0,0.0007828721195411688,0.0008169100377820892,762,768,6,5,3,3,14,6,21,467,292
334,0,616,1,992,991,0,102,1,605,604,0.0,0.002280540522141666,1,891,890,2,-1,3,21,0,12,786,42
335,6,212,416,954,538,38,42,522,547,25,0.00017018959120460194,0.00034037918240920387,532,651,119,3,4,4,11,1,174,666,406
336,18,120,679,943,264,22,22,594,594,0,0.00034037918240920387,0.000442492937131965,656,692,36,4,4,4,5,4,848,637,891
337,0,101,1,927,926,0,3,1,332,331,0.0,3.4037918240920386e-05,1,405,404,5,-1,6,3,0,627,815,526
338,2,208,365,970,605,6,11,333,424,91,0.0,0.0004084550188910446,1,678,677,3,6,4,6,5,494,605,763
339,0,206,1,951,950,0,28,1,454,453,0.0,0.0002382654276864427,1,586,585,3,-1,4,11,0,333,986,510
340,27,27,835,835,0,22,22,890,890,0,0.0009190237925048504,0.0009190237925048504,806,806,0,-1,3,3,2,5,847,216,971
341,0,0,1,1,0,0,0,1,1,0,0.0,0.0,1,1,0,-1,-1,-1,2,0,868,943,738
342,0,0,1,1,0,0,0,1,1,0,0.0,0.0,1,1,0,-1,-1,-1,3,2,774,462,959
343,8,109,530,927,397,30,30,645,645,0,0.00013615167296368154,0.00013615167296368154,526,526,0,6,4,4,5,2,294,323,469
344,6,6,382,382,0,48,48,465,465,0,3.4037918240920386e-05,3.4037918240920386e-05,405,405,0,-1,4,4,16,2,117,648,747
345,18,120,634,925,291,16,16,492,492,0,0.00010211375472276115,0.0002042275094455223,481,559,78,4,4,4,4,5,540,636,680
346,0,102,1,911,910,0,7,1,371,370,0.0,3.4037918240920386e-05,1,399,398,4,-1,5,5,0,528,844,420
347,32,134,722,922,200,48,48,674,674,0,0.0005105687736138058,0.0005105687736138058,708,708,0,4,3,3,7,7,436,253,566
348,0,102,1,876,875,0,15,1,349,348,0.0,0.0,1,1,0,4,-1,5,14,0,133,744,743
349,7,213,518,965,447,15,15,451,451,0,0.0,0.00017018959120460194,1,542,541,3,4,4,6,5,455,225,494
350,24,24,731,731,0,22,22,593,593,0,0.0004765308553728854,0.0004765308553728854,687,687,0,-1,4,4,5,7,601,389,902
351,16,632,585,996,411,42,80,615,841,226,0.00037441710065012424,0.003199564314646516,661,937,276,2,3,3,8,1,297,527,68
352,0,616,1,995,994,0,40,1,716,715,0.0,0.003880322679464924,1,943,942,2,-1,3,5,0,347,968,41
353,22,228,707,977,270,26,26,643,643,0,0.0004765308553728854,0.0008509479560230097,698,781,83,3,4,4,5,6,720,376,420
354,0,101,1,921,920,0,3,1,331,330,0.0,0.0,1,1,0,5,-1,6,3,0,927,546,618
355,0,102,1,907,906,0,7,1,379,378,0.0,0.0002042275094455223,1,569,568,4,-1,5,5,1,412,806,785
356,0,616,1,990,989,0,112,1,740,739,0.0,0.005820484019197386,1,961,960,2,-1,3,15,0,65,632,18
357,0,0,1,1,0,0,0,1,1,0,0.0,0.0,1,1,0,-1,-1,-1,3,0,892,826,701
358,67,67,843,843,0,106,106,918,918,0,0.0018380475850097008,0.0018380475850097008,873,873,0,-1,2,2,7,8,331,497,709
359,0,0,1,1,0,0,0,1,1,0,0.0,0.0,1,1,0,-1,-1,-1,3,0,785,922,533
360,0,0,1,1,0,0,0,1,1,0,0.0,0.0,1,1,0,-1,-1,-1,4,1,650,949,641
361,0,101,1,945,944,0,2,1,328,327,0.0,0.0,1,1,0,5,-1,6,2,0,998,952,690
362,48,150,765,921,156,88,88,733,733,0,0.0006807583648184077,0.0006807583648184077,739,739,0,4,3,3,12,9,292,154,321
363,90,90,941,941,0,22,22,875,875,0,0.004833384390210695,0.004833384390210695,958,958,0,-1,3,3,2,26,868,108,664
364,1,207,333,954,621,10,44,333,548,215,0.0,0.0013274788113958951,1,828,827,3,9,4,10,1,75,647,36
365,18,119,653,933,280,14,14,536,536,0,0.0002723033459273631,0.0002723033459273631,607,607,0,6,4,4,3,5,645,636,721
366,64,64,824,824,0,100,100,828,828,0,0.0013274788113958951,0.0013274788113958951,832,832,0,-1,3,3,10,8,125,352,779
367,16,16,550,550,0,90,90,682,682,0,0.00013615167296368154,0.00013615167296368154,509,509,0,-1,3,3,14,1,172,553,812
368,0,102,1,911,910,0,9,1,412,411,0.0,0.0005446066918547262,1,716,715,4,-1,5,5,0,667,707,390
369,11,113,639,952,313,12,12,648,648,0,0.0006126825283365669,0.0009190237925048504,750,804,54,4,4,4,2,5,910,412,613
370,66,66,822,822,0,114,114,798,798,0,0.0013274788113958951,0.0013274788113958951,834,834,0,-1,3,3,13,9,67,130,874
371,58,58,787,787,0,126,126,768,768,0,0.0011913271384322134,0.0011913271384322134,814,814,0,-1,2,2,17,4,80,504,705
372,0,0,1,1,0,0,0,1,1,0,0.0,0.0,1,1,0,-1,-1,-1,5,0,793,772,428
373,113,113,897,897,0,114,114,938,938,0,0.002212464685659825,0.002212464685659825,892,892,0,-1,3,3,9,19,166,144,928
374,41,247,758,962,204,54,54,612,612,0,0.0008169100377820892,0.0009870996289866913,777,802,25,3,3,3,10,9,75,240,722
375,38,38,767,767,0,46,46,770,770,0,0.0006467204465774873,0.0006467204465774873,742,742,0,-1,3,3,5,5,349,306,872
376,0,0,1,1,0,0,0,1,1,0,0.0,0.0,1,1,0,-1,-1,-1,6,0,764,967,883
377,87,87,924,924,0,46,46,970,970,0,0.006467204465774873,0.006467204465774873,968,968,0,-1,2,2,2,13,894,42,790
378,2,2,379,379,0,4,4,383,383,0,0.0,0.0,1,1,0,-1,5,5,3,1,911,763,705
379,6,6,375,375,0,88,88,520,520,0,0.0002382654276864427,0.0002382654276864427,577,577,0,-1,4,4,22,1,33,869,997
380,1,1,332,332,0,2,2,332,332,0,3.4037918240920386e-05,3.4037918240920386e-05,401,401,0,-1,6,6,2,1,750,437,754
381,89,190,880,960,80,84,84,886,886,0,0.0022465026039007454,0.002280540522141666,894,894,0,5,3,3,8,15,323,36,572
382,6,212,415,961,546,13,17,400,443,43,0.00010211375472276115,0.0008169100377820892,484,771,287,3,4,4,7,1,170,736,184
383,12,218,521,955,434,50,50,611,611,0,0.0004084550188910446,0.001055175465468532,665,814,149,3,4,4,9,3,269,795,242
384,0,102,1,929,928,0,4,1,361,360,0.0,0.00013615167296368154,1,527,526,4,-1,5,3,0,801,906,504
385,0,0,1,1,0,0,0,1,1,0,0.0,0.0,1,1,0,-1,-1,-1,2,0,906,498,883
386,2,104,379,944,565,5,5,409,409,0,3.4037918240920386e-05,0.00017018959120460194,403,557,154,4,5,5,3,1,840,421,404
387,0,616,1,989,988,0,152,1,764,763,0.0,0.0033357159876101976,1,929,928,2,-1,3,20,0,70,768,26
388,28,129,787,954,167,22,22,792,792,0,0.0012594029749140542,0.0012594029749140542,841,841,0,6,3,3,2,8,894,174,484
389,17,17,616,616,0,50,50,673,673,0,0.00034037918240920387,0.00034037918240920387,645,645,0,-1,3,3,8,3,350,354,573
390,0,0,1,1,0,0,0,1,1,0,0.0,0.0,1,1,0,-1,-1,-1,13,0,165,695,985
391,32,32,665,665,0,202,202,912,912,0,0.0014636304843595766,0.0014636304843595766,846,846,0,-1,3,3,17,4,80,440,715
392,0,206,1,965,964,0,32,1,627,626,0.0,0.004016474352428605,1,947,946,3,-1,4,6,0,441,754,21
393,12,12,534,534,0,40,40,572,572,0,0.00013615167296368154,0.00013615167296368154,512,512,0,-1,4,4,10,4,527,239,200
394,94,710,870,994,124,108,108,913,913,0,0.0025188059498281084,0.010109261717553355,916,980,64,2,3,3,8,15,357,36,32
395,12,218,549,962,413,16,32,443,599,156,0.00013615167296368154,0.0009530617107457708,522,793,271,3,4,4,6,4,255,315,438
396,2,103,386,959,573,4,4,446,446,0,6.807583648184077e-05,6.807583648184077e-05,458,458,0,5,5,5,2,3,666,260,799
397,14,14,567,567,0,32,32,548,548,0,0.0002042275094455223,0.0002042275094455223,564,564,0,-1,4,4,8,4,508,230,816
398,6,107,444,927,483,18,18,534,534,0,0.0002042275094455223,0.0002042275094455223,566,566,0,5,4,4,5,2,565,805,398
399,95,196,923,974,51,44,44,881,881,0,0.002382654276864427,0.0024507301133462676,902,905,3,5,3,3,4,18,721,141,449
400,10,112,628,955,327,10,10,544,544,0,0.00013615167296368154,0.0002042275094455223,518,589,71,4,4,4,3,4,608,202,384
401,0,102,1,945,944,0,5,1,422,421,0.0,6.807583648184077e-05,1,462,461,4,-1,5,3,1,790,962,659
402,154,360,907,974,67,168,168,892,892,0,0.002144388849177984,0.0022465026039007454,893,896,3,3,2,2,14,18,203,64,270
403,16,117,672,942,270,22,22,760,760,0,0.0007147962830593281,0.0007828721195411688,767,780,13,5,3,3,2,2,589,160,534
404,0,101,1,922,921,0,3,1,332,331,0.0,0.0,1,1,0,5,-1,6,3,0,621,538,597
405,240,240,975,975,0,94,94,973,973,0,0.00527587732734266,0.00527587732734266,955,955,0,-1,2,2,5,45,386,77,986
406,0,0,1,1,0,0,0,1,1,0,0.0,0.0,1,1,0,-1,-1,-1,6,1,251,738,423
407,49,49,788,788,0,58,58,695,695,0,0.0005446066918547262,0.0005446066918547262,713,713,0,-1,3,3,8,8,411,177,990
408,60,266,813,970,157,68,72,715,734,19,0.0008509479560230097,0.002484768031587188,778,899,121,3,3,3,10,11,272,162,65
409,0,0,1,1,0,0,0,1,1,0,0.0,0.0,1,1,0,-1,-1,-1,3,0,471,358,455
410,0,0,1,1,0,0,0,1,1,0,0.0,0.0,1,1,0,-1,-1,-1,4,2,458,709,993
411,1,1,333,333,0,4,4,333,333,0,0.0,0.0,1,1,0,-1,6,6,4,1,610,640,801
412,51,257,838,975,137,40,40,790,790,0,0.0016678579938050988,0.002757071377514551,869,918,49,3,3,3,5,17,533,269,250
413,0,102,1,894,893,0,12,1,381,380,0.0,3.4037918240920386e-05,1,402,401,4,-1,5,8,0,365,813,718
414,75,75,858,858,0,90,90,867,867,0,0.00176997174852786,0.00176997174852786,876,876,0,-1,3,3,9,16,389,113,800
415,6,6,484,484,0,10,10,510,510,0,0.00013615167296368154,0.00013615167296368154,526,526,0,-1,4,4,3,1,433,527,533
416,24,126,656,908,252,46,46,589,589,0,0.0004084550188910446,0.0004084550188910446,674,674,0,4,4,4,9,6,277,275,618
417,24,126,710,937,227,22,22,574,574,0,0.00037441710065012424,0.0004084550188910446,666,679,13,4,4,4,5,7,552,396,570
418,14,630,587,997,410,14,40,476,766,290,0.0002723033459273631,0.005173763572619898,621,960,339,2,4,3,5,5,438,314,9
419,80,286,789,959,170,228,228,706,706,0,0.0008169100377820892,0.0009870996289866913,759,798,39,3,3,3,33,10,9,413,260
420,23,124,734,949,215,30,30,784,784,0,0.0009870996289866913,0.0010211375472276116,813,817,4,5,3,3,4,4,491,332,552
421,7,7,507,507,0,14,14,499,499,0,0.0002723033459273631,0.0002723033459273631,604,604,0,-1,4,4,3,2,778,101,948
422,0,101,1,921,920,0,4,1,331,330,0.0,0.0,1,1,0,6,-1,7,4,0,787,760,663
423,0,616,1,996,995,0,38,1,686,685,0.0,0.002110350930937064,1,892,891,2,-1,3,6,0,281,778,81
424,2,2,369,369,0,6,6,420,420,0,0.0,0.0,1,1,0,-1,5,5,3,2,923,419,816
425,25,126,754,947,193,12,12,597,597,0,0.0007488342013002485,0.0007488342013002485,776,776,0,5,4,4,2,8,972,161,602
426,17,118,633,924,291,46,46,737,737,0,0.0002382654276864427,0.0002723033459273631,598,613,15,5,3,3,6,3,549,541,687
427,27,233,735,969,234,32,32,661,661,0,0.0005105687736138058,0.0008169100377820892,705,784,79,3,4,4,6,8,582,90,268
428,0,102,1,939,938,0,6,1,438,437,0.0,0.00013615167296368154,1,521,520,4,-1,5,3,1,708,685,551
429,7,108,542,942,400,8,8,489,489,0,6.807583648184077e-05,0.00010211375472276115,451,483,32,5,4,4,2,2,596,627,385
430,23,229,667,963,296,62,62,762,762,0,0.00017018959120460194,0.0005786446100956465,544,732,188,3,3,3,7,4,372,339,366
431,12,12,559,559,0,16,16,493,493,0,0.00010211375472276115,0.00010211375472276115,487,487,0,-1,4,4,4,3,638,361,858
432,0,0,1,1,0,0,0,1,1,0,0.0,0.0,1,1,0,-1,-1,-1,2,0,951,657,836
433,7,109,538,942,404,6,6,449,449,0,0.00037441710065012424,0.0004765308553728854,668,708,40,4,5,5,3,5,770,487,156
434,0,0,1,1,0,0,0,1,1,0,0.0,0.0,1,1,0,-1,-1,-1,10,0,149,922,750
435,0,206,1,953,952,0,15,1,394,393,0.0,0.00010211375472276115,1,487,486,3,-1,4,8,0,357,546,410
436,0,0,1,1,0,0,0,1,1,0,0.0,0.0,1,1,0,-1,-1,-1,3,0,869,940,750
437,0,0,1,1,0,0,0,1,1,0,0.0,0.0,1,1,0,-1,-1,-1,7,0,497,489,830
438,10,111,595,942,347,10,10,508,508,0,0.0004084550188910446,0.0004084550188910446,679,679,0,6,4,4,3,4,615,230,734
439,25,1665,729,1000,271,24,58,612,913,301,0.0005786446100956465,0.024507301133462677,732,996,264,1,4,2,4,5,235,216,74
440,125,125,947,947,0,50,50,901,901,0,0.0031314884781646754,0.0031314884781646754,933,933,0,-1,3,3,5,30,727,39,702
441,57,158,833,943,110,72,72,853,853,0,0.0013615167296368155,0.0013615167296368155,840,840,0,5,3,3,7,14,336,175,495
442,16,222,628,972,344,22,26,642,717,75,0.0002042275094455223,0.0026209197045508697,572,912,340,3,3,3,4,2,736,384,135
443,0,206,1,957,956,0,11,1,412,411,0.0,0.0002723033459273631,1,608,607,3,-1,4,5,0,496,668,799
444,0,616,1,996,995,0,26,1,692,691,0.0,0.0028932230504782326,1,922,921,2,-1,3,4,0,632,776,13
445,11,11,559,559,0,24,24,567,567,0,0.00030634126416828345,0.00030634126416828345,626,626,0,-1,4,4,6,5,446,454,966
446,40,246,735,963,228,56,75,613,739,126,0.0014636304843595766,0.0022465026039007454,841,893,52,3,2,2,11,3,271,466,242
447,0,0,1,1,0,0,0,1,1,0,0.0,0.0,1,1,0,-1,-1,-1,2,0,705,821,845
448,701,803,996,997,1,256,256,998,998,0,0.013547091459886314,0.013615167296368155,982,982,0,4,2,2,10,83,161,10,652
449,31,647,628,993,365,98,126,492,574,82,3.4037918240920386e-05,0.0014636304843595766,396,842,446,2,3,3,30,5,7,274,396
450,2,208,369,974,605,6,14,370,486,116,3.4037918240920386e-05,0.0008509479560230097,408,790,382,3,5,4,5,1,570,924,174
451,0,102,1,940,939,0,3,1,377,376,0.0,3.4037918240920386e-05,1,402,401,4,-1,5,2,0,894,918,531
452,0,206,1,975,974,0,10,1,523,522,0.0,0.0005446066918547262,1,718,717,3,-1,4,3,0,523,804,490
453,0,0,1,1,0,0,0,1,1,0,0.0,0.0,1,1,0,-1,-1,-1,3,0,899,737,889
454,11,113,623,946,323,14,14,593,593,0,0.0005786446100956465,0.0008169100377820892,729,779,50,4,4,4,3,7,639,371,534
455,12,218,478,946,468,61,83,451,510,59,0.0,0.0005446066918547262,1,700,699,3,4,4,22,3,33,598,216
456,0,101,1,928,927,0,4,1,331,330,0.0,0.0,1,1,0,7,-1,8,4,0,462,533,640
457,2,618,374,1000,626,5,38,415,929,514,3.4037918240920386e-05,0.007794683277170768,406,975,569,2,5,3,3,1,916,238,56
458,100,306,854,970,116,188,188,899,899,0,0.0012594029749140542,0.0015317063208414173,829,849,20,3,3,3,17,12,210,163,379
459,0,0,1,1,0,0,0,1,1,0,0.0,0.0,1,1,0,-1,-1,-1,11,1,261,705,998
460,0,102,1,944,943,0,3,1,377,376,0.0,0.00010211375472276115,1,486,485,4,-1,5,2,1,960,895,229
461,0,206,1,972,971,0,11,1,481,480,0.0,0.0005446066918547262,1,720,719,3,-1,4,4,0,597,939,306
462,0,0,1,1,0,0,0,1,1,0,0.0,0.0,1,1,0,-1,-1,-1,7,0,477,894,737
463,6,212,438,969,531,9,20,444,616,172,0.0,0.002144388849177984,1,891,890,3,4,4,4,1,783,503,127
464,1,103,332,926,594,3,5,332,395,63,0.0,0.00013615167296368154,1,521,520,4,8,5,3,1,583,703,107
465,15,221,615,972,357,18,18,603,603,0,0.0002042275094455223,0.0006807583648184077,566,756,190,3,4,4,3,6,687,107,103
466,0,101,1,917,916,0,3,1,330,329,0.0,0.0,1,1,0,7,-1,8,3,0,808,744,861
467,142,142,915,915,0,160,160,886,886,0,0.0012934408931549745,0.0012934408931549745,829,829,0,-1,3,3,15,20,45,49,546
468,0,102,1,879,878,0,25,1,381,380,0.0,0.0002723033459273631,1,612,611,4,-1,5,18,0,29,400,613
469,166,268,970,986,16,32,32,911,911,0,0.005241839409101739,0.005377991082065421,955,956,1,4,3,3,2,50,734,33,389
470,99,200,908,969,61,56,56,837,837,0,0.0018720855032506212,0.0019061234214915416,876,876,0,5,3,3,6,20,373,71,842
471,0,206,1,951,950,0,25,1,401,400,0.0,0.0004765308553728854,1,681,680,3,-1,4,13,1,160,835,386
472,0,0,1,1,0,0,0,1,1,0,0.0,0.0,1,1,0,-1,-1,-1,5,0,284,725,934
473,0,0,1,1,0,0,0,1,1,0,0.0,0.0,1,1,0,-1,-1,-1,5,0,669,898,976
474,2,2,384,384,0,4,4,388,388,0,0.0,0.0,1,1,0,-1,5,5,3,2,707,739,746
475,6,108,436,916,480,16,16,513,513,0,0.0,0.0002382654276864427,1,590,589,4,4,4,4,3,717,321,562
476,8,110,530,920,390,14,14,509,509,0,0.0002042275094455223,0.00037441710065012424,564,666,102,4,4,4,3,3,459,508,785
477,22,228,646,963,317,33,54,562,681,119,0.0002723033459273631,0.0018720855032506212,601,878,277,3,3,3,8,2,236,602,104
478,16,632,456,989,533,93,133,444,552,108,6.807583648184077e-05,0.0006807583648184077,433,736,303,2,3,3,33,2,9,597,145
479,13,115,609,933,324,22,22,586,586,0,0.00013615167296368154,0.00017018959120460194,515,544,29,4,4,4,5,3,551,291,385
480,0,0,1,1,0,0,0,1,1,0,0.0,0.0,1,1,0,-1,-1,-1,5,0,517,533,940
481,90,192,912,969,57,34,34,804,804,0,0.0012253650566731338,0.0014295925661186562,834,853,19,4,3,3,4,17,597,45,795
482,16,16,576,576,0,52,52,641,641,0,0.00034037918240920387,0.00034037918240920387,649,649,0,-1,3,3,9,1,316,556,894
483,40,141,782,933,151,58,58,811,811,0,0.001055175465468532,0.001055175465468532,815,815,0,6,3,3,7,6,416,194,582
484,1,102,332,931,599,3,3,332,332,0,0.0,0.0,1,1,0,6,6,6,3,3,901,181,893
485,59,59,831,831,0,82,82,877,877,0,0.0013955546478777359,0.0013955546478777359,842,842,0,-1,3,3,7,10,209,405,600
486,22,228,600,949,349,56,76,487,554,67,0.0002382654276864427,0.0006467204465774873,582,728,146,3,3,3,17,2,6,579,525
487,6,6,493,493,0,12,12,675,675,0,0.00013615167296368154,0.00013615167296368154,539,539,0,-1,4,4,2,1,802,655,828
488,9,110,649,966,317,8,8,604,604,0,0.0002042275094455223,0.00030634126416828345,580,643,63,5,4,4,2,4,810,567,229
489,6,212,475,977,502,6,14,441,580,139,0.00010211375472276115,0.0020763130126961434,496,896,400,3,5,4,3,4,564,625,41
490,48,254,835,976,141,38,38,861,861,0,0.0011913271384322134,0.00442492937131965,836,948,112,3,3,3,3,14,621,190,48
491,1,103,332,951,619,3,5,332,404,72,0.0,0.0002723033459273631,1,628,627,4,6,5,3,1,798,781,308
492,2,104,380,946,566,4,4,415,415,0,6.807583648184077e-05,0.0004765308553728854,452,706,254,4,5,5,2,1,940,537,90
493,0,206,1,959,958,0,18,1,451,450,0.0,0.0002382654276864427,1,591,590,3,-1,4,7,2,320,633,233
494,0,102,1,881,880,0,14,1,360,359,0.0,6.807583648184077e-05,1,443,442,4,-1,5,12,0,292,669,337
495,0,102,1,921,920,0,5,1,382,381,0.0,0.00010211375472276115,1,487,486,4,-1,5,3,0,927,372,156
496,0,0,1,1,0,0,0,1,1,0,0.0,0.0,1,1,0,-1,-1,-1,19,0,148,723,356
497,0,206,1,960,959,0,22,1,472,471,0.0,0.000442492937131965,1,697,696,3,-1,4,7,0,678,973,246
498,28,130,688,914,226,80,80,766,766,0,0.0006467204465774873,0.00088498587426393,740,792,52,4,3,3,10,4,211,288,677
499,0,616,1,993,992,0,64,1,668,667,0.0,0.0028932230504782326,1,920,919,2,-1,3,10,2,128,462,94
500,84,186,921,973,52,46,46,975,975,0,0.004731270635487933,0.0048674223084516155,955,957,2,4,2,2,2,12,988,179,263
501,6,108,422,911,489,22,22,496,496,0,0.0,6.807583648184077e-05,1,442,441,4,4,4,7,1,214,837,648
502,0,0,1,1,0,0,0,1,1,0,0.0,0.0,1,1,0,-1,-1,-1,6,0,373,695,723
503,78,78,827,827,0,182,182,878,878,0,0.0016338200755641784,0.0016338200755641784,864,864,0,-1,2,2,17,11,24,193,920
504,14,14,619,619,0,16,16,550,550,0,0.0002723033459273631,0.0002723033459273631,617,617,0,-1,4,4,4,4,891,622,868
505,79,181,918,974,56,22,22,825,825,0,0.002927260968719153,0.0029612988869600733,928,928,0,4,3,3,2,25,817,47,230
506,0,102,1,874,873,0,23,1,371,370,0.0,0.00017018959120460194,1,540,539,4,-1,5,16,0,50,744,704
507,0,102,1,891,890,0,16,1,402,401,0.0,0.00034037918240920387,1,642,641,4,-1,5,9,0,249,911,525
508,200,200,989,989,0,12,12,809,809,0,0.009156200006807584,0.009156200006807584,979,979,0,-1,4,4,2,91,872,7,848
509,2,2,357,357,0,9,9,395,395,0,0.0,0.0,1,1,0,-1,5,5,5,2,537,495,330
510,4,106,407,901,494,12,12,408,408,0,3.4037918240920386e-05,0.00013615167296368154,397,523,126,4,5,5,6,2,432,523,247
511,12,218,621,978,357,12,12,628,628,0,0.0004765308553728854,0.0010211375472276116,703,821,118,3,4,4,2,6,939,199,253
512,0,102,1,924,923,0,7,1,390,389,0.0,0.00010211375472276115,1,491,490,4,-1,5,5,0,435,228,420
513,10,112,580,942,362,18,18,653,653,0,0.0008169100377820892,0.0020763130126961434,789,895,106,4,4,4,3,5,833,355,129
514,0,0,1,1,0,0,0,1,1,0,0.0,0.0,1,1,0,-1,-1,-1,3,0,725,995,836
515,16,117,687,954,267,18,18,798,798,0,0.0002723033459273631,0.0002723033459273631,624,624,0,6,3,3,2,1,906,667,739
516,161,367,931,980,49,138,138,859,859,0,0.0015657442390823377,0.002723033459273631,853,915,62,3,3,3,13,23,67,117,146
517,0,0,1,1,0,0,0,1,1,0,0.0,0.0,1,1,0,-1,-1,-1,15,0,40,917,955
518,216,216,949,949,0,236,236,970,970,0,0.004322815616596889,0.004322815616596889,950,950,0,-1,2,2,13,19,165,133,929
519,2,208,375,979,604,5,10,415,560,145,6.807583648184077e-05,0.0029612988869600733,467,931,464,3,5,4,3,2,796,654,77
520,0,206,1,971,970,0,20,1,566,565,0.0,0.001497668402600497,1,855,854,3,-1,4,4,0,460,985,153
521,0,102,1,879,878,0,27,1,385,384,0.0,6.807583648184077e-05,1,441,440,4,-1,5,18,0,29,982,586
522,2,104,351,885,534,17,18,392,395,3,3.4037918240920386e-05,6.807583648184077e-05,395,447,52,4,5,5,9,1,351,788,380
523,38,38,793,793,0,56,56,837,837,0,0.0005786446100956465,0.0005786446100956465,724,724,0,-1,3,3,6,4,373,545,436
524,0,102,1,902,901,0,14,1,404,403,0.0,0.0004765308553728854,1,682,681,4,-1,5,8,0,371,905,221
525,0,101,1,910,909,0,6,1,332,331,0.0,0.0,1,1,0,6,-1,7,6,0,549,758,331
526,0,616,1,997,996,0,24,1,745,744,0.0,0.002110350930937064,1,901,900,2,-1,3,3,0,842,977,61
527,0,102,1,879,878,0,28,1,393,392,0.0,0.00010211375472276115,1,477,476,4,-1,5,16,2,78,752,689
528,35,137,736,927,191,56,56,613,613,0,0.00037441710065012424,0.0006126825283365669,667,739,72,4,4,4,10,9,149,211,670
529,2,104,356,907,551,11,14,387,408,21,3.4037918240920386e-05,0.000442492937131965,408,689,281,4,5,5,7,1,510,265,345
530,0,0,1,1,0,0,0,1,1,0,0.0,0.0,1,1,0,-1,-1,-1,8,0,286,359,780
531,0,0,1,1,0,0,0,1,1,0,0.0,0.0,1,1,0,-1,-1,-1,5,0,570,783,757
532,1,1,333,333,0,7,7,333,333,0,0.0,0.0,1,1,0,-1,6,6,7,2,398,374,583
533,0,0,1,1,0,0,0,1,1,0,0.0,0.0,1,1,0,-1,-1,-1,5,0,291,813,533
534,0,206,1,957,956,0,18,1,451,450,0.0,0.0002042275094455223,1,571,570,3,-1,4,7,0,637,358,303
535,0,101,1,892,891,0,9,1,330,329,0.0,3.4037918240920386e-05,1,403,402,5,-1,6,9,0,147,906,342
536,0,0,1,1,0,0,0,1,1,0,0.0,0.0,1,1,0,-1,-1,-1,13,0,92,943,974
537,16,118,769,975,206,8,8,644,644,0,0.0005446066918547262,0.0009190237925048504,740,803,63,4,4,4,2,4,884,470,475
538,0,102,1,929,928,0,5,1,367,366,0.0,3.4037918240920386e-05,1,393,392,4,-1,5,4,0,563,546,771
539,266,368,961,978,17,222,222,961,961,0,0.002995336805200994,0.0030634126416828346,921,923,2,4,2,2,14,33,21,15,597
540,0,616,1,990,989,0,75,1,533,532,0.0,0.001157289220191293,1,813,812,2,-1,3,19,0,48,574,116
541,2,103,399,964,565,3,3,411,411,0,0.00010211375472276115,0.00010211375472276115,501,501,0,6,5,5,2,2,865,654,739
542,0,102,1,917,916,0,8,1,396,395,0.0,3.4037918240920386e-05,1,389,388,4,-1,5,5,0,720,802,380
543,2,103,376,946,570,6,6,440,440,0,0.00010211375472276115,0.00037441710065012424,478,666,188,5,5,5,3,1,485,718,294
544,0,102,1,931,930,0,7,1,399,398,0.0,0.0004084550188910446,1,676,675,4,-1,5,4,0,617,457,345
545,195,296,932,970,38,218,218,889,889,0,0.0020082371762143027,0.0020082371762143027,879,879,0,5,2,2,19,22,19,203,292
546,12,218,630,978,348,12,12,615,615,0,0.0002723033459273631,0.002723033459273631,635,917,282,3,4,4,2,5,983,124,74
547,78,284,850,972,122,98,102,889,917,28,0.0018380475850097008,0.006943735321147759,874,972,98,3,2,2,8,4,317,40,19
548,0,0,1,1,0,0,0,1,1,0,0.0,0.0,1,1,0,-1,-1,-1,2,0,806,433,947
549,10,111,571,930,359,22,22,593,593,0,0.00013615167296368154,0.00013615167296368154,526,526,0,5,4,4,5,6,601,406,627
550,6,6,481,481,0,12,12,606,606,0,0.00013615167296368154,0.00013615167296368154,520,520,0,-1,4,4,2,3,970,309,513
551,24,230,675,969,294,48,48,739,739,0,0.000442492937131965,0.0012253650566731338,694,825,131,3,3,3,8,6,442,247,130
552,8,8,527,527,0,12,12,463,463,0,6.807583648184077e-05,6.807583648184077e-05,453,453,0,-1,4,4,4,2,741,549,614
553,8,109,573,950,377,16,16,611,611,0,0.00013615167296368154,0.00013615167296368154,515,515,0,5,4,4,4,2,754,363,581
554,2,208,366,974,608,6,10,446,514,68,3.4037918240920386e-05,0.0015657442390823377,406,869,463,3,5,4,3,1,882,840,89
555,77,77,883,883,0,40,40,772,772,0,0.0020763130126961434,0.0020763130126961434,887,887,0,-1,3,3,5,19,386,72,428
556,2,103,366,933,567,5,5,385,385,0,0.00010211375472276115,0.00010211375472276115,482,482,0,6,5,5,3,1,791,931,437
557,54,156,816,941,125,78,78,807,807,0,0.0010211375472276116,0.001157289220191293,804,821,17,4,3,3,10,6,243,377,214
558,36,138,770,936,166,38,38,682,682,0,0.00037441710065012424,0.0009530617107457708,662,799,137,4,3,3,6,5,549,636,407
559,32,134,825,960,135,22,22,820,820,0,0.0011913271384322134,0.0012253650566731338,842,846,4,4,3,3,2,5,896,403,342
560,0,102,1,965,964,0,4,1,478,477,0.0,0.0013955546478777359,1,864,863,4,-1,5,2,2,987,271,15
561,0,616,1,994,993,0,98,1,869,868,0.0,0.013751318969331836,1,987,986,2,-1,3,8,0,186,740,2
562,10,111,671,963,292,8,8,589,589,0,0.0002042275094455223,0.00037441710065012424,598,671,73,5,4,4,2,4,481,637,454
563,41,41,788,788,0,30,30,624,624,0,0.0008169100377820892,0.0008169100377820892,782,782,0,-1,4,4,5,10,349,366,701
564,0,101,1,911,910,0,5,1,332,331,0.0,0.00010211375472276115,1,493,492,5,-1,6,5,0,528,600,492
565,6,108,437,926,489,14,14,533,533,0,0.00013615167296368154,0.0002723033459273631,522,611,89,4,4,4,3,1,554,904,552
566,0,206,1,979,978,0,18,1,750,749,0.0,0.0030974505599237552,1,932,931,3,-1,4,3,1,790,841,74
567,0,0,1,1,0,0,0,1,1,0,0.0,0.0,1,1,0,-1,-1,-1,4,1,401,513,746
568,8,110,502,913,411,15,16,427,433,6,0.0,0.00010211375472276115,1,484,483,4,4,4,7,5,170,464,697
569,46,148,746,904,158,202,202,912,912,0,0.0013615167296368155,0.0013615167296368155,836,836,0,4,3,3,17,5,80,393,879
570,16,16,557,557,0,37,37,475,475,0,0.00013615167296368154,0.00013615167296368154,506,506,0,-1,4,4,13,4,113,444,812
571,9,9,554,554,0,16,16,514,514,0,0.00013615167296368154,0.00013615167296368154,520,520,0,-1,4,4,4,5,758,722,811
572,0,0,1,1,0,0,0,1,1,0,0.0,0.0,1,1,0,-1,-1,-1,7,1,196,806,635
573,10,216,534,966,432,16,16,491,491,0,0.0002042275094455223,0.0006807583648184077,555,758,203,3,4,4,4,5,493,722,40
574,0,0,1,1,0,0,0,1,1,0,0.0,0.0,1,1,0,-1,-1,-1,7,0,374,955,735
575,0,102,1,923,922,0,7,1,365,364,0.0,0.0002042275094455223,1,563,562,4,-1,5,6,3,494,854,479
576,33,134,757,935,178,40,40,781,781,0,0.0004084550188910446,0.0004084550188910446,674,674,0,5,3,3,4,3,567,291,492
577,69,171,830,936,106,104,104,860,860,0,0.0013274788113958951,0.0013274788113958951,834,834,0,4,3,3,9,8,100,352,837
578,17,119,700,948,248,8,8,512,512,0,6.807583648184077e-05,0.0002723033459273631,456,632,176,4,4,4,2,9,948,317,266
579,35,137,788,945,157,36,36,745,745,0,0.0004084550188910446,0.0004084550188910446,678,678,0,4,3,3,5,8,412,257,353
580,0,616,1,998,997,0,34,1,777,776,0.0,0.005922597773920147,1,968,967,2,-1,3,4,0,617,978,70
581,7,623,526,997,471,12,30,472,717,245,0.0,0.0040845501889104465,1,945,944,2,4,3,4,2,675,364,76
582,0,102,1,936,935,0,5,1,392,391,0.0,0.000442492937131965,1,699,698,4,-1,5,3,0,825,745,204
583,2,2,363,363,0,5,5,363,363,0,6.807583648184077e-05,6.807583648184077e-05,445,445,0,-1,5,5,4,1,520,593,999
584,0,102,1,948,947,0,4,1,380,379,0.0,0.0002382654276864427,1,611,610,4,-1,5,3,0,718,808,315
585,0,0,1,1,0,0,0,1,1,0,0.0,0.0,1,1,0,-1,-1,-1,5,0,347,772,855
586,0,102,1,926,925,0,8,1,381,380,0.0,0.0002382654276864427,1,595,594,4,-1,5,6,0,661,826,93
587,0,102,1,931,930,0,8,1,441,440,0.0,0.0006467204465774873,1,754,753,4,-1,5,4,0,581,846,273
588,10,626,480,992,512,34,124,394,738,344,0.00013615167296368154,0.003642057251778481,503,939,436,2,4,3,17,3,103,534,33
589,6,108,458,939,481,16,16,514,514,0,0.00013615167296368154,0.00037441710065012424,522,662,140,4,4,4,6,1,529,904,452
590,0,0,1,1,0,0,0,1,1,0,0.0,0.0,1,1,0,-1,-1,-1,9,0,306,918,909
591,6,212,447,971,524,16,20,541,608,67,0.00010211375472276115,0.0018040096667687805,486,872,386,3,4,4,4,1,545,474,119
592,1,103,333,887,554,9,14,333,381,48,0.0,6.807583648184077e-05,1,449,448,4,6,5,9,1,327,621,176
593,0,102,1,896,895,0,16,1,379,378,0.0,0.00037441710065012424,1,645,644,4,-1,5,11,1,271,947,275
594,0,101,1,918,917,0,4,1,331,330,0.0,3.4037918240920386e-05,1,395,394,5,-1,6,4,0,832,644,743
595,12,114,647,949,302,8,8,519,519,0,0.000442492937131965,0.0007488342013002485,696,764,68,4,4,4,2,6,992,258,459
596,0,206,1,933,932,0,59,1,449,448,0.0,0.00017018959120460194,1,540,539,3,-1,4,21,0,74,766,132
597,490,696,995,998,3,62,62,974,974,0,0.013513053541645392,0.013887470642295518,991,991,0,3,2,2,3,96,855,1,480
598,10,111,634,959,325,16,16,678,678,0,0.00030634126416828345,0.00030634126416828345,648,648,0,5,4,4,4,4,860,617,442
599,1,1,330,330,0,2,2,330,330,0,0.0,0.0,1,1,0,-1,7,7,2,2,933,663,588
600,0,0,1,1,0,0,0,1,1,0,0.0,0.0,1,1,0,-1,-1,-1,4,0,542,974,835
601,30,30,699,699,0,66,66,705,705,0,0.0005786446100956465,0.0005786446100956465,719,719,0,-1,3,3,10,4,355,328,988
602,16,222,518,951,433,47,56,468,497,29,0.00013615167296368154,0.0004084550188910446,516,663,147,3,3,3,15,2,51,560,809
603,133,235,965,982,17,46,46,976,976,0,0.006331052792811192,0.00707988699411144,969,973,4,4,2,2,2,25,979,105,139
604,112,112,931,931,0,66,66,923,923,0,0.0025188059498281084,0.0025188059498281084,909,909,0,-1,3,3,6,20,594,38,901
605,19,121,627,916,289,44,44,603,603,0,6.807583648184077e-05,0.00037441710065012424,447,649,202,4,3,3,9,5,394,710,519
606,64,166,877,964,87,22,22,851,851,0,0.0013274788113958951,0.0013615167296368155,857,860,3,4,3,3,2,12,932,179,244
607,2,2,366,366,0,5,5,398,398,0,0.0,0.0,1,1,0,-1,5,5,3,1,882,743,901
608,0,0,1,1,0,0,0,1,1,0,0.0,0.0,1,1,0,-1,-1,-1,4,0,738,908,478
609,236,236,964,964,0,130,130,923,923,0,0.004288777698355968,0.004288777698355968,948,948,0,-1,3,3,10,31,125,76,478
610,30,131,762,941,179,24,24,661,661,0,0.0004765308553728854,0.0004765308553728854,708,708,0,6,4,4,4,7,753,218,861
611,0,0,1,1,0,0,0,1,1,0,0.0,0.0,1,1,0,-1,-1,-1,7,0,505,887,839
612,1,1,332,332,0,2,2,332,332,0,0.0,0.0,1,1,0,-1,6,6,2,2,937,357,668
613,0,102,1,936,935,0,5,1,397,396,0.0,0.0002042275094455223,1,588,587,4,-1,5,3,0,732,786,507
614,16,118,645,936,291,10,10,473,473,0,0.00030634126416828345,0.0004084550188910446,633,679,46,4,4,4,3,6,585,258,251
615,0,102,1,891,890,0,9,1,363,362,0.0,3.4037918240920386e-05,1,399,398,4,-1,5,7,0,436,816,311
616,95,711,897,998,101,62,66,888,888,0,0.0015657442390823377,0.014500153170632085,865,988,123,2,3,3,6,15,455,219,2
617,2,103,362,919,557,7,7,375,375,0,0.0,0.0,1,1,0,5,5,5,5,2,531,764,580
618,0,0,1,1,0,0,0,1,1,0,0.0,0.0,1,1,0,-1,-1,-1,2,1,747,852,987
619,0,206,1,959,958,0,15,1,409,408,0.0,0.00010211375472276115,1,479,478,3,-1,4,6,0,312,695,508
620,28,28,814,814,0,32,32,902,902,0,0.001497668402600497,0.001497668402600497,871,871,0,-1,3,3,2,5,771,403,730
621,24,640,688,996,308,62,72,805,849,44,0.0010892133837094523,0.002995336805200994,819,926,107,2,3,3,7,4,361,281,106
622,4,106,447,923,476,8,8,426,426,0,6.807583648184077e-05,0.0006467204465774873,444,743,299,4,5,5,4,2,787,408,224
623,0,102,1,934,933,0,4,1,426,425,0.0,0.0017359338302869397,1,870,869,4,-1,5,2,0,739,868,94
624,22,228,780,986,206,24,24,851,851,0,0.0004084550188910446,0.0009870996289866913,685,816,131,3,3,3,3,5,875,252,762
625,50,50,779,779,0,98,98,744,744,0,0.0005786446100956465,0.0005786446100956465,715,715,0,-1,3,3,12,5,116,418,604
626,8,214,504,963,459,20,24,477,518,41,0.00013615167296368154,0.001055175465468532,528,815,287,3,4,4,6,2,352,22,96
627,17,118,753,967,214,12,12,725,725,0,0.00034037918240920387,0.0004084550188910446,661,691,30,5,4,4,2,8,890,132,384
628,53,154,819,946,127,58,58,778,778,0,0.0008169100377820892,0.0008169100377820892,779,779,0,6,3,3,7,9,505,294,331
629,0,206,1,962,961,0,13,1,426,425,0.0,0.00034037918240920387,1,637,636,3,-1,4,5,0,546,400,332
630,2,2,357,357,0,10,10,366,366,0,0.0,0.0,1,1,0,-1,5,5,8,2,186,721,790
631,0,0,1,1,0,0,0,1,1,0,0.0,0.0,1,1,0,-1,-1,-1,12,0,292,782,789
632,0,0,1,1,0,0,0,1,1,0,0.0,0.0,1,1,0,-1,-1,-1,6,0,393,664,715
633,42,42,756,756,0,64,64,631,631,0,0.00037441710065012424,0.00037441710065012424,667,667,0,-1,4,4,12,11,187,316,817
634,0,101,1,937,936,0,3,1,331,330,0.0,0.0,1,1,0,5,-1,6,3,0,590,988,749
635,26,232,788,981,193,24,28,821,845,24,0.0009190237925048504,0.002723033459273631,796,916,120,3,3,3,3,5,854,178,87
636,0,206,1,955,954,0,21,1,463,462,0.0,0.0002382654276864427,1,590,589,3,-1,4,7,0,436,768,40
637,6,6,378,378,0,38,38,387,387,0,3.4037918240920386e-05,3.4037918240920386e-05,400,400,0,-1,4,4,21,2,54,615,992
638,35,651,805,998,193,34,34,801,801,0,0.0008169100377820892,0.008237176214302734,785,978,193,2,3,3,4,6,633,471,9
639,181,181,929,929,0,192,192,879,879,0,0.0020763130126961434,0.0020763130126961434,887,887,0,-1,2,2,18,23,111,106,930
640,12,114,610,934,324,26,26,653,653,0,0.0006807583648184077,0.0008169100377820892,751,792,41,4,4,4,5,4,376,440,504
641,21,227,674,967,293,28,28,566,566,0,0.0002382654276864427,0.0009870996289866913,593,812,219,3,4,4,6,6,387,486,340
642,0,0,1,1,0,0,0,1,1,0,0.0,0.0,1,1,0,-1,-1,-1,9,1,277,705,737
643,429,635,987,995,8,206,206,995,995,0,0.011811157629599374,0.012730181422104225,982,984,2,3,2,2,9,54,278,19,189
644,105,105,940,940,0,28,28,819,819,0,0.003165526396405596,0.003165526396405596,925,925,0,-1,3,3,3,24,716,8,611
645,70,172,849,955,106,74,74,798,798,0,0.0007147962830593281,0.0007147962830593281,758,758,0,4,3,3,8,8,297,187,662
646,134,235,939,976,37,50,50,886,886,0,0.0038462847612240037,0.0038462847612240037,941,941,0,5,3,3,5,28,476,41,481
647,10,112,541,915,374,16,16,510,510,0,0.00013615167296368154,0.0006467204465774873,513,744,231,4,4,4,4,3,391,704,177
648,11,112,609,941,332,8,8,482,482,0,0.000442492937131965,0.0004765308553728854,687,696,9,5,4,4,2,4,429,365,244
649,1,103,333,910,577,7,12,333,397,64,0.0,0.00013615167296368154,1,504,503,4,7,5,7,2,196,582,4
650,10,111,609,944,335,8,8,590,590,0,0.00034037918240920387,0.000442492937131965,674,717,43,5,4,4,2,3,283,519,481
651,0,101,1,942,941,0,2,1,331,330,0.0,0.0,1,1,0,5,-1,6,2,0,802,884,615
652,0,0,1,1,0,0,0,1,1,0,0.0,0.0,1,1,0,-1,-1,-1,4,0,891,950,330
653,20,121,631,905,274,50,50,609,609,0,0.0002382654276864427,0.0002382654276864427,590,590,0,5,4,4,9,6,287,379,593
654,32,134,800,950,150,24,24,781,781,0,0.000442492937131965,0.0004765308553728854,692,697,5,4,3,3,3,7,716,422,667
655,0,0,1,1,0,0,0,1,1,0,0.0,0.0,1,1,0,-1,-1,-1,7,0,336,778,784
656,16,16,547,547,0,108,108,796,796,0,0.0006467204465774873,0.0006467204465774873,739,739,0,-1,3,3,13,1,160,480,731
657,6,212,439,969,530,18,18,517,517,0,0.00017018959120460194,0.0005105687736138058,552,703,151,3,4,4,5,1,487,334,418
658,100,100,862,862,0,100,100,688,688,0,0.026821879573845263,0.027026107083290785,1000,1000,0,3,1,1,16,127,78,11,150
659,667,867,1000,1000,0,56,56,979,979,0,0.02307770856734402,0.024064808196330712,998,998,0,3,2,2,2,157,752,2,157
660,5,5,561,561,0,3,3,417,417,0,0.00010211375472276115,0.00010211375472276115,499,499,0,-1,5,5,2,3,962,214,883
661,2,104,361,910,549,6,8,375,403,28,0.0,0.0,1,1,0,4,5,5,4,1,500,853,434
662,0,101,1,906,905,0,8,1,332,331,0.0,3.4037918240920386e-05,1,400,399,5,-1,6,8,0,442,643,618
663,1,617,333,991,658,17,72,333,540,207,0.0,0.0010892133837094523,1,817,816,2,6,3,17,2,56,582,189
664,22,22,739,739,0,22,22,805,805,0,0.0020422750944552232,0.0020422750944552232,892,892,0,-1,3,3,2,5,609,535,604
665,5,107,435,919,484,10,10,423,423,0,0.0,3.4037918240920386e-05,1,415,414,4,5,5,5,3,326,580,594
666,0,616,1,999,998,0,44,1,911,910,0.0,0.026141121209026855,1,995,994,2,-1,3,4,0,480,926,2
667,2,2,361,361,0,5,5,390,390,0,6.807583648184077e-05,6.807583648184077e-05,450,450,0,-1,5,5,3,2,337,764,854
668,12,113,592,927,335,16,16,536,536,0,0.00017018959120460194,0.00030634126416828345,553,635,82,5,4,4,4,6,397,107,761
669,4,105,529,974,445,4,4,496,496,0,0.00013615167296368154,0.0004084550188910446,525,700,175,5,5,5,2,3,872,704,354
670,8,8,504,504,0,28,28,554,554,0,6.807583648184077e-05,6.807583648184077e-05,443,443,0,-1,4,4,6,2,560,549,751
671,14,115,662,953,291,12,12,655,655,0,0.0002382654276864427,0.00037441710065012424,605,668,63,5,4,4,2,4,874,332,537
672,1,1,333,333,0,9,9,333,333,0,0.0,0.0,1,1,0,-1,8,8,9,1,394,857,611
673,207,309,972,983,11,84,84,965,965,0,0.00803294870485721,0.008203138296061813,975,975,0,4,2,2,5,31,517,34,521
674,8,8,513,513,0,18,18,531,531,0,0.0004084550188910446,0.0004084550188910446,680,680,0,-1,4,4,5,3,669,197,684
675,0,102,1,873,872,0,22,1,372,371,0.0,0.00017018959120460194,1,535,534,4,-1,5,15,0,49,769,710
676,5,106,436,920,484,8,8,412,412,0,6.807583648184077e-05,0.00013615167296368154,441,504,63,5,5,5,4,3,832,311,337
677,6,212,432,971,539,15,20,459,512,53,0.00010211375472276115,0.0005786446100956465,481,724,243,3,4,4,6,3,373,755,471
678,0,102,1,922,921,0,4,1,365,364,0.0,0.00010211375472276115,1,481,480,4,-1,5,3,0,577,946,369
679,30,1670,697,1000,303,70,114,722,896,174,0.00034037918240920387,0.010960209673576363,636,982,346,1,3,2,10,6,256,107,169
680,0,206,1,962,961,0,20,1,562,561,0.0,0.001157289220191293,1,834,833,3,-1,4,4,0,300,977,147
681,0,0,1,1,0,0,0,1,1,0,0.0,0.0,1,1,0,-1,-1,-1,2,1,913,660,673
682,6,212,408,955,547,20,30,421,488,67,0.0,0.0006807583648184077,1,744,743,3,4,4,9,1,136,807,175
683,9,215,567,971,404,18,18,605,605,0,0.0002723033459273631,0.002484768031587188,622,904,282,3,4,4,3,3,836,458,38
684,0,102,1,927,926,0,4,1,397,396,0.0,0.00010211375472276115,1,497,496,4,-1,5,2,0,925,954,274
685,0,102,1,943,942,0,3,1,373,372,0.0,3.4037918240920386e-05,1,417,416,4,-1,5,2,0,802,910,719
686,82,183,910,972,62,22,22,784,784,0,0.002280540522141666,0.002280540522141666,909,909,0,6,3,3,2,19,596,144,621
687,0,0,1,1,0,0,0,1,1,0,0.0,0.0,1,1,0,-1,-1,-1,17,0,10,933,826
688,0,101,1,912,911,0,4,1,332,331,0.0,3.4037918240920386e-05,1,400,399,5,-1,6,4,0,759,967,592
689,4,4,443,443,0,5,5,387,387,0,3.4037918240920386e-05,3.4037918240920386e-05,404,404,0,-1,5,5,3,2,651,430,834
690,13,219,595,971,376,32,36,644,693,49,0.00030634126416828345,0.0014636304843595766,641,848,207,3,4,4,6,3,405,291,130
691,12,114,538,906,368,43,43,589,589,0,0.00010211375472276115,0.00010211375472276115,476,476,0,4,4,4,10,2,243,251,799
692,0,101,1,888,887,0,9,1,332,331,0.0,3.4037918240920386e-05,1,399,398,5,-1,6,9,0,164,981,788
693,22,124,767,959,192,10,10,531,531,0,0.0004765308553728854,0.0005786446100956465,713,733,20,4,4,4,3,11,600,316,223
694,6,108,396,887,491,18,20,401,409,8,0.0,0.0002382654276864427,1,583,582,4,4,4,9,3,381,578,516
695,2,104,348,894,546,13,17,369,391,22,0.0,6.807583648184077e-05,1,438,437,4,5,5,10,1,409,734,508
696,68,68,894,894,0,28,28,809,809,0,0.0013955546478777359,0.0013955546478777359,857,857,0,-1,3,3,3,17,748,269,569
697,0,0,1,1,0,0,0,1,1,0,0.0,0.0,1,1,0,-1,-1,-1,5,3,496,478,985
698,0,102,1,909,908,0,8,1,409,408,0.0,6.807583648184077e-05,1,448,447,4,-1,5,4,0,572,635,667
699,16,118,524,887,363,100,100,679,679,0,0.0002382654276864427,0.00030634126416828345,579,620,41,4,3,3,15,1,49,727,110
700,13,115,529,902,373,40,40,522,522,0,6.807583648184077e-05,0.00010211375472276115,449,479,30,4,4,4,10,3,153,458,598
701,0,0,1,1,0,0,0,1,1,0,0.0,0.0,1,1,0,-1,-1,-1,5,0,599,856,777
702,100,100,880,880,0,100,100,899,899,0,0.029681064706082574,0.030191633479696382,999,999,0,3,1,1,8,78,236,9,162
703,24,125,662,908,246,46,46,551,551,0,0.00030634126416828345,0.00030634126416828345,620,620,0,5,3,3,12,4,375,220,530
704,1,1,332,332,0,4,4,332,332,0,0.0,0.0,1,1,0,-1,8,8,4,1,614,857,811
705,1,207,333,953,620,11,42,333,518,185,0.0,0.0005446066918547262,1,703,702,3,6,4,11,4,220,595,637
706,0,206,1,956,955,0,14,1,412,411,0.0,0.0005105687736138058,1,709,708,3,-1,4,6,0,157,921,487
707,0,206,1,974,973,0,14,1,588,587,0.0,0.0030634126416828346,1,930,929,3,-1,4,3,0,863,969,48
708,1,207,332,980,648,2,7,332,512,180,0.0,0.00017018959120460194,1,549,548,3,7,4,2,1,977,671,199
709,0,616,1,995,994,0,24,1,609,608,0.0,0.001157289220191293,1,824,823,2,-1,3,5,0,311,848,187
710,0,206,1,968,967,0,8,1,432,431,0.0,0.0002042275094455223,1,559,558,3,-1,4,3,0,778,600,597
711,18,224,641,967,326,14,14,502,502,0,0.00037441710065012424,0.0007147962830593281,660,759,99,3,4,4,3,6,731,199,287
712,38,38,691,691,0,112,112,655,655,0,0.000442492937131965,0.000442492937131965,670,670,0,-1,3,3,21,4,2,617,698
713,204,204,967,967,0,88,88,978,978,0,0.006875659484665918,0.006875659484665918,967,967,0,-1,2,2,4,27,758,88,872
714,0,0,1,1,0,0,0,1,1,0,0.0,0.0,1,1,0,-1,-1,-1,3,0,485,695,686
715,0,206,1,973,972,0,13,1,468,467,0.0,0.000442492937131965,1,684,683,3,-1,4,5,1,570,706,46
716,8,8,557,557,0,12,12,588,588,0,0.0002382654276864427,0.0002382654276864427,583,583,0,-1,4,4,2,4,598,270,875
717,155,257,931,965,34,110,110,864,864,0,0.0020763130126961434,0.002212464685659825,885,889,4,4,3,3,10,26,128,127,274
718,25,25,676,676,0,80,80,788,788,0,0.0009530617107457708,0.0009530617107457708,786,786,0,-1,3,3,10,4,437,207,971
719,1,103,331,974,643,2,3,331,436,105,0.0,0.00030634126416828345,1,659,658,4,6,5,2,1,978,618,209
720,0,0,1,1,0,0,0,1,1,0,0.0,0.0,1,1,0,-1,-1,-1,6,2,556,684,953
721,58,264,789,962,173,160,160,844,844,0,0.0012594029749140542,0.0012594029749140542,834,834,0,3,2,2,16,3,59,351,222
722,17,633,666,998,332,18,28,653,780,127,0.00030634126416828345,0.005582218591510943,646,967,321,2,4,3,3,6,672,199,34
723,6,6,424,424,0,40,40,604,604,0,0.00013615167296368154,0.00013615167296368154,506,506,0,-1,4,4,8,2,286,223,786
724,88,88,915,915,0,32,32,900,900,0,0.002552843868069029,0.002552843868069029,914,914,0,-1,3,3,2,22,925,203,349
725,77,283,911,986,75,12,12,631,631,0,0.002314578440382586,0.0026209197045508697,911,917,6,3,4,4,2,19,894,133,329
726,0,206,1,955,954,0,28,1,501,500,0.0,0.0010892133837094523,1,806,805,3,-1,4,8,0,443,933,227
727,84,186,908,972,64,32,32,916,916,0,0.0022465026039007454,0.0026209197045508697,901,919,18,4,3,3,2,22,849,116,90
728,4,210,425,967,542,6,10,393,453,60,3.4037918240920386e-05,0.00030634126416828345,418,636,218,3,5,4,3,4,613,442,504
729,62,163,876,963,87,38,38,868,868,0,0.0013615167296368155,0.0013615167296368155,851,851,0,5,3,3,3,12,833,163,484
730,0,206,1,959,958,0,32,1,518,517,0.0,0.0008169100377820892,1,772,771,3,-1,4,8,0,225,446,96
731,2,2,371,371,0,7,7,416,416,0,0.0,0.0,1,1,0,-1,5,5,4,2,480,690,786
732,100,100,839,839,0,100,100,563,563,0,0.011845195547840293,0.012049423057285817,986,986,0,3,1,1,20,19,5,133,487
733,29,646,807,999,192,14,24,594,812,218,0.0006467204465774873,0.004050512270669526,745,945,200,2,4,3,3,9,708,130,403
734,0,206,1,960,959,0,22,1,487,486,0.0,0.0005105687736138058,1,706,705,3,-1,4,7,0,171,864,139
735,1,1,333,333,0,5,5,333,333,0,0.0,0.0,1,1,0,-1,6,6,5,1,531,671,713
736,1,207,333,965,632,7,13,333,406,73,0.0,0.00010211375472276115,1,475,474,3,6,4,7,1,141,972,581
737,52,154,787,926,139,98,98,758,758,0,0.001055175465468532,0.001157289220191293,805,814,9,4,3,3,13,10,185,195,481
738,0,206,1,959,958,0,36,1,570,569,0.0,0.0018720855032506212,1,877,876,3,-1,4,8,1,380,948,128
739,0,0,1,1,0,0,0,1,1,0,0.0,0.0,1,1,0,-1,-1,-1,10,0,99,970,907
740,2,102,375,942,567,4,4,393,393,0,6.807583648184077e-05,0.00013615167296368154,458,527,69,4,5,5,2,1,771,618,259
741,19,121,704,942,238,20,20,742,742,0,0.0002382654276864427,0.0002723033459273631,597,614,17,4,3,3,3,3,882,214,419
742,0,206,1,957,956,0,22,1,464,463,0.0,0.00013615167296368154,1,527,526,3,-1,4,7,0,179,946,222
743,0,0,1,1,0,0,0,1,1,0,0.0,0.0,1,1,0,-1,-1,-1,6,0,253,864,672
744,1,617,333,993,660,11,56,333,592,259,0.0,0.002110350930937064,1,888,887,2,6,3,11,2,167,448,36
745,0,1640,1,1000,999,0,42,1,964,963,0.0,0.03563770039824364,1,997,996,1,-1,2,3,0,888,847,313
746,0,206,1,945,944,0,27,1,392,391,0.0,0.00017018959120460194,1,538,537,3,-1,4,14,1,133,641,124
747,0,206,1,976,975,0,10,1,482,481,0.0,0.0005786446100956465,1,731,730,3,-1,4,4,0,811,638,414
748,16,16,574,574,0,30,30,489,489,0,0.00013615167296368154,0.00013615167296368154,511,511,0,-1,4,4,9,8,136,477,746
749,16,117,670,948,278,18,18,660,660,0,0.0006467204465774873,0.0008509479560230097,752,793,41,5,4,4,3,4,958,333,805
750,368,574,980,988,8,306,306,973,973,0,0.004186663943633207,0.005037611899656217,943,955,12,3,2,2,18,44,64,27,186
751,0,616,1,995,994,0,28,1,555,554,0.0,0.0028932230504782326,1,917,916,2,-1,3,7,0,362,489,108
752,1,1,333,333,0,4,4,333,333,0,6.807583648184077e-05,6.807583648184077e-05,457,457,0,-1,6,6,4,1,558,601,824
753,142,244,946,972,26,70,70,933,933,0,0.003437829742332959,0.003608019333537561,932,933,1,4,3,3,5,28,412,41,527
754,14,14,628,628,0,16,16,528,528,0,0.00013615167296368154,0.00013615167296368154,520,520,0,-1,4,4,4,3,649,369,428
755,0,0,1,1,0,0,0,1,1,0,0.0,0.0,1,1,0,-1,-1,-1,3,0,703,871,614
756,201,201,974,974,0,38,38,881,881,0,0.004493005207801491,0.004493005207801491,957,957,0,-1,3,3,3,45,588,77,693
757,72,72,835,835,0,60,60,651,651,0,0.0006126825283365669,0.0006126825283365669,728,728,0,-1,3,3,9,9,351,414,910
758,0,206,1,967,966,0,18,1,533,532,0.0,0.0004084550188910446,1,688,687,3,-1,4,5,1,565,779,218
759,48,254,774,969,195,96,96,811,811,0,0.0005786446100956465,0.0007828721195411688,728,767,39,3,2,2,10,3,135,222,891
760,0,616,1,992,991,0,80,1,601,600,0.0,0.0017018959120460194,1,866,865,2,-1,3,15,0,0,760,206
761,29,131,642,888,246,114,114,640,640,0,0.00030634126416828345,0.00034037918240920387,622,632,10,4,3,3,19,5,14,487,570
762,0,206,1,940,939,0,66,1,507,506,0.0,0.0017359338302869397,1,865,864,3,-1,4,19,0,148,798,157
763,0,206,1,974,973,0,15,1,563,562,0.0,0.0006126825283365669,1,741,740,3,-1,4,4,0,673,604,704
764,0,206,1,944,943,0,41,1,398,397,0.0,0.0002723033459273631,1,608,607,3,-1,4,21,0,12,489,557
765,12,12,534,534,0,30,30,488,488,0,0.00013615167296368154,0.00013615167296368154,526,526,0,-1,4,4,9,3,217,496,520
766,26,26,758,758,0,18,18,649,649,0,0.00037441710065012424,0.00037441710065012424,665,665,0,-1,4,4,3,7,903,422,996
767,8,110,574,952,378,8,8,525,525,0,0.00017018959120460194,0.0016338200755641784,555,879,324,4,4,4,2,2,895,425,94
768,0,616,1,996,995,0,24,1,630,629,0.0,0.004050512270669526,1,944,943,2,-1,3,5,0,412,903,77
769,0,0,1,1,0,0,0,1,1,0,0.0,0.0,1,1,0,-1,-1,-1,6,0,352,457,538
770,14,115,533,890,357,46,46,476,476,0,3.4037918240920386e-05,3.4037918240920386e-05,396,396,0,5,4,4,15,3,32,311,896
771,0,0,1,1,0,0,0,1,1,0,0.0,0.0,1,1,0,-1,-1,-1,7,0,372,865,715
772,50,152,793,927,134,66,66,715,715,0,0.0007488342013002485,0.0008509479560230097,769,783,14,4,3,3,9,6,274,46,208
773,35,137,691,898,207,68,68,574,574,0,0.0007147962830593281,0.0008169100377820892,749,762,13,4,4,4,14,9,122,240,464
774,0,0,1,1,0,0,0,1,1,0,0.0,0.0,1,1,0,-1,-1,-1,9,0,123,915,947
775,88,189,892,965,73,50,50,828,828,0,0.0016338200755641784,0.0016338200755641784,854,854,0,5,3,3,5,15,464,62,837
776,40,142,742,916,174,96,96,795,795,0,0.0011913271384322134,0.0012253650566731338,822,826,4,4,2,2,10,2,240,532,613
777,0,101,1,894,893,0,8,1,332,331,0.0,6.807583648184077e-05,1,440,439,5,-1,6,8,0,646,991,464
778,0,206,1,960,959,0,36,1,574,573,0.0,0.0016678579938050988,1,858,857,3,-1,4,8,0,383,880,112
779,0,0,1,1,0,0,0,1,1,0,0.0,0.0,1,1,0,-1,-1,-1,10,0,259,423,750
780,2,2,391,391,0,4,4,458,458,0,0.00013615167296368154,0.00013615167296368154,520,520,0,-1,5,5,2,1,749,720,635
781,0,206,1,965,964,0,17,1,442,441,0.0,0.0004084550188910446,1,671,670,3,-1,4,7,0,658,644,242
782,0,101,1,930,929,0,3,1,331,330,0.0,0.0,1,1,0,6,-1,7,3,0,774,863,603
783,0,206,1,979,978,0,8,1,561,560,0.0,0.0006807583648184077,1,769,768,3,-1,4,2,0,994,731,497
784,0,0,1,1,0,0,0,1,1,0,0.0,0.0,1,1,0,-1,-1,-1,2,0,932,968,954
785,21,1661,804,1000,196,12,46,737,983,246,0.0007488342013002485,0.051839749480921744,777,998,221,1,4,2,2,6,749,4,724
786,0,0,1,1,0,0,0,1,1,0,0.0,0.0,1,1,0,-1,-1,-1,6,0,624,675,744
787,2,208,355,961,606,18,26,415,475,60,3.4037918240920386e-05,0.0002382654276864427,399,591,192,3,5,4,9,1,367,555,191
788,23,229,723,979,256,10,14,494,563,69,0.0002723033459273631,0.0009870996289866913,614,817,203,3,4,4,3,11,627,162,150
789,112,214,921,963,42,88,88,884,884,0,0.0017018959120460194,0.0018720855032506212,861,874,13,4,3,3,8,16,468,78,208
790,0,616,1,992,991,0,54,1,690,689,0.0,0.0028591851322373124,1,920,919,2,-1,3,8,0,383,740,108
791,33,33,740,740,0,62,62,779,779,0,0.0005446066918547262,0.0005446066918547262,720,720,0,-1,3,3,7,7,714,237,568
792,0,206,1,967,966,0,20,1,496,495,0.0,0.0007828721195411688,1,754,753,3,-1,4,6,0,556,946,630
793,9,215,567,974,407,12,16,491,535,44,0.00013615167296368154,0.0017359338302869397,524,871,347,3,4,4,4,3,397,653,65
794,18,18,593,593,0,60,60,612,612,0,0.00037441710065012424,0.00037441710065012424,659,659,0,-1,3,3,11,2,279,697,858
795,13,219,620,971,351,20,24,609,686,77,0.00034037918240920387,0.0026549576227917903,645,912,267,3,4,4,4,4,578,501,109
796,0,206,1,944,943,0,66,1,486,485,0.0,0.0008509479560230097,1,766,765,3,-1,4,21,0,25,367,193
797,0,101,1,862,861,0,20,1,332,331,0.0,0.0,1,1,0,5,-1,6,20,0,88,804,755
798,148,354,931,980,49,82,82,862,862,0,0.0020422750944552232,0.0023486163586235067,884,903,19,3,3,3,7,23,374,66,535
799,2,2,370,370,0,5,5,394,394,0,0.0,0.0,1,1,0,-1,5,5,3,1,670,530,600
800,6,212,452,973,521,20,20,597,597,0,0.00013615167296368154,0.0005786446100956465,511,722,211,3,4,4,4,1,735,394,755
801,60,162,871,964,93,12,12,619,619,0,0.0016678579938050988,0.0016678579938050988,879,879,0,4,4,4,2,14,750,146,536
802,1,103,332,936,604,2,3,332,367,35,0.0,0.00017018959120460194,1,547,546,4,6,5,2,1,993,736,474
803,307,307,979,979,0,80,80,942,942,0,0.005888559855679227,0.005888559855679227,962,962,0,-1,3,3,5,57,537,50,834
804,0,0,1,1,0,0,0,1,1,0,0.0,0.0,1,1,0,-1,-1,-1,13,0,165,926,672
805,18,18,716,716,0,8,8,523,523,0,0.00088498587426393,0.00088498587426393,804,804,0,-1,4,4,2,5,906,403,657
806,0,102,1,955,954,0,3,1,385,384,0.0,0.0007147962830593281,1,768,767,4,-1,5,2,0,965,850,559
807,24,230,718,974,256,32,40,751,789,38,0.00037441710065012424,0.003165526396405596,662,925,263,3,3,3,5,3,533,93,88
808,8,110,606,965,359,6,6,497,497,0,3.4037918240920386e-05,0.0002382654276864427,405,607,202,4,5,5,3,5,852,528,167
809,90,192,932,977,45,46,46,978,978,0,0.00527587732734266,0.0053099152455835805,960,961,1,4,2,2,2,17,874,96,406
810,0,0,1,1,0,0,0,1,1,0,0.0,0.0,1,1,0,-1,-1,-1,10,0,409,587,892
811,48,150,800,937,137,44,44,660,660,0,0.0006126825283365669,0.0006467204465774873,744,748,4,4,3,3,7,7,678,396,755
812,0,102,1,905,904,0,10,1,366,365,0.0,0.00010211375472276115,1,475,474,4,-1,5,8,0,431,783,566
813,290,496,987,996,9,32,32,896,896,0,0.008475441641989176,0.009190237925048503,982,986,4,3,3,3,2,59,934,6,497
814,6,6,425,425,0,26,26,505,505,0,6.807583648184077e-05,6.807583648184077e-05,450,450,0,-1,4,4,7,1,320,904,254
815,18,224,626,968,342,88,88,861,861,0,0.0007828721195411688,0.0011232513019503727,765,815,50,3,3,3,8,4,137,440,294
816,2,2,384,384,0,4,4,388,388,0,3.4037918240920386e-05,3.4037918240920386e-05,399,399,0,-1,5,5,3,1,730,334,967
817,18,18,627,627,0,46,46,658,658,0,0.00013615167296368154,0.00013615167296368154,512,512,0,-1,3,3,8,2,146,363,515
818,2,208,361,975,614,5,10,390,484,94,0.0,0.0005786446100956465,1,727,726,3,5,4,3,3,337,748,216
819,12,628,486,992,506,60,86,508,612,104,0.00030634126416828345,0.0024166921951053475,632,903,271,2,4,3,16,3,53,121,69
820,79,181,866,955,89,50,50,794,794,0,0.001055175465468532,0.0010892133837094523,820,825,5,4,3,3,5,17,408,327,576
821,0,0,1,1,0,0,0,1,1,0,0.0,0.0,1,1,0,-1,-1,-1,5,0,602,833,963
822,99,305,887,980,93,102,102,947,947,0,0.0013615167296368155,0.0017359338302869397,845,873,28,3,2,2,8,17,440,327,523
823,0,206,1,980,979,0,12,1,603,602,0.0,0.005412029000306341,1,963,962,3,-1,4,2,0,943,808,19
824,0,0,1,1,0,0,0,1,1,0,0.0,0.0,1,1,0,-1,-1,-1,5,0,363,514,886
825,1,1,330,330,0,2,2,330,330,0,0.0,0.0,1,1,0,-1,6,6,2,1,933,736,400
826,0,0,1,1,0,0,0,1,1,0,0.0,0.0,1,1,0,-1,-1,-1,2,0,932,892,910
827,3,209,401,963,562,9,13,386,430,44,6.807583648184077e-05,0.0002723033459273631,450,603,153,3,5,4,5,3,426,631,354
828,0,0,1,1,0,0,0,1,1,0,0.0,0.0,1,1,0,-1,-1,-1,3,0,835,372,946
829,56,262,754,961,207,180,180,825,825,0,0.001055175465468532,0.0012594029749140542,802,830,28,3,2,2,19,2,35,453,459
830,2,208,367,974,607,7,12,413,506,93,6.807583648184077e-05,0.0005786446100956465,444,735,291,3,5,4,4,1,721,449,46
831,13,629,618,997,379,18,32,542,749,207,0.00010211375472276115,0.002314578440382586,491,901,410,2,4,3,5,4,612,332,335
832,24,640,687,994,307,60,70,797,863,66,0.0004765308553728854,0.003982436434187685,701,938,237,2,3,3,8,3,309,103,47
833,4,106,460,944,484,4,4,411,411,0,3.4037918240920386e-05,0.00017018959120460194,402,539,137,4,5,5,2,3,937,572,551
834,82,184,843,940,97,126,126,828,828,0,0.001497668402600497,0.0019741992579733825,856,883,27,4,2,2,14,11,144,316,198
835,0,0,1,1,0,0,0,1,1,0,0.0,0.0,1,1,0,-1,-1,-1,3,0,882,786,774
836,0,102,1,961,960,0,3,1,403,402,0.0,0.00030634126416828345,1,656,655,4,-1,5,2,0,481,665,366
837,0,101,1,886,885,0,9,1,330,329,0.0,3.4037918240920386e-05,1,399,398,5,-1,6,9,0,327,826,764
838,27,27,787,787,0,12,12,628,628,0,0.0007147962830593281,0.0007147962830593281,769,769,0,-1,4,4,2,10,939,296,668
839,100,100,845,845,0,100,100,587,587,0,0.009020048333843901,0.010313489226998877,970,975,5,2,1,1,19,20,35,109,562
840,17,223,664,973,309,16,16,550,550,0,0.00017018959120460194,0.0007488342013002485,542,772,230,3,4,4,4,8,562,302,204
841,176,278,928,967,39,144,144,838,838,0,0.002995336805200994,0.002995336805200994,924,924,0,4,3,3,14,26,133,108,547
842,0,102,1,907,906,0,11,1,405,404,0.0,6.807583648184077e-05,1,451,450,4,-1,5,6,0,275,998,424
843,323,529,973,988,15,222,222,971,971,0,0.005173763572619898,0.0053439531638245,956,957,1,3,2,2,13,37,41,74,447
844,12,218,614,978,364,10,14,508,587,79,0.0004765308553728854,0.0006467204465774873,709,746,37,3,4,4,3,6,770,368,447
845,6,6,380,380,0,49,49,423,423,0,3.4037918240920386e-05,3.4037918240920386e-05,397,397,0,-1,4,4,21,1,74,558,906
846,22,124,749,956,207,22,22,820,820,0,0.000442492937131965,0.0006807583648184077,699,772,73,4,3,3,2,4,232,551,262
847,0,206,1,950,949,0,25,1,406,405,0.0,0.00017018959120460194,1,532,531,3,-1,4,13,0,129,894,409
848,0,616,1,993,992,0,66,1,638,637,0.0,0.002212464685659825,1,889,888,2,-1,3,11,0,167,629,65
849,0,102,1,937,936,0,5,1,411,410,0.0,0.00013615167296368154,1,530,529,4,-1,5,3,1,899,539,556
850,0,101,1,918,917,0,4,1,331,330,0.0,0.0,1,1,0,5,-1,6,4,0,655,941,680
851,42,42,795,795,0,52,52,800,800,0,0.0005786446100956465,0.0005786446100956465,723,723,0,-1,3,3,6,6,393,494,849
852,91,91,932,932,0,46,46,974,974,0,0.0048674223084516155,0.0048674223084516155,955,955,0,-1,2,2,2,23,919,122,966
853,0,102,1,896,895,0,12,1,381,380,0.0,0.00013615167296368154,1,519,518,4,-1,5,8,1,142,529,425
854,16,222,525,953,428,43,52,455,489,34,6.807583648184077e-05,0.0007147962830593281,445,744,299,3,3,3,16,2,50,662,184
855,0,102,1,876,875,0,15,1,346,345,0.0,0.00010211375472276115,1,476,475,4,-1,5,14,0,121,715,605
856,36,36,826,826,0,28,28,798,798,0,0.0014295925661186562,0.0014295925661186562,862,862,0,-1,3,3,3,5,861,403,851
857,23,23,657,657,0,42,42,495,495,0,0.0002723033459273631,0.0002723033459273631,608,608,0,-1,3,3,13,4,185,581,538
858,8,110,522,923,401,12,12,473,473,0,6.807583648184077e-05,0.0004084550188910446,445,677,232,4,4,4,4,2,921,791,275
859,0,102,1,900,899,0,6,1,377,376,0.0,0.0002042275094455223,1,563,562,4,-1,5,4,1,547,660,652
860,0,206,1,964,963,0,13,1,443,442,0.0,0.0002723033459273631,1,603,602,3,-1,4,5,0,390,919,711
861,1,207,333,968,635,6,15,333,454,121,0.0,0.0008509479560230097,1,780,779,3,6,4,6,3,575,484,190
862,0,102,1,870,869,0,16,1,354,353,0.0,0.0,1,1,0,4,-1,5,14,0,122,954,598
863,6,6,433,433,0,9,9,439,439,0,3.4037918240920386e-05,3.4037918240920386e-05,393,393,0,-1,4,4,3,1,726,788,824
864,0,206,1,959,958,0,28,1,466,465,0.0,0.0002042275094455223,1,569,568,3,-1,4,10,0,211,349,101
865,2,103,364,935,571,6,6,418,418,0,0.0,0.0002723033459273631,1,615,614,5,5,5,3,1,748,463,562
866,0,206,1,961,960,0,16,1,411,410,0.0,0.00013615167296368154,1,506,505,3,-1,4,8,0,201,992,286
867,32,134,739,933,194,32,32,629,629,0,0.0006126825283365669,0.0007147962830593281,745,763,18,4,4,4,6,9,98,343,553
868,174,174,928,928,0,182,182,875,875,0,0.0029612988869600733,0.0029612988869600733,922,922,0,-1,3,3,17,26,10,108,684
869,0,0,1,1,0,0,0,1,1,0,0.0,0.0,1,1,0,-1,-1,-1,2,0,906,608,946
870,0,206,1,954,953,0,23,1,477,476,0.0,0.0004765308553728854,1,708,707,3,-1,4,8,1,282,706,413
871,16,117,475,880,405,126,126,550,550,0,6.807583648184077e-05,6.807583648184077e-05,437,437,0,6,4,4,35,5,20,350,703
872,22,22,691,691,0,60,60,885,885,0,0.0011232513019503727,0.0011232513019503727,825,825,0,-1,3,3,5,5,326,412,871
873,0,102,1,888,887,0,10,1,370,369,0.0,0.00010211375472276115,1,474,473,4,-1,5,7,0,182,875,477
874,38,244,779,974,195,32,32,638,638,0,0.0008509479560230097,0.0013615167296368155,783,838,55,3,4,4,6,9,515,242,440
875,0,206,1,978,977,0,11,1,501,500,0.0,0.0002382654276864427,1,606,605,3,-1,4,4,0,827,728,704
876,22,228,636,959,323,62,62,656,656,0,0.00037441710065012424,0.00088498587426393,656,780,124,3,3,3,10,2,152,465,250
877,0,102,1,916,915,0,5,1,363,362,0.0,6.807583648184077e-05,1,448,447,4,-1,5,4,1,401,767,640
878,0,102,1,883,882,0,17,1,371,370,0.0,0.00010211375472276115,1,481,480,4,-1,5,12,0,116,538,314
879,30,132,836,971,135,22,22,869,869,0,0.0009530617107457708,0.0011232513019503727,812,834,22,4,3,3,2,7,751,169,677
880,94,300,866,973,107,114,114,889,889,0,0.0020082371762143027,0.0030634126416828346,887,927,40,3,3,3,9,17,351,213,403
881,24,24,720,720,0,24,24,689,689,0,0.0006807583648184077,0.0006807583648184077,754,754,0,-1,4,4,4,9,562,211,796
882,34,240,787,976,189,34,34,742,742,0,0.00088498587426393,0.0025188059498281084,795,910,115,3,3,3,4,5,558,338,108
883,2,2,350,350,0,11,11,362,362,0,3.4037918240920386e-05,3.4037918240920386e-05,409,409,0,-1,5,5,9,2,803,764,554
884,1,1,333,333,0,16,16,333,333,0,0.0,0.0,1,1,0,-1,6,6,16,2,151,656,908
885,44,660,701,990,289,172,194,757,810,53,0.0005786446100956465,0.0020082371762143027,710,877,167,2,3,3,23,10,57,266,203
886,0,206,1,967,966,0,20,1,531,530,0.0,0.001497668402600497,1,857,856,3,-1,4,4,0,385,757,66
887,1,103,332,952,620,2,3,332,390,58,0.0,6.807583648184077e-05,1,452,451,4,6,5,2,2,994,495,491
888,28,130,725,934,209,46,46,733,733,0,0.0006807583648184077,0.0007488342013002485,746,764,18,4,3,3,6,3,341,390,215
889,159,759,940,996,56,92,92,881,881,0,0.002586881786309949,0.004833384390210695,910,956,46,2,3,3,7,27,179,61,39
890,17,119,647,927,280,36,36,725,725,0,0.00034037918240920387,0.0006807583648184077,642,743,101,4,3,3,5,2,605,101,295
891,0,0,1,1,0,0,0,1,1,0,0.0,0.0,1,1,0,-1,-1,-1,5,0,173,849,604
892,0,0,1,1,0,0,0,1,1,0,0.0,0.0,1,1,0,-1,-1,-1,3,0,857,839,798
893,62,268,872,982,110,18,18,697,697,0,0.0018380475850097008,0.0024507301133462676,877,907,30,3,4,4,3,19,433,144,390
894,0,0,1,1,0,0,0,1,1,0,0.0,0.0,1,1,0,-1,-1,-1,3,0,288,400,819
895,2,208,364,973,609,10,20,419,538,119,0.0,0.0012934408931549745,1,846,845,3,5,4,6,1,594,618,73
896,16,222,637,977,340,34,34,775,775,0,0.0008509479560230097,0.002484768031587188,792,907,115,3,3,3,4,3,397,309,122
897,2,103,353,900,547,12,12,390,390,0,3.4037918240920386e-05,3.4037918240920386e-05,392,392,0,6,5,5,7,1,207,537,893
898,0,0,1,1,0,0,0,1,1,0,0.0,0.0,1,1,0,-1,-1,-1,9,1,414,792,712
899,0,101,1,946,945,0,2,1,331,330,0.0,3.4037918240920386e-05,1,414,413,5,-1,6,2,0,957,868,607
900,88,190,936,980,44,22,22,849,849,0,0.0029612988869600733,0.0030974505599237552,930,931,1,4,3,3,2,20,897,38,454
901,6,212,391,949,558,38,42,461,481,20,0.0002042275094455223,0.0002723033459273631,565,604,39,3,4,4,13,1,41,481,662
902,7,109,594,960,366,8,8,583,583,0,0.0002723033459273631,0.0005446066918547262,637,736,99,4,4,4,2,3,751,354,107
903,75,75,801,801,0,180,180,764,764,0,0.0007147962830593281,0.0007147962830593281,737,737,0,-1,2,2,24,7,28,329,927
904,0,206,1,970,969,0,14,1,453,452,0.0,0.00030634126416828345,1,629,628,3,-1,4,5,0,247,750,115
905,6,622,424,995,571,24,50,524,738,214,0.0,0.0036760951700194017,1,939,938,2,4,3,7,1,196,873,105
906,16,16,507,507,0,102,102,623,623,0,0.00010211375472276115,0.00010211375472276115,479,479,0,-1,3,3,20,3,88,260,957
907,0,206,1,953,952,0,22,1,400,399,0.0,0.00030634126416828345,1,618,617,3,-1,4,12,0,375,600,809
908,22,22,746,746,0,34,34,839,839,0,0.0006807583648184077,0.0006807583648184077,766,766,0,-1,3,3,4,2,728,634,699
909,62,678,803,991,188,180,190,882,901,19,0.0018380475850097008,0.003608019333537561,870,930,60,2,2,2,16,4,27,281,95
910,47,47,755,755,0,128,128,820,820,0,0.0005446066918547262,0.0005446066918547262,717,717,0,-1,3,3,13,9,165,212,693
911,16,222,626,971,345,24,28,626,677,51,0.0008509479560230097,0.0010892133837094523,786,818,32,3,3,3,5,2,502,648,263
912,30,30,719,719,0,45,45,647,647,0,0.00034037918240920387,0.00034037918240920387,646,646,0,-1,3,3,8,6,297,258,956
913,22,22,778,778,0,12,12,691,691,0,0.00088498587426393,0.00088498587426393,787,787,0,-1,4,4,2,6,967,289,877
914,0,0,1,1,0,0,0,1,1,0,0.0,0.0,1,1,0,-1,-1,-1,6,1,657,913,569
915,0,0,1,1,0,0,0,1,1,0,0.0,0.0,1,1,0,-1,-1,-1,3,0,867,205,431
916,18,18,717,717,0,12,12,655,655,0,0.0007828721195411688,0.0007828721195411688,777,777,0,-1,4,4,2,5,874,273,723
917,12,12,598,598,0,30,30,733,733,0,0.00013615167296368154,0.00013615167296368154,506,506,0,-1,4,4,5,4,663,551,723
918,0,0,1,1,0,0,0,1,1,0,0.0,0.0,1,1,0,-1,-1,-1,13,0,129,997,858
919,16,222,558,958,400,116,116,860,860,0,0.0006126825283365669,0.0007147962830593281,729,748,19,3,3,3,11,1,360,612,544
920,17,118,630,911,281,48,48,718,718,0,0.0008169100377820892,0.0008509479560230097,784,786,2,5,3,3,7,3,335,299,870
921,8,214,514,962,448,34,34,603,603,0,6.807583648184077e-05,0.00037441710065012424,448,650,202,3,4,4,7,2,400,628,376
922,87,189,925,977,52,12,12,714,714,0,0.002280540522141666,0.002280540522141666,903,903,0,4,4,4,2,28,876,44,476
923,0,206,1,953,952,0,17,1,392,391,0.0,0.00010211375472276115,1,480,479,3,-1,4,10,0,75,565,661
924,0,102,1,937,936,0,4,1,400,399,0.0,0.00017018959120460194,1,548,547,4,-1,5,2,0,689,923,149
925,30,132,748,939,191,44,44,840,840,0,0.0005446066918547262,0.0006126825283365669,710,730,20,4,3,3,4,4,832,267,579
926,0,102,1,911,910,0,6,1,354,353,0.0,3.4037918240920386e-05,1,406,405,4,-1,5,5,0,555,875,290
927,29,29,767,767,0,28,28,745,745,0,0.00030634126416828345,0.00030634126416828345,634,634,0,-1,3,3,3,5,636,487,796
928,6,108,442,924,482,10,10,425,425,0,6.807583648184077e-05,0.0002382654276864427,452,591,139,4,5,5,5,3,691,534,365
929,14,14,509,509,0,66,66,531,531,0,0.00017018959120460194,0.00017018959120460194,536,536,0,-1,4,4,17,3,73,378,488
930,16,16,551,551,0,66,66,675,675,0,0.00010211375472276115,0.00010211375472276115,478,478,0,-1,3,3,10,1,298,689,965
931,10,216,596,978,382,14,18,578,680,102,0.0002042275094455223,0.001599782157323258,566,862,296,3,4,4,3,4,288,287,73
932,0,1640,1,1000,999,0,45,1,828,827,0.0,0.017393376221110316,1,990,989,1,-1,2,6,0,486,907,320
933,28,28,674,674,0,112,112,831,831,0,0.0013615167296368155,0.0013615167296368155,849,849,0,-1,3,3,12,5,58,393,746
934,0,616,1,996,995,0,50,1,813,812,0.0,0.006841621566424997,1,972,971,2,-1,3,5,0,531,987,126
935,0,101,1,928,927,0,3,1,329,328,0.0,3.4037918240920386e-05,1,410,409,5,-1,6,3,0,801,906,225
936,44,250,827,977,150,36,36,770,770,0,0.0004084550188910446,0.0005786446100956465,675,729,54,3,3,3,5,10,908,262,134
937,14,116,593,927,334,28,28,609,609,0,0.0002382654276864427,0.0002723033459273631,594,610,16,4,4,4,6,6,373,247,563
938,112,214,927,972,45,54,54,873,873,0,0.0030293747234419145,0.0030974505599237552,922,924,2,4,3,3,4,26,558,112,394
939,0,206,1,953,952,0,34,1,490,489,0.0,0.00034037918240920387,1,652,651,3,-1,4,11,0,174,980,316
940,78,284,804,959,155,196,196,816,816,0,0.0009530617107457708,0.0013955546478777359,783,844,61,3,3,3,21,7,74,218,616
941,0,102,1,955,954,0,3,1,388,387,0.0,0.0002723033459273631,1,624,623,4,-1,5,2,0,967,587,525
942,1,207,333,971,638,4,9,333,450,117,0.0,0.00037441710065012424,1,677,676,3,7,4,4,1,313,703,605
943,6,212,394,949,555,34,47,472,533,61,0.0,0.0005105687736138058,1,701,700,3,4,4,12,3,183,321,273
944,0,0,1,1,0,0,0,1,1,0,0.0,0.0,1,1,0,-1,-1,-1,6,1,432,962,757
945,0,0,1,1,0,0,0,1,1,0,0.0,0.0,1,1,0,-1,-1,-1,3,0,676,999,324
946,16,118,526,885,359,73,73,520,520,0,0.00010211375472276115,0.0002723033459273631,464,598,134,4,3,3,20,1,70,718,285
947,8,8,533,533,0,18,18,506,506,0,0.0,0.0,1,1,0,-1,4,4,5,2,616,680,752
948,61,267,861,976,115,34,34,738,738,0,0.0011232513019503727,0.002144388849177984,831,892,61,3,3,3,4,16,304,113,269
949,0,0,1,1,0,0,0,1,1,0,0.0,0.0,1,1,0,-1,-1,-1,5,0,546,911,672
950,0,206,1,945,944,0,31,1,420,419,0.0,0.00013615167296368154,1,511,510,3,-1,4,14,0,181,457,381
951,20,121,661,922,261,20,20,532,532,0,0.00013615167296368154,0.00017018959120460194,518,538,20,5,4,4,4,4,385,504,717
952,38,139,813,953,140,18,18,647,647,0,0.00088498587426393,0.0009190237925048504,797,800,3,5,4,4,3,9,829,242,442
953,0,0,1,1,0,0,0,1,1,0,0.0,0.0,1,1,0,-1,-1,-1,4,0,885,330,937
954,22,228,712,978,266,18,18,733,733,0,0.0006126825283365669,0.0011232513019503727,744,834,90,3,3,3,2,3,846,496,101
955,0,0,1,1,0,0,0,1,1,0,0.0,0.0,1,1,0,-1,-1,-1,2,0,734,801,796
956,0,102,1,942,941,0,4,1,417,416,0.0,0.0002723033459273631,1,622,621,4,-1,5,2,0,874,672,619
957,6,6,463,463,0,11,11,471,471,0,6.807583648184077e-05,6.807583648184077e-05,459,459,0,-1,4,4,4,2,824,597,831
958,0,206,1,972,971,0,11,1,444,443,0.0,0.0006807583648184077,1,757,756,3,-1,4,4,0,700,881,240
959,8,109,532,920,388,28,28,607,607,0,0.0002042275094455223,0.0002042275094455223,556,556,0,5,4,4,6,4,664,270,476
960,0,616,1,993,992,0,43,1,577,576,0.0,0.0007488342013002485,1,758,757,2,-1,3,9,0,327,838,160
961,0,102,1,934,933,0,5,1,395,394,0.0,0.00010211375472276115,1,495,494,4,-1,5,3,0,579,889,510
962,20,226,705,978,273,18,18,759,759,0,0.0006807583648184077,0.0015657442390823377,762,861,99,3,3,3,2,4,934,622,193
963,0,0,1,1,0,0,0,1,1,0,0.0,0.0,1,1,0,-1,-1,-1,5,0,695,975,624
964,112,112,894,894,0,132,132,875,875,0,0.002212464685659825,0.002212464685659825,894,894,0,-1,3,3,12,15,252,158,372
965,0,206,1,961,960,0,36,1,568,567,0.0,0.0006467204465774873,1,739,738,3,-1,4,8,0,286,707,355
966,38,38,703,703,0,132,132,768,768,0,0.0005446066918547262,0.0005446066918547262,698,698,0,-1,3,3,17,4,210,407,271
967,18,18,726,726,0,18,18,802,802,0,0.00088498587426393,0.00088498587426393,805,805,0,-1,3,3,2,2,776,473,725
968,27,128,794,960,166,20,20,683,683,0,0.00088498587426393,0.0009530617107457708,785,796,11,5,4,4,4,10,738,405,369
969,0,102,1,959,958,0,4,1,390,389,0.0,0.00037441710065012424,1,680,679,4,-1,5,3,0,915,672,525
970,0,0,1,1,0,0,0,1,1,0,0.0,0.0,1,1,0,-1,-1,-1,17,0,210,796,359
971,539,641,991,994,3,152,152,984,984,0,0.011777119711358454,0.011913271384322134,984,984,0,4,2,2,8,92,334,30,477
972,63,63,863,863,0,50,50,853,853,0,0.0012253650566731338,0.0012253650566731338,832,832,0,-1,3,3,5,13,291,340,367
973,7,109,531,936,405,13,13,555,555,0,0.00017018959120460194,0.0002382654276864427,562,604,42,4,4,4,3,2,833,22,360
974,100,100,889,889,0,100,100,905,905,0,0.01929949964260186,0.01929949964260186,993,993,0,-1,1,1,8,6,420,392,796
975,2,2,361,361,0,3,3,332,332,0,0.0,0.0,1,1,0,-1,6,6,3,5,833,605,635
976,0,206,1,959,958,0,30,1,488,487,0.0,0.0010211375472276116,1,806,805,3,-1,4,10,0,211,433,242
977,0,101,1,901,900,0,8,1,332,331,0.0,0.0,1,1,0,5,-1,6,8,0,137,699,313
978,35,136,779,938,159,30,30,699,699,0,0.0008169100377820892,0.0008169100377820892,792,792,0,7,3,3,4,9,354,212,972
979,25,231,704,971,267,32,36,674,695,21,0.000442492937131965,0.0013955546478777359,692,840,148,3,3,3,5,7,537,371,92
980,16,16,517,517,0,88,88,573,573,0,0.0002042275094455223,0.0002042275094455223,559,559,0,-1,3,3,19,2,48,652,715
981,6,212,440,972,532,12,20,460,566,106,0.000442492937131965,0.001055175465468532,693,820,127,3,4,4,4,2,460,805,299
982,2,208,357,965,608,11,19,409,502,93,3.4037918240920386e-05,0.001055175465468532,394,813,419,3,5,4,6,1,606,577,166
983,18,18,577,577,0,116,116,731,731,0,0.0006467204465774873,0.0006467204465774873,730,730,0,-1,3,3,16,3,117,299,669
984,0,0,1,1,0,0,0,1,1,0,0.0,0.0,1,1,0,-1,-1,-1,7,1,342,852,849
985,1,1,332,332,0,2,2,332,332,0,0.0,0.0,1,1,0,-1,7,7,2,1,828,469,961
986,0,102,1,900,899,0,9,1,377,376,0.0,6.807583648184077e-05,1,447,446,4,-1,5,6,3,98,478,260
987,12,628,557,996,439,26,44,521,694,173,0.0006807583648184077,0.004288777698355968,741,947,206,2,4,3,7,2,658,473,28
988,0,102,1,956,955,0,3,1,389,388,0.0,0.0002042275094455223,1,579,578,4,-1,5,2,0,889,991,115
989,1,103,331,960,629,3,5,331,425,94,0.0,0.0013615167296368155,1,854,853,4,6,5,3,2,915,292,65
990,116,322,887,973,86,182,182,876,876,0,0.0015657442390823377,0.002110350930937064,855,893,38,3,2,2,17,12,23,155,467
991,0,102,1,907,906,0,5,1,352,351,0.0,3.4037918240920386e-05,1,404,403,4,-1,5,4,2,448,775,408
992,0,0,1,1,0,0,0,1,1,0,0.0,0.0,1,1,0,-1,-1,-1,2,0,993,998,875
993,14,116,623,928,305,14,14,494,494,0,0.00034037918240920387,0.0005105687736138058,655,701,46,4,4,4,5,4,456,637,899
994,1,102,333,948,615,3,3,333,333,0,6.807583648184077e-05,0.00010211375472276115,456,497,41,5,6,6,3,2,718,764,332
995,6,212,470,976,506,26,26,659,659,0,0.00010211375472276115,0.0008169100377820892,476,784,308,3,4,4,5,1,602,110,387
996,8,624,498,996,498,26,40,526,664,138,0.0002042275094455223,0.0012934408931549745,571,839,268,2,4,3,7,3,207,121,189
997,2,208,354,959,605,13,38,399,609,210,0.0,0.0018380475850097008,1,881,880,3,5,4,7,1,221,618,304
998,1,207,331,974,643,4,11,331,470,139,0.0,0.0007147962830593281,1,772,771,3,9,4,4,1,824,647,202
999,184,390,968,992,24,66,66,922,922,0,0.0040845501889104465,0.004288777698355968,940,946,6,3,3,3,6,36,529,48,486
